,Hours,SE1,SE2,SE3,SE4,SE
01-01-2020,00 - 01,969,1806,9518,2664,14957
01-01-2020,01 - 02,1139,1785,9350,2586,14860
01-01-2020,02 - 03,1106,1808,9158,2523,14595
01-01-2020,03 - 04,996,1724,8980,2504,14204
01-01-2020,04 - 05,1173,1692,8914,2484,14263
01-01-2020,05 - 06,1079,1731,8964,2483,14257
01-01-2020,06 - 07,892,1820,9160,2581,14453
01-01-2020,07 - 08,980,1855,9451,2602,14888
01-01-2020,08 - 09,1103,1941,9661,2622,15327
01-01-2020,09 - 10,1087,2023,9726,2666,15502
01-01-2020,10 - 11,1195,1989,10050,2738,15972
01-01-2020,11 - 12,1278,1954,10347,2821,16400
01-01-2020,12 - 13,1179,1878,10592,2891,16540
01-01-2020,13 - 14,1195,1965,10637,2937,16734
01-01-2020,14 - 15,1169,1927,10811,2972,16879
01-01-2020,15 - 16,1157,2065,11104,3065,17391
01-01-2020,16 - 17,1213,2131,11446,3253,18043
01-01-2020,17 - 18,1168,2092,11526,3354,18140
01-01-2020,18 - 19,1136,1942,11371,3283,17732
01-01-2020,19 - 20,1101,1938,11174,3212,17425
01-01-2020,20 - 21,1107,1968,10723,3147,16945
01-01-2020,21 - 22,1172,1927,10269,3052,16420
01-01-2020,22 - 23,1145,1815,9783,2893,15636
01-01-2020,23 - 00,1071,1756,9394,2842,15063
02-01-2020,00 - 01,1113,1725,9064,2647,14549
02-01-2020,01 - 02,1037,1707,8885,2668,14297
02-01-2020,02 - 03,1059,1710,8765,2699,14233
02-01-2020,03 - 04,1028,1933,8738,2706,14405
02-01-2020,04 - 05,1054,1933,8832,2736,14555
02-01-2020,05 - 06,1182,1815,9229,2878,15104
02-01-2020,06 - 07,1105,1919,10116,3177,16317
02-01-2020,07 - 08,928,1934,10787,3398,17047
02-01-2020,08 - 09,1054,1933,11305,3503,17795
02-01-2020,09 - 10,1121,1930,11473,3571,18095
02-01-2020,10 - 11,1100,1955,11644,3614,18313
02-01-2020,11 - 12,1083,1979,11741,3712,18515
02-01-2020,12 - 13,1064,1985,11813,3747,18609
02-01-2020,13 - 14,1109,1902,11833,3788,18632
02-01-2020,14 - 15,1066,1966,11890,3796,18718
02-01-2020,15 - 16,1173,2055,12243,3815,19286
02-01-2020,16 - 17,1100,2052,12453,3908,19513
02-01-2020,17 - 18,1089,2031,12515,3927,19562
02-01-2020,18 - 19,1042,2097,12132,3845,19116
02-01-2020,19 - 20,1024,2013,11839,3687,18563
02-01-2020,20 - 21,994,1987,11458,3469,17908
02-01-2020,21 - 22,1076,1851,10937,3294,17158
02-01-2020,22 - 23,1105,1779,10321,3154,16359
02-01-2020,23 - 00,919,1739,9879,2983,15520
03-01-2020,00 - 01,1048,1776,9489,2915,15228
03-01-2020,01 - 02,997,1805,9246,2853,14901
03-01-2020,02 - 03,990,1803,9173,2899,14865
03-01-2020,03 - 04,1012,1706,9090,2887,14695
03-01-2020,04 - 05,1006,1791,9157,2818,14772
03-01-2020,05 - 06,1133,1887,9427,2886,15333
03-01-2020,06 - 07,1105,1836,10130,3077,16148
03-01-2020,07 - 08,1137,2053,10930,3313,17433
03-01-2020,08 - 09,1115,2097,11412,3483,18107
03-01-2020,09 - 10,1133,2125,11485,3513,18256
03-01-2020,10 - 11,1152,2049,11719,3607,18527
03-01-2020,11 - 12,1060,1989,11828,3622,18499
03-01-2020,12 - 13,1082,2262,11695,3616,18655
03-01-2020,13 - 14,1127,2418,11618,3615,18778
03-01-2020,14 - 15,1144,2273,11702,3551,18670
03-01-2020,15 - 16,1091,2208,12165,3729,19193
03-01-2020,16 - 17,1204,2192,12490,3857,19743
03-01-2020,17 - 18,1144,2226,12489,3782,19641
03-01-2020,18 - 19,1125,2151,12333,3672,19281
03-01-2020,19 - 20,1154,2070,12093,3518,18835
03-01-2020,20 - 21,1101,1993,11603,3339,18036
03-01-2020,21 - 22,1122,1986,11099,3150,17357
03-01-2020,22 - 23,1081,1873,10717,2941,16612
03-01-2020,23 - 00,1087,1950,10300,2790,16127
04-01-2020,00 - 01,1076,1888,9964,2766,15694
04-01-2020,01 - 02,1129,1885,9796,2669,15479
04-01-2020,02 - 03,1177,1866,9725,2638,15406
04-01-2020,03 - 04,1193,1897,9783,2638,15511
04-01-2020,04 - 05,1239,1906,9854,2661,15660
04-01-2020,05 - 06,1069,1948,9997,2714,15728
04-01-2020,06 - 07,991,2046,10221,2822,16080
04-01-2020,07 - 08,995,2038,10608,2958,16599
04-01-2020,08 - 09,1126,2117,10981,3115,17339
04-01-2020,09 - 10,1229,2142,11334,3218,17923
04-01-2020,10 - 11,1262,2175,11539,3401,18377
04-01-2020,11 - 12,1270,2080,11543,3329,18222
04-01-2020,12 - 13,1239,2121,11538,3234,18132
04-01-2020,13 - 14,1220,2097,11501,3194,18012
04-01-2020,14 - 15,1191,2127,11572,3161,18051
04-01-2020,15 - 16,1205,2100,11894,3304,18503
04-01-2020,16 - 17,1096,2250,12359,3474,19179
04-01-2020,17 - 18,1209,2220,12593,3560,19582
04-01-2020,18 - 19,1282,2157,12530,3475,19444
04-01-2020,19 - 20,1313,2190,12484,3382,19369
04-01-2020,20 - 21,1197,2152,12055,3286,18690
04-01-2020,21 - 22,1235,2118,11683,3189,18225
04-01-2020,22 - 23,1108,2225,11265,3065,17663
04-01-2020,23 - 00,1228,2116,10883,3012,17239
05-01-2020,00 - 01,1223,2111,10507,2922,16763
05-01-2020,01 - 02,1135,1976,10215,2820,16146
05-01-2020,02 - 03,1128,2115,10019,2781,16043
05-01-2020,03 - 04,1166,2061,10108,2712,16047
05-01-2020,04 - 05,1138,1936,10243,2742,16059
05-01-2020,05 - 06,1256,2022,10451,2803,16532
05-01-2020,06 - 07,1381,2073,10726,2853,17033
05-01-2020,07 - 08,1410,2136,11245,2969,17760
05-01-2020,08 - 09,1374,2056,11573,3166,18169
05-01-2020,09 - 10,1409,2263,12007,3321,19000
05-01-2020,10 - 11,1209,2280,11990,3433,18912
05-01-2020,11 - 12,1208,2066,11992,3408,18674
05-01-2020,12 - 13,1299,1882,12097,3308,18586
05-01-2020,13 - 14,1363,1919,12028,3283,18593
05-01-2020,14 - 15,1319,1982,12106,3274,18681
05-01-2020,15 - 16,1162,2186,12302,3346,18996
05-01-2020,16 - 17,1110,2195,12490,3495,19290
05-01-2020,17 - 18,1194,2206,12583,3519,19502
05-01-2020,18 - 19,1186,2220,12368,3518,19292
05-01-2020,19 - 20,1212,2096,12120,3442,18870
05-01-2020,20 - 21,1206,1906,11669,3263,18044
05-01-2020,21 - 22,1179,2026,11113,3076,17394
05-01-2020,22 - 23,1125,1903,10614,2946,16588
05-01-2020,23 - 00,1113,1978,10055,2799,15945
06-01-2020,00 - 01,1194,1860,9801,2710,15565
06-01-2020,01 - 02,1230,1714,9379,2654,14977
06-01-2020,02 - 03,1195,1558,9156,2594,14503
06-01-2020,03 - 04,1179,1522,9100,2565,14366
06-01-2020,04 - 05,1144,1522,9118,2585,14369
06-01-2020,05 - 06,1081,1618,9342,2679,14720
06-01-2020,06 - 07,1183,1764,9732,2778,15457
06-01-2020,07 - 08,1183,1891,10213,2918,16205
06-01-2020,08 - 09,1188,2015,10727,3017,16947
06-01-2020,09 - 10,1350,2023,11006,3108,17487
06-01-2020,10 - 11,1364,1866,11280,3242,17752
06-01-2020,11 - 12,1279,2070,11502,3335,18186
06-01-2020,12 - 13,1277,1976,11501,3362,18116
06-01-2020,13 - 14,1273,1842,11499,3319,17933
06-01-2020,14 - 15,1262,1894,11584,3293,18033
06-01-2020,15 - 16,1283,2256,11886,3324,18749
06-01-2020,16 - 17,1482,2431,11988,3441,19342
06-01-2020,17 - 18,1571,2355,11978,3468,19372
06-01-2020,18 - 19,1320,2066,11778,3419,18583
06-01-2020,19 - 20,1130,1902,11509,3293,17834
06-01-2020,20 - 21,1029,2018,11235,3174,17456
06-01-2020,21 - 22,1101,1995,10792,3076,16964
06-01-2020,22 - 23,1240,1665,10175,2894,15974
06-01-2020,23 - 00,1356,1744,9709,2718,15527
07-01-2020,00 - 01,1235,1800,9330,2645,15010
07-01-2020,01 - 02,1126,1641,9138,2581,14486
07-01-2020,02 - 03,1105,1661,9074,2562,14402
07-01-2020,03 - 04,943,1713,9088,2603,14347
07-01-2020,04 - 05,990,1619,9267,2646,14522
07-01-2020,05 - 06,1332,1786,9843,2854,15815
07-01-2020,06 - 07,1486,1796,11007,3275,17564
07-01-2020,07 - 08,1363,2024,12074,3646,19107
07-01-2020,08 - 09,1377,2073,12603,3749,19802
07-01-2020,09 - 10,1280,2067,12570,3775,19692
07-01-2020,10 - 11,1257,2088,12722,3820,19887
07-01-2020,11 - 12,1264,2139,12706,3858,19967
07-01-2020,12 - 13,1282,2387,12669,3840,20178
07-01-2020,13 - 14,1318,2334,12749,3826,20227
07-01-2020,14 - 15,1342,1987,12740,3806,19875
07-01-2020,15 - 16,1268,1899,12846,3807,19820
07-01-2020,16 - 17,1206,2088,12956,3740,19990
07-01-2020,17 - 18,1163,1933,12936,3701,19733
07-01-2020,18 - 19,1061,1883,12688,3706,19338
07-01-2020,19 - 20,1047,2026,12288,3570,18931
07-01-2020,20 - 21,1060,1945,11889,3422,18316
07-01-2020,21 - 22,1055,1859,11361,3205,17480
07-01-2020,22 - 23,1038,1825,10710,3023,16596
07-01-2020,23 - 00,1089,1867,10098,2864,15918
08-01-2020,00 - 01,1234,1783,9813,2819,15649
08-01-2020,01 - 02,1207,1726,9600,2778,15311
08-01-2020,02 - 03,1200,1796,9442,2734,15172
08-01-2020,03 - 04,1112,1811,9578,2738,15239
08-01-2020,04 - 05,1107,1761,9635,2761,15264
08-01-2020,05 - 06,1061,1705,9995,2904,15665
08-01-2020,06 - 07,1222,1835,11124,3311,17492
08-01-2020,07 - 08,1196,1984,12224,3697,19101
08-01-2020,08 - 09,1314,2216,12441,3806,19777
08-01-2020,09 - 10,1281,2249,12326,3740,19596
08-01-2020,10 - 11,1298,2250,12257,3776,19581
08-01-2020,11 - 12,1286,2188,12225,3717,19416
08-01-2020,12 - 13,1164,2119,12206,3627,19116
08-01-2020,13 - 14,1150,2242,12208,3587,19187
08-01-2020,14 - 15,1197,2121,12292,3565,19175
08-01-2020,15 - 16,1345,2127,12627,3568,19667
08-01-2020,16 - 17,1390,2189,12886,3676,20141
08-01-2020,17 - 18,1174,2172,13125,3752,20223
08-01-2020,18 - 19,1141,2058,12992,3736,19927
08-01-2020,19 - 20,1213,1928,12656,3673,19470
08-01-2020,20 - 21,1042,2010,12168,3445,18665
08-01-2020,21 - 22,1093,2040,11628,3272,18033
08-01-2020,22 - 23,1133,2063,10932,3086,17214
08-01-2020,23 - 00,1118,1944,10337,2906,16305
09-01-2020,00 - 01,1095,1815,10006,2842,15758
09-01-2020,01 - 02,1083,1781,9732,2819,15415
09-01-2020,02 - 03,1104,1838,9704,2827,15473
09-01-2020,03 - 04,1074,1858,9707,2846,15485
09-01-2020,04 - 05,1110,1782,9860,2934,15686
09-01-2020,05 - 06,1109,1890,10471,3174,16644
09-01-2020,06 - 07,1178,2153,11668,3524,18523
09-01-2020,07 - 08,1259,2225,12782,3888,20154
09-01-2020,08 - 09,1291,2309,13235,3941,20776
09-01-2020,09 - 10,1370,2326,13025,3791,20512
09-01-2020,10 - 11,1388,2320,12987,3794,20489
09-01-2020,11 - 12,1356,2155,12811,3818,20140
09-01-2020,12 - 13,1308,2160,12753,3796,20017
09-01-2020,13 - 14,1375,2310,12835,3810,20330
09-01-2020,14 - 15,1352,2316,12980,3823,20471
09-01-2020,15 - 16,1339,2240,13328,3855,20762
09-01-2020,16 - 17,1219,2192,13369,3811,20591
09-01-2020,17 - 18,1246,2135,13521,3768,20670
09-01-2020,18 - 19,1228,2104,13295,3683,20310
09-01-2020,19 - 20,1274,2033,13017,3590,19914
09-01-2020,20 - 21,1231,1937,12570,3473,19211
09-01-2020,21 - 22,1239,1894,11958,3278,18369
09-01-2020,22 - 23,1275,1806,11336,2992,17409
09-01-2020,23 - 00,1192,1514,10677,2737,16120
10-01-2020,00 - 01,1226,1572,10314,2634,15746
10-01-2020,01 - 02,1079,1642,10061,2585,15367
10-01-2020,02 - 03,1097,1674,9952,2541,15264
10-01-2020,03 - 04,1141,1749,9924,2516,15330
10-01-2020,04 - 05,1220,1708,10089,2568,15585
10-01-2020,05 - 06,1268,1859,10664,2747,16538
10-01-2020,06 - 07,1279,1988,11986,3162,18415
10-01-2020,07 - 08,1181,2153,13062,3582,19978
10-01-2020,08 - 09,1264,2243,13249,3665,20421
10-01-2020,09 - 10,1262,2185,13264,3615,20326
10-01-2020,10 - 11,1399,2274,13449,3655,20777
10-01-2020,11 - 12,1416,2265,13321,3701,20703
10-01-2020,12 - 13,1418,2297,13186,3634,20535
10-01-2020,13 - 14,1347,2013,12962,3594,19916
10-01-2020,14 - 15,1341,1988,12986,3545,19860
10-01-2020,15 - 16,1302,2177,13243,3606,20328
10-01-2020,16 - 17,1240,2188,13448,3667,20543
10-01-2020,17 - 18,1105,2179,13506,3658,20448
10-01-2020,18 - 19,1321,2131,13306,3576,20334
10-01-2020,19 - 20,1275,2106,13065,3518,19964
10-01-2020,20 - 21,1166,2074,12673,3399,19312
10-01-2020,21 - 22,1129,2130,12344,3329,18932
10-01-2020,22 - 23,1303,2209,11809,3174,18495
10-01-2020,23 - 00,1123,2050,11387,3010,17570
11-01-2020,00 - 01,1046,2155,11088,2817,17106
11-01-2020,01 - 02,1179,2039,10857,2766,16841
11-01-2020,02 - 03,1137,1581,10640,2748,16106
11-01-2020,03 - 04,982,1583,10555,2737,15857
11-01-2020,04 - 05,973,1689,10536,2715,15913
11-01-2020,05 - 06,1157,1714,10568,2697,16136
11-01-2020,06 - 07,1078,1875,10927,2769,16649
11-01-2020,07 - 08,1009,1929,11375,2922,17235
11-01-2020,08 - 09,1177,2077,11753,3078,18085
11-01-2020,09 - 10,1082,2075,12021,3203,18381
11-01-2020,10 - 11,1087,2131,12342,3263,18823
11-01-2020,11 - 12,1359,2168,12414,3227,19168
11-01-2020,12 - 13,1323,2034,12360,3174,18891
11-01-2020,13 - 14,1188,1999,12282,3176,18645
11-01-2020,14 - 15,1211,1884,12255,3192,18542
11-01-2020,15 - 16,1364,1959,12401,3257,18981
11-01-2020,16 - 17,1375,1944,12512,3418,19249
11-01-2020,17 - 18,1227,2004,12452,3509,19192
11-01-2020,18 - 19,1267,1832,12181,3455,18735
11-01-2020,19 - 20,1302,1733,11764,3324,18123
11-01-2020,20 - 21,1293,1616,11281,3184,17374
11-01-2020,21 - 22,1125,1613,10764,3063,16565
11-01-2020,22 - 23,1197,1537,10270,2945,15949
11-01-2020,23 - 00,1188,1569,9791,2812,15360
12-01-2020,00 - 01,1165,1446,9334,2732,14677
12-01-2020,01 - 02,1151,1531,9128,2625,14435
12-01-2020,02 - 03,1189,1557,9013,2576,14335
12-01-2020,03 - 04,1196,1326,8990,2580,14092
12-01-2020,04 - 05,1159,1433,8906,2579,14077
12-01-2020,05 - 06,1166,1577,8955,2590,14288
12-01-2020,06 - 07,1175,1740,9171,2671,14757
12-01-2020,07 - 08,1167,1755,9500,2769,15191
12-01-2020,08 - 09,1147,1836,9775,2893,15651
12-01-2020,09 - 10,1001,1625,10035,2983,15644
12-01-2020,10 - 11,1116,1615,10342,3053,16126
12-01-2020,11 - 12,1145,1657,10570,3077,16449
12-01-2020,12 - 13,1215,1615,10798,3129,16757
12-01-2020,13 - 14,1155,1679,10813,3139,16786
12-01-2020,14 - 15,1112,1801,10912,3188,17013
12-01-2020,15 - 16,1208,2008,11353,3241,17810
12-01-2020,16 - 17,1228,1833,11829,3431,18321
12-01-2020,17 - 18,1358,2018,12164,3439,18979
12-01-2020,18 - 19,1371,2088,11997,3373,18829
12-01-2020,19 - 20,1297,1958,11768,3314,18337
12-01-2020,20 - 21,1352,1808,11621,3304,18085
12-01-2020,21 - 22,1257,1772,11096,3188,17313
12-01-2020,22 - 23,1102,1625,10522,3021,16270
12-01-2020,23 - 00,1158,1592,10168,2819,15737
13-01-2020,00 - 01,1198,1751,9848,2556,15353
13-01-2020,01 - 02,1223,1703,9747,2516,15189
13-01-2020,02 - 03,1235,1845,9741,2540,15361
13-01-2020,03 - 04,1092,1845,9830,2570,15337
13-01-2020,04 - 05,1162,1978,10047,2605,15792
13-01-2020,05 - 06,1437,1780,10636,2820,16673
13-01-2020,06 - 07,1354,2020,12020,3253,18647
13-01-2020,07 - 08,1274,2136,13097,3678,20185
13-01-2020,08 - 09,1276,2103,13379,3788,20546
13-01-2020,09 - 10,1156,2177,13195,3708,20236
13-01-2020,10 - 11,1294,2330,13262,3798,20684
13-01-2020,11 - 12,1321,2331,13033,3779,20464
13-01-2020,12 - 13,1336,2227,12898,3689,20150
13-01-2020,13 - 14,1341,2315,12993,3711,20360
13-01-2020,14 - 15,1302,2276,13039,3708,20325
13-01-2020,15 - 16,1398,2218,13243,3793,20652
13-01-2020,16 - 17,1405,2180,13511,3867,20963
13-01-2020,17 - 18,1393,2308,13498,3923,21122
13-01-2020,18 - 19,1307,2173,13219,3794,20493
13-01-2020,19 - 20,1272,1948,12970,3672,19862
13-01-2020,20 - 21,1311,1969,12493,3548,19321
13-01-2020,21 - 22,1337,1899,11987,3382,18605
13-01-2020,22 - 23,1220,1923,11185,3158,17486
13-01-2020,23 - 00,1192,2099,10580,2930,16801
14-01-2020,00 - 01,1143,1869,10147,2783,15942
14-01-2020,01 - 02,1118,1822,9885,2653,15478
14-01-2020,02 - 03,1041,1980,9871,2641,15533
14-01-2020,03 - 04,1151,1881,9879,2650,15561
14-01-2020,04 - 05,1404,1899,10012,2668,15983
14-01-2020,05 - 06,1261,2033,10578,2916,16788
14-01-2020,06 - 07,1305,2251,11688,3355,18599
14-01-2020,07 - 08,1308,2171,12730,3758,19967
14-01-2020,08 - 09,1211,2304,12918,3856,20289
14-01-2020,09 - 10,1142,2395,12862,3815,20214
14-01-2020,10 - 11,1207,2444,12926,3874,20451
14-01-2020,11 - 12,1246,2288,12931,3895,20360
14-01-2020,12 - 13,1284,2269,12863,3819,20235
14-01-2020,13 - 14,1228,2230,12702,3833,19993
14-01-2020,14 - 15,1268,2115,12475,3797,19655
14-01-2020,15 - 16,1286,2216,12713,3858,20073
14-01-2020,16 - 17,1292,2247,12983,3984,20506
14-01-2020,17 - 18,1360,2281,13210,3960,20811
14-01-2020,18 - 19,1301,1954,12960,3839,20054
14-01-2020,19 - 20,1275,1878,12653,3629,19435
14-01-2020,20 - 21,1296,2036,12202,3391,18925
14-01-2020,21 - 22,1130,1987,11596,3226,17939
14-01-2020,22 - 23,958,1962,10962,2996,16878
14-01-2020,23 - 00,1051,1805,10445,2771,16072
15-01-2020,00 - 01,1150,2068,9778,2653,15649
15-01-2020,01 - 02,1124,1984,9422,2623,15153
15-01-2020,02 - 03,1123,1927,9395,2595,15040
15-01-2020,03 - 04,1160,1768,9476,2583,14987
15-01-2020,04 - 05,1178,1740,9475,2614,15007
15-01-2020,05 - 06,1153,1964,9871,2772,15760
15-01-2020,06 - 07,1241,1939,10915,3173,17268
15-01-2020,07 - 08,1291,2174,11987,3593,19045
15-01-2020,08 - 09,1323,2241,12210,3672,19446
15-01-2020,09 - 10,1413,2401,12139,3623,19576
15-01-2020,10 - 11,1371,2405,12227,3672,19675
15-01-2020,11 - 12,1353,2157,12155,3680,19345
15-01-2020,12 - 13,1415,2187,12148,3646,19396
15-01-2020,13 - 14,1441,2100,12009,3631,19181
15-01-2020,14 - 15,1467,2098,12037,3637,19239
15-01-2020,15 - 16,1502,2199,12323,3713,19737
15-01-2020,16 - 17,1474,2102,12632,3797,20005
15-01-2020,17 - 18,1419,2153,12774,3872,20218
15-01-2020,18 - 19,1347,2060,12611,3681,19699
15-01-2020,19 - 20,1389,1813,12253,3477,18932
15-01-2020,20 - 21,1388,1778,11768,3466,18400
15-01-2020,21 - 22,1390,1925,11272,3362,17949
15-01-2020,22 - 23,1269,1986,10496,3231,16982
15-01-2020,23 - 00,1268,1899,9822,3027,16016
16-01-2020,00 - 01,1160,1907,9533,2830,15430
16-01-2020,01 - 02,1157,1777,9335,2629,14898
16-01-2020,02 - 03,1283,1869,9306,2542,15000
16-01-2020,03 - 04,1297,1812,9284,2668,15061
16-01-2020,04 - 05,1301,1678,9464,2727,15170
16-01-2020,05 - 06,1348,1798,9975,2917,16038
16-01-2020,06 - 07,1438,2074,11136,3274,17922
16-01-2020,07 - 08,1417,2267,12317,3664,19665
16-01-2020,08 - 09,1402,2176,12512,3787,19877
16-01-2020,09 - 10,1437,2189,12359,3732,19717
16-01-2020,10 - 11,1374,2092,12408,3764,19638
16-01-2020,11 - 12,1378,1919,12506,3687,19490
16-01-2020,12 - 13,1389,2022,12324,3590,19325
16-01-2020,13 - 14,1420,2050,12271,3608,19349
16-01-2020,14 - 15,1433,2002,12303,3669,19407
16-01-2020,15 - 16,1488,2122,12327,3682,19619
16-01-2020,16 - 17,1474,2029,12828,3788,20119
16-01-2020,17 - 18,1485,2035,12893,3891,20304
16-01-2020,18 - 19,1465,2053,12666,3827,20011
16-01-2020,19 - 20,1329,2117,12460,3650,19556
16-01-2020,20 - 21,1187,2104,12063,3551,18905
16-01-2020,21 - 22,1300,2095,11444,3391,18230
16-01-2020,22 - 23,1251,2081,10824,3217,17373
16-01-2020,23 - 00,1195,2005,10209,3116,16525
17-01-2020,00 - 01,1251,1837,9806,2894,15788
17-01-2020,01 - 02,1240,1828,9483,2823,15374
17-01-2020,02 - 03,1243,1863,9481,2786,15373
17-01-2020,03 - 04,1234,1826,9515,2846,15421
17-01-2020,04 - 05,1326,1832,9550,2899,15607
17-01-2020,05 - 06,1267,2017,10102,3016,16402
17-01-2020,06 - 07,1500,2142,11447,3427,18516
17-01-2020,07 - 08,1452,2370,12576,3755,20153
17-01-2020,08 - 09,1524,2312,12797,3829,20462
17-01-2020,09 - 10,1632,2187,12644,3808,20271
17-01-2020,10 - 11,1465,2333,12649,3812,20259
17-01-2020,11 - 12,1498,2342,12527,3759,20126
17-01-2020,12 - 13,1457,2262,12428,3632,19779
17-01-2020,13 - 14,1595,2239,12268,3518,19620
17-01-2020,14 - 15,1573,2510,12319,3411,19813
17-01-2020,15 - 16,1561,2611,12351,3445,19968
17-01-2020,16 - 17,1489,2489,12749,3501,20228
17-01-2020,17 - 18,1504,2416,12929,3618,20467
17-01-2020,18 - 19,1453,2357,12493,3543,19846
17-01-2020,19 - 20,1412,2303,12022,3418,19155
17-01-2020,20 - 21,1418,2226,11491,3327,18462
17-01-2020,21 - 22,1372,2092,10901,3175,17540
17-01-2020,22 - 23,1266,2005,10578,3003,16852
17-01-2020,23 - 00,1288,2014,10190,2844,16336
18-01-2020,00 - 01,1306,2041,9856,2659,15862
18-01-2020,01 - 02,1281,1878,9533,2628,15320
18-01-2020,02 - 03,1286,1904,9342,2577,15109
18-01-2020,03 - 04,1243,1828,9253,2515,14839
18-01-2020,04 - 05,1281,1831,9176,2433,14721
18-01-2020,05 - 06,1317,1842,9284,2423,14866
18-01-2020,06 - 07,1314,2065,9505,2579,15463
18-01-2020,07 - 08,1363,2116,9871,2699,16049
18-01-2020,08 - 09,1358,2164,10411,2803,16736
18-01-2020,09 - 10,1357,2229,10962,2898,17446
18-01-2020,10 - 11,1437,2238,11215,2999,17889
18-01-2020,11 - 12,1330,2151,11347,3042,17870
18-01-2020,12 - 13,1357,2174,11353,3079,17963
18-01-2020,13 - 14,1326,2158,11289,3048,17821
18-01-2020,14 - 15,1395,2178,11353,3033,17959
18-01-2020,15 - 16,1397,2309,11375,3065,18146
18-01-2020,16 - 17,1360,2437,11755,3182,18734
18-01-2020,17 - 18,1365,2365,11848,3265,18843
18-01-2020,18 - 19,1244,2327,11683,3187,18441
18-01-2020,19 - 20,1288,2180,11211,3080,17759
18-01-2020,20 - 21,1297,2000,10849,2980,17126
18-01-2020,21 - 22,1274,1774,10504,2871,16423
18-01-2020,22 - 23,1268,1830,10133,2786,16017
18-01-2020,23 - 00,1176,1971,9874,2706,15727
19-01-2020,00 - 01,1207,1836,9493,2661,15197
19-01-2020,01 - 02,1132,1900,9402,2557,14991
19-01-2020,02 - 03,1234,1765,9284,2514,14797
19-01-2020,03 - 04,1204,1722,9251,2581,14758
19-01-2020,04 - 05,1265,1738,9383,2619,15005
19-01-2020,05 - 06,1188,1650,9534,2711,15083
19-01-2020,06 - 07,1231,1733,9946,2814,15724
19-01-2020,07 - 08,1321,1733,10320,2891,16265
19-01-2020,08 - 09,1376,1894,10872,2954,17096
19-01-2020,09 - 10,1451,2023,11241,3110,17825
19-01-2020,10 - 11,1439,2083,11467,3149,18138
19-01-2020,11 - 12,1481,2131,11514,3186,18312
19-01-2020,12 - 13,1489,2068,11433,3162,18152
19-01-2020,13 - 14,1373,2076,11369,3096,17914
19-01-2020,14 - 15,1400,2107,11436,3083,18026
19-01-2020,15 - 16,1488,2263,11816,3128,18695
19-01-2020,16 - 17,1581,2185,12358,3274,19398
19-01-2020,17 - 18,1440,2076,12683,3420,19619
19-01-2020,18 - 19,1405,2095,12761,3388,19649
19-01-2020,19 - 20,1464,2039,12661,3280,19444
19-01-2020,20 - 21,1337,1936,12327,3295,18895
19-01-2020,21 - 22,1323,2075,11835,3245,18478
19-01-2020,22 - 23,1160,2313,11269,3082,17824
19-01-2020,23 - 00,1192,2177,10770,2968,17107
20-01-2020,00 - 01,1209,1784,10418,2861,16272
20-01-2020,01 - 02,1121,1516,10296,2739,15672
20-01-2020,02 - 03,1070,1641,10275,2740,15726
20-01-2020,03 - 04,1066,1723,10149,2769,15707
20-01-2020,04 - 05,1115,1601,10303,2835,15854
20-01-2020,05 - 06,1210,1625,10709,3002,16546
20-01-2020,06 - 07,1259,1924,11986,3334,18503
20-01-2020,07 - 08,1397,2185,13273,3729,20584
20-01-2020,08 - 09,1362,2172,13371,3749,20654
20-01-2020,09 - 10,1404,2226,13188,3766,20584
20-01-2020,10 - 11,1368,2250,13149,3837,20604
20-01-2020,11 - 12,1304,2168,13065,3825,20362
20-01-2020,12 - 13,1272,2184,12894,3745,20095
20-01-2020,13 - 14,1295,2308,12741,3676,20020
20-01-2020,14 - 15,1093,2327,12589,3651,19660
20-01-2020,15 - 16,1115,2283,12758,3730,19886
20-01-2020,16 - 17,1218,2245,13091,3826,20380
20-01-2020,17 - 18,1229,2146,13170,3853,20398
20-01-2020,18 - 19,1185,2033,12943,3732,19893
20-01-2020,19 - 20,1092,2056,12586,3633,19367
20-01-2020,20 - 21,1201,2011,12185,3467,18864
20-01-2020,21 - 22,1098,1913,11608,3265,17884
20-01-2020,22 - 23,1095,1725,10905,3108,16833
20-01-2020,23 - 00,1089,1699,10188,2929,15905
21-01-2020,00 - 01,1046,1711,9707,2820,15284
21-01-2020,01 - 02,1104,1728,9326,2708,14866
21-01-2020,02 - 03,1324,1769,9203,2640,14936
21-01-2020,03 - 04,1178,1777,9157,2633,14745
21-01-2020,04 - 05,1224,1747,9264,2672,14907
21-01-2020,05 - 06,1267,1864,9849,2856,15836
21-01-2020,06 - 07,1336,2122,11092,3240,17790
21-01-2020,07 - 08,1315,2322,12130,3659,19426
21-01-2020,08 - 09,1418,2253,12310,3745,19726
21-01-2020,09 - 10,1350,2291,12456,3720,19817
21-01-2020,10 - 11,1411,2321,12407,3746,19885
21-01-2020,11 - 12,1214,2260,12309,3758,19541
21-01-2020,12 - 13,1376,2111,11987,3717,19191
21-01-2020,13 - 14,1282,2122,11812,3664,18880
21-01-2020,14 - 15,1267,2185,11896,3650,18998
21-01-2020,15 - 16,1275,2271,12193,3647,19386
21-01-2020,16 - 17,1365,2256,12558,3743,19922
21-01-2020,17 - 18,1408,2194,12849,3817,20268
21-01-2020,18 - 19,1293,2147,12751,3692,19883
21-01-2020,19 - 20,1365,2139,12277,3526,19307
21-01-2020,20 - 21,1355,1963,11742,3418,18478
21-01-2020,21 - 22,1276,1970,11082,3283,17611
21-01-2020,22 - 23,1266,1818,10593,3047,16724
21-01-2020,23 - 00,1085,1896,9965,2835,15781
22-01-2020,00 - 01,1019,1772,9560,2795,15146
22-01-2020,01 - 02,1111,1894,9426,2718,15149
22-01-2020,02 - 03,1147,1940,9390,2688,15165
22-01-2020,03 - 04,1128,1947,9489,2717,15281
22-01-2020,04 - 05,1091,1899,9817,2783,15590
22-01-2020,05 - 06,1173,1915,10205,2950,16243
22-01-2020,06 - 07,1306,2286,11483,3397,18472
22-01-2020,07 - 08,1324,2308,12671,3740,20043
22-01-2020,08 - 09,1286,2351,12711,3781,20129
22-01-2020,09 - 10,1221,2364,12738,3747,20070
22-01-2020,10 - 11,1425,2351,12694,3660,20130
22-01-2020,11 - 12,1392,2347,12592,3601,19932
22-01-2020,12 - 13,1292,2315,12387,3457,19451
22-01-2020,13 - 14,1421,2304,12329,3389,19443
22-01-2020,14 - 15,1335,2406,12400,3476,19617
22-01-2020,15 - 16,1468,2366,12885,3630,20349
22-01-2020,16 - 17,1531,2507,13465,3780,21283
22-01-2020,17 - 18,1324,2559,13664,3905,21452
22-01-2020,18 - 19,1252,2399,13478,3914,21043
22-01-2020,19 - 20,1294,2299,13143,3774,20510
22-01-2020,20 - 21,1204,2361,12882,3649,20096
22-01-2020,21 - 22,1175,2202,12425,3551,19353
22-01-2020,22 - 23,1131,2272,11784,3381,18568
22-01-2020,23 - 00,1177,2334,11267,3201,17979
23-01-2020,00 - 01,1194,2237,10937,3139,17507
23-01-2020,01 - 02,1111,2027,10680,3153,16971
23-01-2020,02 - 03,1210,1952,10420,3148,16730
23-01-2020,03 - 04,1322,2137,10280,3064,16803
23-01-2020,04 - 05,1581,2173,10359,3008,17121
23-01-2020,05 - 06,1461,2056,10851,3130,17498
23-01-2020,06 - 07,1243,1887,12376,3517,19023
23-01-2020,07 - 08,1261,2046,13454,3823,20584
23-01-2020,08 - 09,1397,2092,13503,3852,20844
23-01-2020,09 - 10,1260,2144,13318,3882,20604
23-01-2020,10 - 11,1245,2119,13220,3932,20516
23-01-2020,11 - 12,1324,2114,13008,3884,20330
23-01-2020,12 - 13,1357,2199,12858,3843,20257
23-01-2020,13 - 14,1403,2104,12773,3774,20054
23-01-2020,14 - 15,1377,2160,12648,3731,19916
23-01-2020,15 - 16,1475,2248,12803,3800,20326
23-01-2020,16 - 17,1448,2236,13054,3833,20571
23-01-2020,17 - 18,1397,2260,13196,3908,20761
23-01-2020,18 - 19,1333,2104,12821,3818,20076
23-01-2020,19 - 20,1351,1986,12417,3652,19406
23-01-2020,20 - 21,1347,2005,11942,3491,18785
23-01-2020,21 - 22,1256,1979,11321,3314,17870
23-01-2020,22 - 23,1184,1972,10615,3114,16885
23-01-2020,23 - 00,1150,2017,10005,2883,16055
24-01-2020,00 - 01,1113,2058,9580,2817,15568
24-01-2020,01 - 02,1103,2126,9330,2750,15309
24-01-2020,02 - 03,1129,2146,9214,2700,15189
24-01-2020,03 - 04,1138,2110,9178,2720,15146
24-01-2020,04 - 05,1188,1994,9257,2800,15239
24-01-2020,05 - 06,1148,2081,9716,2948,15893
24-01-2020,06 - 07,1308,2442,10919,3316,17985
24-01-2020,07 - 08,1353,2545,11978,3696,19572
24-01-2020,08 - 09,1240,2528,12216,3762,19746
24-01-2020,09 - 10,1362,2394,12273,3809,19838
24-01-2020,10 - 11,1419,2246,12366,3850,19881
24-01-2020,11 - 12,1316,2402,12151,3787,19656
24-01-2020,12 - 13,1325,2454,12056,3762,19597
24-01-2020,13 - 14,1384,2223,11837,3710,19154
24-01-2020,14 - 15,1385,2075,11666,3619,18745
24-01-2020,15 - 16,1320,2083,11576,3575,18554
24-01-2020,16 - 17,1298,2128,11974,3675,19075
24-01-2020,17 - 18,1341,2242,12310,3679,19572
24-01-2020,18 - 19,1311,2178,12100,3518,19107
24-01-2020,19 - 20,1341,2180,11645,3317,18483
24-01-2020,20 - 21,1313,2107,11252,3158,17830
24-01-2020,21 - 22,1300,1965,10828,3046,17139
24-01-2020,22 - 23,1274,2115,10475,2935,16799
24-01-2020,23 - 00,1225,1957,9959,2791,15932
25-01-2020,00 - 01,1170,1997,9580,2699,15446
25-01-2020,01 - 02,1126,1838,9390,2626,14980
25-01-2020,02 - 03,1186,1819,9293,2596,14894
25-01-2020,03 - 04,1132,1915,9302,2581,14930
25-01-2020,04 - 05,1049,1908,9471,2625,15053
25-01-2020,05 - 06,1156,1912,9606,2614,15288
25-01-2020,06 - 07,1234,2118,9960,2709,16021
25-01-2020,07 - 08,1288,2097,10492,2910,16787
25-01-2020,08 - 09,1279,2073,10852,3012,17216
25-01-2020,09 - 10,1276,2094,11234,3087,17691
25-01-2020,10 - 11,1330,2184,11325,3163,18002
25-01-2020,11 - 12,1381,2333,11446,3162,18322
25-01-2020,12 - 13,1402,2350,11373,3115,18240
25-01-2020,13 - 14,1368,2352,11191,3077,17988
25-01-2020,14 - 15,1392,2279,11053,2996,17720
25-01-2020,15 - 16,1451,2096,11109,3011,17667
25-01-2020,16 - 17,1364,1987,11522,3169,18042
25-01-2020,17 - 18,1388,2148,11850,3281,18667
25-01-2020,18 - 19,1557,2187,11705,3229,18678
25-01-2020,19 - 20,1538,1898,11336,3119,17891
25-01-2020,20 - 21,1370,1858,10778,2989,16995
25-01-2020,21 - 22,1275,1779,10271,2787,16112
25-01-2020,22 - 23,1247,1482,9895,2666,15290
25-01-2020,23 - 00,1382,1452,9393,2570,14797
26-01-2020,00 - 01,1170,1467,8981,2586,14204
26-01-2020,01 - 02,1132,1550,8834,2455,13971
26-01-2020,02 - 03,1192,1617,8751,2464,14024
26-01-2020,03 - 04,1191,1691,8647,2453,13982
26-01-2020,04 - 05,1088,1717,8620,2453,13878
26-01-2020,05 - 06,1053,1643,8799,2474,13969
26-01-2020,06 - 07,1131,1736,9001,2548,14416
26-01-2020,07 - 08,1193,1813,9294,2680,14980
26-01-2020,08 - 09,1331,1881,9654,2796,15662
26-01-2020,09 - 10,1404,2031,10029,2921,16385
26-01-2020,10 - 11,1407,2069,10394,3038,16908
26-01-2020,11 - 12,1399,2173,10779,3127,17478
26-01-2020,12 - 13,1405,2202,10793,3119,17519
26-01-2020,13 - 14,1496,2140,10759,3103,17498
26-01-2020,14 - 15,1418,2100,10672,3132,17322
26-01-2020,15 - 16,1493,2303,10955,3187,17938
26-01-2020,16 - 17,1457,2454,11431,3287,18629
26-01-2020,17 - 18,1513,2545,11776,3464,19298
26-01-2020,18 - 19,1476,2483,11622,3472,19053
26-01-2020,19 - 20,1448,2456,11323,3327,18554
26-01-2020,20 - 21,1462,2418,10844,3200,17924
26-01-2020,21 - 22,1478,2358,10322,3084,17242
26-01-2020,22 - 23,1445,2295,9815,2954,16509
26-01-2020,23 - 00,1362,2228,9429,2835,15854
27-01-2020,00 - 01,1369,2127,9263,2769,15528
27-01-2020,01 - 02,1318,2135,9171,2712,15336
27-01-2020,02 - 03,1345,2014,9029,2719,15107
27-01-2020,03 - 04,1356,2123,9053,2746,15278
27-01-2020,04 - 05,1291,2055,9169,2818,15333
27-01-2020,05 - 06,1253,2203,9767,3007,16230
27-01-2020,06 - 07,1435,2567,11152,3371,18525
27-01-2020,07 - 08,1453,2743,12329,3778,20303
27-01-2020,08 - 09,1438,2702,12603,3879,20622
27-01-2020,09 - 10,1525,2641,12512,3904,20582
27-01-2020,10 - 11,1454,2641,12693,3959,20747
27-01-2020,11 - 12,1459,2683,12762,3980,20884
27-01-2020,12 - 13,1449,2725,12656,3926,20756
27-01-2020,13 - 14,1491,2651,12633,3891,20666
27-01-2020,14 - 15,1485,2693,12647,3897,20722
27-01-2020,15 - 16,1488,2784,12873,3935,21080
27-01-2020,16 - 17,1613,2787,13063,3911,21374
27-01-2020,17 - 18,1597,2674,13359,3955,21585
27-01-2020,18 - 19,1463,2722,13062,3849,21096
27-01-2020,19 - 20,1425,2666,12681,3691,20463
27-01-2020,20 - 21,1509,2561,12190,3510,19770
27-01-2020,21 - 22,1431,2518,11530,3395,18874
27-01-2020,22 - 23,1415,2427,10819,3232,17893
27-01-2020,23 - 00,1456,2363,10214,3018,17051
28-01-2020,00 - 01,1330,2252,9717,2840,16139
28-01-2020,01 - 02,1280,2040,9498,2775,15593
28-01-2020,02 - 03,1279,2059,9424,2757,15519
28-01-2020,03 - 04,1281,2043,9366,2735,15425
28-01-2020,04 - 05,1414,2048,9534,2750,15746
28-01-2020,05 - 06,1374,2061,10095,2878,16408
28-01-2020,06 - 07,1442,2485,11394,3297,18618
28-01-2020,07 - 08,1555,2613,12498,3686,20352
28-01-2020,08 - 09,1491,2476,12642,3695,20304
28-01-2020,09 - 10,1468,2406,12573,3719,20166
28-01-2020,10 - 11,1509,2456,12473,3754,20192
28-01-2020,11 - 12,1444,2458,12530,3784,20216
28-01-2020,12 - 13,1487,2323,12440,3772,20022
28-01-2020,13 - 14,1458,2272,12421,3763,19914
28-01-2020,14 - 15,1476,2296,12468,3687,19927
28-01-2020,15 - 16,1577,2383,12588,3661,20209
28-01-2020,16 - 17,1534,2431,12924,3691,20580
28-01-2020,17 - 18,1571,2445,13267,3810,21093
28-01-2020,18 - 19,1536,2316,13054,3777,20683
28-01-2020,19 - 20,1400,2345,12809,3672,20226
28-01-2020,20 - 21,1386,2348,12318,3528,19580
28-01-2020,21 - 22,1404,2353,11679,3364,18800
28-01-2020,22 - 23,1314,2346,10964,3162,17786
28-01-2020,23 - 00,1251,2366,10373,2984,16974
29-01-2020,00 - 01,1254,2249,9843,2826,16172
29-01-2020,01 - 02,1233,2233,9725,2747,15938
29-01-2020,02 - 03,1229,2270,9644,2692,15835
29-01-2020,03 - 04,1198,2410,9659,2709,15976
29-01-2020,04 - 05,1280,2303,9776,2709,16068
29-01-2020,05 - 06,1363,2309,10328,2879,16879
29-01-2020,06 - 07,1338,2442,11728,3290,18798
29-01-2020,07 - 08,1423,2589,12809,3725,20546
29-01-2020,08 - 09,1483,2619,12952,3770,20824
29-01-2020,09 - 10,1542,2661,12877,3684,20764
29-01-2020,10 - 11,1489,2681,13024,3714,20908
29-01-2020,11 - 12,1442,2705,12939,3686,20772
29-01-2020,12 - 13,1475,2798,12858,3633,20764
29-01-2020,13 - 14,1440,2759,12798,3661,20658
29-01-2020,14 - 15,1406,2670,12865,3651,20592
29-01-2020,15 - 16,1433,2641,12974,3734,20782
29-01-2020,16 - 17,1472,2735,13089,3756,21052
29-01-2020,17 - 18,1459,2729,13340,3906,21434
29-01-2020,18 - 19,1418,2498,13163,3776,20855
29-01-2020,19 - 20,1381,2395,12832,3619,20227
29-01-2020,20 - 21,1311,2301,12504,3451,19567
29-01-2020,21 - 22,1376,2281,11865,3343,18865
29-01-2020,22 - 23,1382,2254,11222,3117,17975
29-01-2020,23 - 00,1288,2134,10622,2880,16924
30-01-2020,00 - 01,1305,2155,10284,2714,16458
30-01-2020,01 - 02,1261,2104,10019,2768,16152
30-01-2020,02 - 03,1292,2072,9859,2792,16015
30-01-2020,03 - 04,1284,2069,9862,2765,15980
30-01-2020,04 - 05,1335,2122,10071,2826,16354
30-01-2020,05 - 06,1376,2187,10628,2987,17178
30-01-2020,06 - 07,1444,2326,11909,3456,19135
30-01-2020,07 - 08,1529,2445,13086,3822,20882
30-01-2020,08 - 09,1518,2521,13215,3823,21077
30-01-2020,09 - 10,1538,2439,13131,3745,20853
30-01-2020,10 - 11,1533,2428,13190,3784,20935
30-01-2020,11 - 12,1512,2449,13053,3725,20739
30-01-2020,12 - 13,1506,2369,12985,3631,20491
30-01-2020,13 - 14,1515,2351,12887,3629,20382
30-01-2020,14 - 15,1488,2354,12804,3650,20296
30-01-2020,15 - 16,1529,2425,12933,3617,20504
30-01-2020,16 - 17,1531,2534,13228,3661,20954
30-01-2020,17 - 18,1568,2683,13644,3791,21686
30-01-2020,18 - 19,1567,2612,13438,3761,21378
30-01-2020,19 - 20,1462,2481,13053,3601,20597
30-01-2020,20 - 21,1452,2424,12576,3446,19898
30-01-2020,21 - 22,1392,2326,11871,3244,18833
30-01-2020,22 - 23,1375,2310,11248,2942,17875
30-01-2020,23 - 00,1267,2275,10590,2665,16797
31-01-2020,00 - 01,1428,2117,10315,2650,16510
31-01-2020,01 - 02,1320,2188,10201,2663,16372
31-01-2020,02 - 03,1338,2126,10013,2601,16078
31-01-2020,03 - 04,1303,2250,10035,2494,16082
31-01-2020,04 - 05,1323,2293,10242,2555,16413
31-01-2020,05 - 06,1348,2371,10707,2783,17209
31-01-2020,06 - 07,1468,2598,12020,3240,19326
31-01-2020,07 - 08,1471,2705,13066,3623,20865
31-01-2020,08 - 09,1524,2684,13211,3697,21116
31-01-2020,09 - 10,1433,2702,13178,3683,20996
31-01-2020,10 - 11,1443,2686,13161,3751,21041
31-01-2020,11 - 12,1421,2747,13097,3733,20998
31-01-2020,12 - 13,1474,2648,12975,3640,20737
31-01-2020,13 - 14,1505,2547,12927,3593,20572
31-01-2020,14 - 15,1579,2624,12802,3432,20437
31-01-2020,15 - 16,1546,2634,12723,3464,20367
31-01-2020,16 - 17,1669,2650,12877,3634,20830
31-01-2020,17 - 18,1595,2501,13067,3704,20867
31-01-2020,18 - 19,1541,2484,12674,3583,20282
31-01-2020,19 - 20,1502,2413,12142,3428,19485
31-01-2020,20 - 21,1499,2324,11603,3303,18729
31-01-2020,21 - 22,1478,2299,11029,3102,17908
31-01-2020,22 - 23,1445,2227,10469,2942,17083
31-01-2020,23 - 00,1350,2291,10133,2762,16536
01-02-2020,00 - 01,1307,2225,9700,2615,15847
01-02-2020,01 - 02,1315,2088,9435,2531,15369
01-02-2020,02 - 03,1302,2064,9116,2401,14883
01-02-2020,03 - 04,1309,2098,9101,2372,14880
01-02-2020,04 - 05,1279,2126,9015,2350,14770
01-02-2020,05 - 06,1388,2102,9152,2384,15026
01-02-2020,06 - 07,1425,2224,9485,2506,15640
01-02-2020,07 - 08,1404,2220,9853,2695,16172
01-02-2020,08 - 09,1367,2156,10079,2875,16477
01-02-2020,09 - 10,1519,2191,10598,2887,17195
01-02-2020,10 - 11,1433,2339,10917,2954,17643
01-02-2020,11 - 12,1404,2301,10955,3008,17668
01-02-2020,12 - 13,1480,2360,10863,2966,17669
01-02-2020,13 - 14,1546,2178,10669,2903,17296
01-02-2020,14 - 15,1515,2091,10677,2879,17162
01-02-2020,15 - 16,1452,2041,10773,2887,17153
01-02-2020,16 - 17,1471,2339,11193,2971,17974
01-02-2020,17 - 18,1500,2705,11631,3125,18961
01-02-2020,18 - 19,1492,2577,11453,3081,18603
01-02-2020,19 - 20,1513,2352,11045,3001,17911
01-02-2020,20 - 21,1525,2303,10644,2888,17360
01-02-2020,21 - 22,1483,2173,10303,2774,16733
01-02-2020,22 - 23,1387,2023,9833,2660,15903
01-02-2020,23 - 00,1238,1932,9478,2575,15223
02-02-2020,00 - 01,1228,1938,9239,2539,14944
02-02-2020,01 - 02,1265,1992,8986,2473,14716
02-02-2020,02 - 03,1275,1981,8800,2484,14540
02-02-2020,03 - 04,1257,1999,8753,2502,14511
02-02-2020,04 - 05,1232,1909,8799,2520,14460
02-02-2020,05 - 06,1252,1989,8911,2551,14703
02-02-2020,06 - 07,1265,2071,9326,2594,15256
02-02-2020,07 - 08,1285,1918,9774,2703,15680
02-02-2020,08 - 09,1260,2022,10193,2784,16259
02-02-2020,09 - 10,1315,2199,10680,3005,17199
02-02-2020,10 - 11,1364,2153,10890,3092,17499
02-02-2020,11 - 12,1372,2182,10983,3055,17592
02-02-2020,12 - 13,1414,2128,10824,2972,17338
02-02-2020,13 - 14,1397,2131,10770,2945,17243
02-02-2020,14 - 15,1410,2188,10876,2973,17447
02-02-2020,15 - 16,1456,2266,11045,3121,17888
02-02-2020,16 - 17,1502,2305,11598,3285,18690
02-02-2020,17 - 18,1467,2314,12286,3522,19589
02-02-2020,18 - 19,1350,2211,12412,3573,19546
02-02-2020,19 - 20,1177,2166,12308,3478,19129
02-02-2020,20 - 21,1265,2221,12012,3333,18831
02-02-2020,21 - 22,1283,2171,11488,3142,18084
02-02-2020,22 - 23,1303,2060,10931,2990,17284
02-02-2020,23 - 00,1410,1957,10544,2902,16813
03-02-2020,00 - 01,1276,1775,10279,2766,16096
03-02-2020,01 - 02,1256,1990,10226,2686,16158
03-02-2020,02 - 03,1206,2032,10201,2682,16121
03-02-2020,03 - 04,1183,2055,10303,2686,16227
03-02-2020,04 - 05,1214,2083,10464,2756,16517
03-02-2020,05 - 06,1330,1984,11036,3036,17386
03-02-2020,06 - 07,1293,1949,12548,3456,19246
03-02-2020,07 - 08,1360,2356,13692,3835,21243
03-02-2020,08 - 09,1363,2273,13898,3894,21428
03-02-2020,09 - 10,1360,2375,13876,3881,21492
03-02-2020,10 - 11,1292,2316,13727,3865,21200
03-02-2020,11 - 12,1357,2354,13484,3785,20980
03-02-2020,12 - 13,1371,2463,13190,3690,20714
03-02-2020,13 - 14,1363,2571,13037,3635,20606
03-02-2020,14 - 15,1355,2592,12948,3627,20522
03-02-2020,15 - 16,1349,2588,13242,3695,20874
03-02-2020,16 - 17,1394,2685,13678,3703,21460
03-02-2020,17 - 18,1406,2747,14244,3860,22257
03-02-2020,18 - 19,1375,2745,14024,3801,21945
03-02-2020,19 - 20,1463,2659,13815,3677,21614
03-02-2020,20 - 21,1311,2633,13377,3497,20818
03-02-2020,21 - 22,1321,2571,12819,3334,20045
03-02-2020,22 - 23,1360,2436,12028,3130,18954
03-02-2020,23 - 00,1314,2363,11469,2908,18054
04-02-2020,00 - 01,1386,2218,11089,2742,17435
04-02-2020,01 - 02,1369,2210,10950,2728,17257
04-02-2020,02 - 03,1344,2242,10912,2707,17205
04-02-2020,03 - 04,1505,2244,10995,2746,17490
04-02-2020,04 - 05,1445,2401,11179,2863,17888
04-02-2020,05 - 06,1412,2412,11595,3088,18507
04-02-2020,06 - 07,1549,2649,12810,3499,20507
04-02-2020,07 - 08,1669,2931,13904,3871,22375
04-02-2020,08 - 09,1904,2887,13867,3855,22513
04-02-2020,09 - 10,1861,2783,13876,3884,22404
04-02-2020,10 - 11,1799,2754,13899,3859,22311
04-02-2020,11 - 12,1745,2629,13822,3866,22062
04-02-2020,12 - 13,1604,2604,13781,3818,21807
04-02-2020,13 - 14,1573,2660,13693,3886,21812
04-02-2020,14 - 15,1345,2734,13525,3826,21430
04-02-2020,15 - 16,1137,2613,13601,3778,21129
04-02-2020,16 - 17,1183,2540,13790,3774,21287
04-02-2020,17 - 18,1358,2559,14149,3884,21950
04-02-2020,18 - 19,1341,2180,13990,3745,21256
04-02-2020,19 - 20,1349,2251,13660,3680,20940
04-02-2020,20 - 21,1407,2232,13337,3514,20490
04-02-2020,21 - 22,1398,2230,12787,3375,19790
04-02-2020,22 - 23,1361,2139,12043,3216,18759
04-02-2020,23 - 00,1299,2121,11506,3096,18022
05-02-2020,00 - 01,1392,2006,11123,3023,17544
05-02-2020,01 - 02,1403,1865,11094,2977,17339
05-02-2020,02 - 03,1258,1913,11077,2915,17163
05-02-2020,03 - 04,1160,1861,11087,2960,17068
05-02-2020,04 - 05,1297,2235,11259,3001,17792
05-02-2020,05 - 06,1304,2315,11876,3230,18725
05-02-2020,06 - 07,1393,2488,13241,3712,20834
05-02-2020,07 - 08,1384,2539,14193,4120,22236
05-02-2020,08 - 09,1371,2368,14111,4005,21855
05-02-2020,09 - 10,1434,2373,13990,3854,21651
05-02-2020,10 - 11,1442,2493,13982,3825,21742
05-02-2020,11 - 12,1442,2358,13632,3750,21182
05-02-2020,12 - 13,1292,2435,13062,3585,20374
05-02-2020,13 - 14,1432,2354,12745,3548,20079
05-02-2020,14 - 15,1447,2114,12682,3639,19882
05-02-2020,15 - 16,1345,2418,12875,3629,20267
05-02-2020,16 - 17,1332,2441,13195,3586,20554
05-02-2020,17 - 18,1370,2251,13620,3716,20957
05-02-2020,18 - 19,1345,2002,13406,3677,20430
05-02-2020,19 - 20,1379,1979,12979,3577,19914
05-02-2020,20 - 21,1333,2011,12453,3422,19219
05-02-2020,21 - 22,1352,1936,11938,3284,18510
05-02-2020,22 - 23,1311,2050,11370,3094,17825
05-02-2020,23 - 00,1280,2129,10830,2888,17127
06-02-2020,00 - 01,1253,2141,10255,2757,16406
06-02-2020,01 - 02,1275,1937,10078,2684,15974
06-02-2020,02 - 03,1295,1985,9976,2634,15890
06-02-2020,03 - 04,1290,2071,9935,2634,15930
06-02-2020,04 - 05,1332,2035,10228,2654,16249
06-02-2020,05 - 06,1280,2051,10900,2848,17079
06-02-2020,06 - 07,1474,2272,12190,3311,19247
06-02-2020,07 - 08,1515,2466,13303,3692,20976
06-02-2020,08 - 09,1403,2520,13351,3767,21041
06-02-2020,09 - 10,1424,2539,13315,3790,21068
06-02-2020,10 - 11,1497,2485,13142,3766,20890
06-02-2020,11 - 12,1497,2539,12859,3710,20605
06-02-2020,12 - 13,1536,2595,12672,3648,20451
06-02-2020,13 - 14,1502,2548,12601,3680,20331
06-02-2020,14 - 15,1408,2552,12547,3688,20195
06-02-2020,15 - 16,1366,2552,12685,3671,20274
06-02-2020,16 - 17,1377,2578,13015,3639,20609
06-02-2020,17 - 18,1367,2709,13665,3730,21471
06-02-2020,18 - 19,1429,2686,13677,3759,21551
06-02-2020,19 - 20,1494,2627,13345,3693,21159
06-02-2020,20 - 21,1652,2584,13087,3593,20916
06-02-2020,21 - 22,1510,2616,12658,3412,20196
06-02-2020,22 - 23,1415,2557,12127,3216,19315
06-02-2020,23 - 00,1367,2376,11622,3061,18426
07-02-2020,00 - 01,1308,2138,11335,2987,17768
07-02-2020,01 - 02,1184,1807,11105,2943,17039
07-02-2020,02 - 03,1104,1528,11038,2954,16624
07-02-2020,03 - 04,1090,1585,11056,2972,16703
07-02-2020,04 - 05,1167,1842,11089,3001,17099
07-02-2020,05 - 06,1186,2073,11554,3152,17965
07-02-2020,06 - 07,1399,2199,12608,3536,19742
07-02-2020,07 - 08,1351,2247,13501,3810,20909
07-02-2020,08 - 09,1289,2249,13549,3882,20969
07-02-2020,09 - 10,1430,2246,13536,3898,21110
07-02-2020,10 - 11,1440,2073,13472,3888,20873
07-02-2020,11 - 12,1387,2204,13482,3836,20909
07-02-2020,12 - 13,1410,2401,13362,3719,20892
07-02-2020,13 - 14,1369,2445,13050,3643,20507
07-02-2020,14 - 15,1392,2358,12841,3613,20204
07-02-2020,15 - 16,1350,2126,12735,3615,19826
07-02-2020,16 - 17,1439,2412,12931,3626,20408
07-02-2020,17 - 18,1417,2673,13280,3743,21113
07-02-2020,18 - 19,1322,2636,13160,3613,20731
07-02-2020,19 - 20,1310,2604,12634,3454,20002
07-02-2020,20 - 21,1297,2403,12012,3270,18982
07-02-2020,21 - 22,1382,2425,11381,3073,18261
07-02-2020,22 - 23,1475,2357,10815,2916,17563
07-02-2020,23 - 00,1363,2108,10334,2837,16642
08-02-2020,00 - 01,1170,2006,10082,2717,15975
08-02-2020,01 - 02,1194,1751,9874,2627,15446
08-02-2020,02 - 03,1251,1517,9683,2600,15051
08-02-2020,03 - 04,1374,1520,9639,2620,15153
08-02-2020,04 - 05,1213,1317,9689,2638,14857
08-02-2020,05 - 06,1237,1410,9902,2670,15219
08-02-2020,06 - 07,1222,1433,10196,2819,15670
08-02-2020,07 - 08,1170,1598,10744,3026,16538
08-02-2020,08 - 09,1231,1730,11180,3155,17296
08-02-2020,09 - 10,1306,2017,11736,3268,18327
08-02-2020,10 - 11,1224,2138,12010,3287,18659
08-02-2020,11 - 12,1105,2257,12120,3329,18811
08-02-2020,12 - 13,1406,2219,12170,3295,19090
08-02-2020,13 - 14,1578,2183,12072,3252,19085
08-02-2020,14 - 15,1506,2033,11986,3241,18766
08-02-2020,15 - 16,1282,2046,11906,3299,18533
08-02-2020,16 - 17,1451,2131,12222,3359,19163
08-02-2020,17 - 18,1492,2066,12638,3557,19753
08-02-2020,18 - 19,1256,2018,12438,3532,19244
08-02-2020,19 - 20,1267,2063,12048,3386,18764
08-02-2020,20 - 21,1301,1808,11554,3249,17912
08-02-2020,21 - 22,1464,1769,11070,3077,17380
08-02-2020,22 - 23,1235,1735,10703,2944,16617
08-02-2020,23 - 00,1174,1631,10501,2781,16087
09-02-2020,00 - 01,1292,1539,10081,2658,15570
09-02-2020,01 - 02,1327,1671,9736,2632,15366
09-02-2020,02 - 03,1241,1723,9495,2594,15053
09-02-2020,03 - 04,1290,1677,9469,2624,15060
09-02-2020,04 - 05,1239,1798,9393,2581,15011
09-02-2020,05 - 06,1080,1701,9539,2574,14894
09-02-2020,06 - 07,1075,1781,9682,2651,15189
09-02-2020,07 - 08,1238,1888,9954,2760,15840
09-02-2020,08 - 09,1321,1908,10239,2826,16294
09-02-2020,09 - 10,1452,1991,10726,2969,17138
09-02-2020,10 - 11,1504,1916,11104,2963,17487
09-02-2020,11 - 12,1431,2090,11396,3035,17952
09-02-2020,12 - 13,1376,2067,11502,3122,18067
09-02-2020,13 - 14,1385,1922,11508,3163,17978
09-02-2020,14 - 15,1413,1930,11622,3211,18176
09-02-2020,15 - 16,1369,1971,11779,3291,18410
09-02-2020,16 - 17,1410,2049,12105,3403,18967
09-02-2020,17 - 18,1373,2067,12460,3471,19371
09-02-2020,18 - 19,1369,2042,12386,3427,19224
09-02-2020,19 - 20,1406,2048,12073,3341,18868
09-02-2020,20 - 21,1517,2090,11709,3255,18571
09-02-2020,21 - 22,1403,1988,11164,3133,17688
09-02-2020,22 - 23,1356,1906,10614,3024,16900
09-02-2020,23 - 00,1252,1851,10110,2855,16068
10-02-2020,00 - 01,1291,1897,9728,2779,15695
10-02-2020,01 - 02,1350,1873,9545,2731,15499
10-02-2020,02 - 03,1335,1916,9603,2710,15564
10-02-2020,03 - 04,1376,1903,9604,2694,15577
10-02-2020,04 - 05,1294,1811,9763,2677,15545
10-02-2020,05 - 06,1286,1946,10350,2787,16369
10-02-2020,06 - 07,1691,2202,11429,3207,18529
10-02-2020,07 - 08,1517,2377,12441,3576,19911
10-02-2020,08 - 09,1474,2370,12513,3703,20060
10-02-2020,09 - 10,1468,2456,12599,3666,20189
10-02-2020,10 - 11,1538,2422,12658,3665,20283
10-02-2020,11 - 12,1360,2324,12610,3653,19947
10-02-2020,12 - 13,1470,2334,12496,3652,19952
10-02-2020,13 - 14,1594,2181,12371,3655,19801
10-02-2020,14 - 15,1535,2186,12425,3672,19818
10-02-2020,15 - 16,1374,2269,12547,3667,19857
10-02-2020,16 - 17,1436,2248,12809,3703,20196
10-02-2020,17 - 18,1574,2295,13293,3853,21015
10-02-2020,18 - 19,1566,2329,13209,3821,20925
10-02-2020,19 - 20,1355,2213,12880,3703,20151
10-02-2020,20 - 21,1262,2180,12380,3549,19371
10-02-2020,21 - 22,1339,2203,11830,3459,18831
10-02-2020,22 - 23,1187,2158,11301,3372,18018
10-02-2020,23 - 00,1051,1949,10662,3166,16828
11-02-2020,00 - 01,1224,1841,10320,3062,16447
11-02-2020,01 - 02,1272,1789,10177,2977,16215
11-02-2020,02 - 03,1229,1908,10277,2910,16324
11-02-2020,03 - 04,1240,1873,10299,2974,16386
11-02-2020,04 - 05,1271,1960,10291,3000,16522
11-02-2020,05 - 06,1370,2039,10809,3141,17359
11-02-2020,06 - 07,1404,2122,12103,3632,19261
11-02-2020,07 - 08,1350,2287,13065,4023,20725
11-02-2020,08 - 09,1216,2335,13085,4043,20679
11-02-2020,09 - 10,1332,2360,13036,3979,20707
11-02-2020,10 - 11,1395,2647,12923,4051,21016
11-02-2020,11 - 12,1250,2601,12980,4061,20892
11-02-2020,12 - 13,1265,2595,12973,3913,20746
11-02-2020,13 - 14,1285,2565,12843,3863,20556
11-02-2020,14 - 15,1316,2558,12913,3957,20744
11-02-2020,15 - 16,1354,2375,13003,3980,20712
11-02-2020,16 - 17,1322,2345,13184,3896,20747
11-02-2020,17 - 18,1307,2354,13568,3998,21227
11-02-2020,18 - 19,1185,2340,13329,3970,20824
11-02-2020,19 - 20,1200,2399,12953,3921,20473
11-02-2020,20 - 21,1134,2264,12567,3723,19688
11-02-2020,21 - 22,1080,2147,12046,3523,18796
11-02-2020,22 - 23,1161,2174,11309,3307,17951
11-02-2020,23 - 00,1257,2122,10621,3081,17081
12-02-2020,00 - 01,1164,2149,10325,2892,16530
12-02-2020,01 - 02,1210,2021,10103,2821,16155
12-02-2020,02 - 03,1180,1960,10076,2843,16059
12-02-2020,03 - 04,1111,2108,10215,2860,16294
12-02-2020,04 - 05,1244,2106,10427,2883,16660
12-02-2020,05 - 06,1336,1910,10947,3104,17297
12-02-2020,06 - 07,1276,2310,12153,3495,19234
12-02-2020,07 - 08,1244,2311,12905,3854,20314
12-02-2020,08 - 09,1263,2185,12939,3855,20242
12-02-2020,09 - 10,1415,2191,12788,3867,20261
12-02-2020,10 - 11,1502,2200,12719,3898,20319
12-02-2020,11 - 12,1435,2168,12646,3876,20125
12-02-2020,12 - 13,1381,2174,12566,3806,19927
12-02-2020,13 - 14,1314,2179,12494,3724,19711
12-02-2020,14 - 15,1335,2195,12437,3710,19677
12-02-2020,15 - 16,1296,2285,12488,3708,19777
12-02-2020,16 - 17,1409,2232,12760,3743,20144
12-02-2020,17 - 18,1489,2146,13340,3936,20911
12-02-2020,18 - 19,1492,2060,13147,3848,20547
12-02-2020,19 - 20,1452,2117,12833,3731,20133
12-02-2020,20 - 21,1434,1966,12430,3611,19441
12-02-2020,21 - 22,1410,1938,11975,3487,18810
12-02-2020,22 - 23,1348,1966,11387,3268,17969
12-02-2020,23 - 00,1341,1902,10862,3131,17236
13-02-2020,00 - 01,1287,1735,10536,3054,16612
13-02-2020,01 - 02,1295,1782,10386,2977,16440
13-02-2020,02 - 03,1261,1860,10377,2895,16393
13-02-2020,03 - 04,1306,1923,10422,2820,16471
13-02-2020,04 - 05,1308,1983,10583,2881,16755
13-02-2020,05 - 06,1258,2106,11167,3056,17587
13-02-2020,06 - 07,1458,2401,12541,3501,19901
13-02-2020,07 - 08,1542,2512,13551,3805,21410
13-02-2020,08 - 09,1580,2576,13617,3807,21580
13-02-2020,09 - 10,1495,2722,13318,3791,21326
13-02-2020,10 - 11,1445,2567,13156,3732,20900
13-02-2020,11 - 12,1441,2571,12940,3705,20657
13-02-2020,12 - 13,1478,2509,12629,3674,20290
13-02-2020,13 - 14,1512,2398,12381,3676,19967
13-02-2020,14 - 15,1565,2467,12443,3629,20104
13-02-2020,15 - 16,1588,2397,12601,3687,20273
13-02-2020,16 - 17,1505,2344,12919,3717,20485
13-02-2020,17 - 18,1491,2293,13606,3873,21263
13-02-2020,18 - 19,1436,2021,13457,3792,20706
13-02-2020,19 - 20,1439,2006,13194,3694,20333
13-02-2020,20 - 21,1410,2021,12808,3592,19831
13-02-2020,21 - 22,1445,1901,12584,3490,19420
13-02-2020,22 - 23,1369,1983,12103,3336,18791
13-02-2020,23 - 00,1376,1942,11453,3183,17954
14-02-2020,00 - 01,1353,2151,11105,3127,17736
14-02-2020,01 - 02,1294,2152,11100,3075,17621
14-02-2020,02 - 03,1205,2297,11170,3070,17742
14-02-2020,03 - 04,1240,2324,11226,3068,17858
14-02-2020,04 - 05,1331,2390,11510,3077,18308
14-02-2020,05 - 06,1476,2494,11981,3205,19156
14-02-2020,06 - 07,1542,2583,13114,3627,20866
14-02-2020,07 - 08,1531,2701,14043,3935,22210
14-02-2020,08 - 09,1514,2566,14220,3989,22289
14-02-2020,09 - 10,1541,2422,14047,3936,21946
14-02-2020,10 - 11,1492,2377,13805,3815,21489
14-02-2020,11 - 12,1469,2353,13648,3674,21144
14-02-2020,12 - 13,1516,2369,13009,3507,20401
14-02-2020,13 - 14,1309,2464,12811,3426,20010
14-02-2020,14 - 15,1274,2416,12726,3366,19782
14-02-2020,15 - 16,1269,2441,13000,3379,20089
14-02-2020,16 - 17,1265,2508,13162,3433,20368
14-02-2020,17 - 18,1389,2555,13710,3655,21309
14-02-2020,18 - 19,1412,2360,13223,3606,20601
14-02-2020,19 - 20,1348,2166,12705,3474,19693
14-02-2020,20 - 21,1321,1888,12121,3247,18577
14-02-2020,21 - 22,1435,1872,11635,3024,17966
14-02-2020,22 - 23,1374,1985,10990,2920,17269
14-02-2020,23 - 00,1212,1794,10381,2824,16211
15-02-2020,00 - 01,1322,1785,10175,2758,16040
15-02-2020,01 - 02,1335,1668,10028,2679,15710
15-02-2020,02 - 03,1334,1819,10029,2660,15842
15-02-2020,03 - 04,1307,1933,9952,2717,15909
15-02-2020,04 - 05,1282,1967,9938,2737,15924
15-02-2020,05 - 06,1219,1816,10117,2782,15934
15-02-2020,06 - 07,1287,1942,10446,2848,16523
15-02-2020,07 - 08,1476,2016,10748,2984,17224
15-02-2020,08 - 09,1413,2119,11080,3151,17763
15-02-2020,09 - 10,1347,2059,11693,3296,18395
15-02-2020,10 - 11,1402,1988,11870,3355,18615
15-02-2020,11 - 12,1535,2003,12024,3422,18984
15-02-2020,12 - 13,1442,1760,11733,3408,18343
15-02-2020,13 - 14,1368,1710,11590,3418,18086
15-02-2020,14 - 15,1280,1846,11442,3376,17944
15-02-2020,15 - 16,1387,1981,11297,3349,18014
15-02-2020,16 - 17,1388,2162,11861,3397,18808
15-02-2020,17 - 18,1351,2200,12237,3565,19353
15-02-2020,18 - 19,1227,2236,12132,3468,19063
15-02-2020,19 - 20,1156,2079,11681,3259,18175
15-02-2020,20 - 21,1163,1956,11184,3064,17367
15-02-2020,21 - 22,1185,1704,10771,2944,16604
15-02-2020,22 - 23,1072,1432,10243,2804,15551
15-02-2020,23 - 00,1076,1604,9894,2672,15246
16-02-2020,00 - 01,1083,1534,9587,2613,14817
16-02-2020,01 - 02,1254,1566,9278,2572,14670
16-02-2020,02 - 03,1395,1671,9157,2543,14766
16-02-2020,03 - 04,1315,1792,9089,2501,14697
16-02-2020,04 - 05,1195,1843,9044,2513,14595
16-02-2020,05 - 06,1138,1854,9100,2516,14608
16-02-2020,06 - 07,1266,1824,9288,2594,14972
16-02-2020,07 - 08,1446,1891,9571,2675,15583
16-02-2020,08 - 09,1500,1904,9985,2746,16135
16-02-2020,09 - 10,1351,1883,10408,2907,16549
16-02-2020,10 - 11,1350,2083,10850,3006,17289
16-02-2020,11 - 12,1370,1950,11169,3128,17617
16-02-2020,12 - 13,1312,1838,11275,3162,17587
16-02-2020,13 - 14,1333,2035,11216,3154,17738
16-02-2020,14 - 15,1410,2161,11140,3120,17831
16-02-2020,15 - 16,1361,2337,11145,3104,17947
16-02-2020,16 - 17,1345,2422,11339,3164,18270
16-02-2020,17 - 18,1422,2426,11888,3345,19081
16-02-2020,18 - 19,1570,2435,11875,3406,19286
16-02-2020,19 - 20,1564,2162,11715,3489,18930
16-02-2020,20 - 21,1502,2051,11358,3524,18435
16-02-2020,21 - 22,1474,2104,10889,3302,17769
16-02-2020,22 - 23,1400,2208,10354,3151,17113
16-02-2020,23 - 00,1377,2243,9917,2880,16417
17-02-2020,00 - 01,1318,2082,9567,2577,15544
17-02-2020,01 - 02,1327,2011,9393,2507,15238
17-02-2020,02 - 03,1267,2091,9273,2619,15250
17-02-2020,03 - 04,1185,1983,9377,2630,15175
17-02-2020,04 - 05,1196,2015,9533,2671,15415
17-02-2020,05 - 06,1337,1973,10231,2892,16433
17-02-2020,06 - 07,1514,2123,11513,3339,18489
17-02-2020,07 - 08,1415,2369,12654,3664,20102
17-02-2020,08 - 09,1303,2410,12874,3745,20332
17-02-2020,09 - 10,1462,2372,12820,3717,20371
17-02-2020,10 - 11,1298,2512,12833,3779,20422
17-02-2020,11 - 12,1372,2406,12903,3774,20455
17-02-2020,12 - 13,1012,2246,12843,3758,19859
17-02-2020,13 - 14,1527,2002,12680,3735,19944
17-02-2020,14 - 15,1387,1990,12673,3695,19745
17-02-2020,15 - 16,1135,1870,12725,3707,19437
17-02-2020,16 - 17,1260,2026,12927,3686,19899
17-02-2020,17 - 18,1285,2092,13496,3860,20733
17-02-2020,18 - 19,1353,2166,13294,3838,20651
17-02-2020,19 - 20,1182,2265,12793,3692,19932
17-02-2020,20 - 21,1238,2298,12280,3511,19327
17-02-2020,21 - 22,1410,2055,11710,3337,18512
17-02-2020,22 - 23,1360,1961,10966,3160,17447
17-02-2020,23 - 00,1309,1870,10325,2974,16478
18-02-2020,00 - 01,1230,1742,9856,2841,15669
18-02-2020,01 - 02,1286,1756,9691,2776,15509
18-02-2020,02 - 03,1360,1916,9594,2706,15576
18-02-2020,03 - 04,1275,1775,9649,2665,15364
18-02-2020,04 - 05,1332,1798,9709,2731,15570
18-02-2020,05 - 06,1212,1790,9758,2862,15622
18-02-2020,06 - 07,1314,2074,11020,3226,17634
18-02-2020,07 - 08,1375,2269,12229,3570,19443
18-02-2020,08 - 09,1318,2111,12319,3653,19401
18-02-2020,09 - 10,1279,2042,12394,3655,19370
18-02-2020,10 - 11,1317,2066,12353,3628,19364
18-02-2020,11 - 12,1274,2142,12301,3603,19320
18-02-2020,12 - 13,1209,2127,12294,3606,19236
18-02-2020,13 - 14,1319,2022,12243,3692,19276
18-02-2020,14 - 15,1210,1904,12023,3719,18856
18-02-2020,15 - 16,1112,2083,12023,3699,18917
18-02-2020,16 - 17,1316,1900,12101,3676,18993
18-02-2020,17 - 18,1304,1963,12613,3763,19643
18-02-2020,18 - 19,1351,2068,12687,3818,19924
18-02-2020,19 - 20,1295,2103,12350,3707,19455
18-02-2020,20 - 21,1281,2018,12034,3531,18864
18-02-2020,21 - 22,1395,1957,11521,3434,18307
18-02-2020,22 - 23,1364,1886,10938,3246,17434
18-02-2020,23 - 00,1272,1896,10310,3048,16526
19-02-2020,00 - 01,1283,1723,9977,2880,15863
19-02-2020,01 - 02,1294,1868,9737,2803,15702
19-02-2020,02 - 03,1337,1851,9707,2808,15703
19-02-2020,03 - 04,1274,1805,9864,2796,15739
19-02-2020,04 - 05,1226,1951,10166,2818,16161
19-02-2020,05 - 06,1243,1882,10748,2962,16835
19-02-2020,06 - 07,1452,2184,11937,3287,18860
19-02-2020,07 - 08,1553,2296,12743,3581,20173
19-02-2020,08 - 09,1528,2288,12815,3668,20299
19-02-2020,09 - 10,1446,2374,12811,3657,20288
19-02-2020,10 - 11,1381,2471,12779,3825,20456
19-02-2020,11 - 12,1403,2443,12530,3888,20264
19-02-2020,12 - 13,1333,2304,12237,3695,19569
19-02-2020,13 - 14,1277,2175,11889,3619,18960
19-02-2020,14 - 15,1307,2255,11639,3537,18738
19-02-2020,15 - 16,1344,2279,11663,3497,18783
19-02-2020,16 - 17,1499,2333,11815,3513,19160
19-02-2020,17 - 18,1636,2379,12646,3664,20325
19-02-2020,18 - 19,1545,2451,13064,3631,20691
19-02-2020,19 - 20,1385,2473,12825,3541,20224
19-02-2020,20 - 21,1369,2457,12456,3419,19701
19-02-2020,21 - 22,1444,2295,11759,3290,18788
19-02-2020,22 - 23,1411,2325,11280,3156,18172
19-02-2020,23 - 00,1409,2195,10907,3062,17573
20-02-2020,00 - 01,1389,1977,10605,2942,16913
20-02-2020,01 - 02,1340,1818,10514,2836,16508
20-02-2020,02 - 03,1249,1698,10513,2804,16264
20-02-2020,03 - 04,1127,1677,10522,2853,16179
20-02-2020,04 - 05,1313,1732,10739,2921,16705
20-02-2020,05 - 06,1294,1832,11377,3109,17612
20-02-2020,06 - 07,1271,2108,12504,3446,19329
20-02-2020,07 - 08,1397,2192,13228,3695,20512
20-02-2020,08 - 09,1490,2147,13278,3700,20615
20-02-2020,09 - 10,1507,2263,13119,3670,20559
20-02-2020,10 - 11,1606,2318,14076,3679,21679
20-02-2020,11 - 12,1415,2339,14049,3649,21452
20-02-2020,12 - 13,1310,2143,12804,3649,19906
20-02-2020,13 - 14,1422,2367,12497,3662,19948
20-02-2020,14 - 15,1422,2262,12590,3702,19976
20-02-2020,15 - 16,1410,2448,12859,3773,20490
20-02-2020,16 - 17,1433,2392,12989,3745,20559
20-02-2020,17 - 18,1467,2298,13531,3816,21112
20-02-2020,18 - 19,1460,2340,13188,3774,20762
20-02-2020,19 - 20,1386,2308,12899,3684,20277
20-02-2020,20 - 21,1447,2223,12438,3581,19689
20-02-2020,21 - 22,1480,2247,11852,3382,18961
20-02-2020,22 - 23,1442,2148,11147,3193,17930
20-02-2020,23 - 00,1244,2034,10512,2963,16753
21-02-2020,00 - 01,1276,2053,9961,2892,16182
21-02-2020,01 - 02,1231,2045,9671,2880,15827
21-02-2020,02 - 03,1199,2018,9588,2897,15702
21-02-2020,03 - 04,1244,2100,9634,2894,15872
21-02-2020,04 - 05,1269,2038,9790,2936,16033
21-02-2020,05 - 06,1306,2230,10306,3047,16889
21-02-2020,06 - 07,1447,2414,11460,3442,18763
21-02-2020,07 - 08,1514,2464,12316,3701,19995
21-02-2020,08 - 09,1574,2448,12542,3813,20377
21-02-2020,09 - 10,1564,2583,12615,3780,20542
21-02-2020,10 - 11,1549,2470,12412,3757,20188
21-02-2020,11 - 12,1429,2286,12227,3664,19606
21-02-2020,12 - 13,1437,2406,12000,3553,19396
21-02-2020,13 - 14,1444,2096,11695,3499,18734
21-02-2020,14 - 15,1394,2101,11658,3501,18654
21-02-2020,15 - 16,1176,2116,11649,3434,18375
21-02-2020,16 - 17,1173,2079,11839,3404,18495
21-02-2020,17 - 18,1237,2148,12326,3596,19307
21-02-2020,18 - 19,1127,2222,12006,3577,18932
21-02-2020,19 - 20,1120,2228,11365,3430,18143
21-02-2020,20 - 21,1136,2084,10703,3238,17161
21-02-2020,21 - 22,1182,1864,10171,3083,16300
21-02-2020,22 - 23,1216,1766,10242,2962,16186
21-02-2020,23 - 00,1217,1824,9795,2862,15698
22-02-2020,00 - 01,1042,1789,9345,2702,14878
22-02-2020,01 - 02,1057,1587,9152,2571,14367
22-02-2020,02 - 03,1068,1445,9033,2558,14104
22-02-2020,03 - 04,1075,1460,9021,2578,14134
22-02-2020,04 - 05,1057,1559,9008,2627,14251
22-02-2020,05 - 06,1088,1750,9102,2757,14697
22-02-2020,06 - 07,1109,1803,9441,2695,15048
22-02-2020,07 - 08,1146,1716,9765,2852,15479
22-02-2020,08 - 09,1171,1894,10255,2999,16319
22-02-2020,09 - 10,1190,1835,10893,3187,17105
22-02-2020,10 - 11,1157,2041,11171,3287,17656
22-02-2020,11 - 12,1221,2214,11352,3336,18123
22-02-2020,12 - 13,1183,2058,11325,3306,17872
22-02-2020,13 - 14,1199,1972,11288,3264,17723
22-02-2020,14 - 15,1285,1981,11140,3212,17618
22-02-2020,15 - 16,1428,2107,11033,3145,17713
22-02-2020,16 - 17,1351,1963,11235,3223,17772
22-02-2020,17 - 18,1419,1920,11771,3387,18497
22-02-2020,18 - 19,1441,2111,11946,3424,18922
22-02-2020,19 - 20,1432,1858,11621,3349,18260
22-02-2020,20 - 21,1421,1897,11161,3222,17701
22-02-2020,21 - 22,1267,1878,10544,3117,16806
22-02-2020,22 - 23,1293,1865,10464,3033,16655
22-02-2020,23 - 00,1306,1921,10102,2926,16255
23-02-2020,00 - 01,1179,1895,9898,2828,15800
23-02-2020,01 - 02,1063,1925,9689,2742,15419
23-02-2020,02 - 03,1197,1827,9655,2710,15389
23-02-2020,03 - 04,1223,1846,9570,2731,15370
23-02-2020,04 - 05,1120,1828,9526,2731,15205
23-02-2020,05 - 06,1127,1858,9605,2759,15349
23-02-2020,06 - 07,1107,2016,9919,2852,15894
23-02-2020,07 - 08,1131,1942,10155,2961,16189
23-02-2020,08 - 09,1259,1849,10483,3054,16645
23-02-2020,09 - 10,1250,2038,10830,3191,17309
23-02-2020,10 - 11,1248,2004,11014,3307,17573
23-02-2020,11 - 12,1191,2090,11020,3403,17704
23-02-2020,12 - 13,1157,2042,11082,3371,17652
23-02-2020,13 - 14,1157,2099,10982,3314,17552
23-02-2020,14 - 15,1141,2210,10897,3301,17549
23-02-2020,15 - 16,1221,2161,11012,3322,17716
23-02-2020,16 - 17,1320,2234,11355,3441,18350
23-02-2020,17 - 18,1411,2485,12064,3691,19651
23-02-2020,18 - 19,1325,2418,12307,3769,19819
23-02-2020,19 - 20,1231,2150,11985,3524,18890
23-02-2020,20 - 21,1303,2149,11625,3254,18331
23-02-2020,21 - 22,1302,2072,11144,3081,17599
23-02-2020,22 - 23,1252,1997,10715,2964,16928
23-02-2020,23 - 00,1212,1962,10375,2818,16367
24-02-2020,00 - 01,1171,1827,9972,2778,15748
24-02-2020,01 - 02,1102,1806,9966,2709,15583
24-02-2020,02 - 03,1128,1840,10170,2718,15856
24-02-2020,03 - 04,1151,1934,10324,2747,16156
24-02-2020,04 - 05,1177,1955,10553,2907,16592
24-02-2020,05 - 06,1285,2007,11064,3048,17404
24-02-2020,06 - 07,1345,2371,12358,3441,19515
24-02-2020,07 - 08,1326,2472,13001,3754,20553
24-02-2020,08 - 09,1384,2335,13069,3759,20547
24-02-2020,09 - 10,1344,2473,12894,3746,20457
24-02-2020,10 - 11,1427,2430,12594,3662,20113
24-02-2020,11 - 12,1410,2293,12419,3608,19730
24-02-2020,12 - 13,1380,2197,12466,3564,19607
24-02-2020,13 - 14,1343,2238,12418,3563,19562
24-02-2020,14 - 15,1330,2213,12523,3554,19620
24-02-2020,15 - 16,1341,2436,12301,3618,19696
24-02-2020,16 - 17,1369,2562,12459,3602,19992
24-02-2020,17 - 18,1388,2360,13221,3787,20756
24-02-2020,18 - 19,1438,2425,13314,3828,21005
24-02-2020,19 - 20,1398,2461,13070,3739,20668
24-02-2020,20 - 21,1312,2494,12721,3613,20140
24-02-2020,21 - 22,1343,2371,12312,3515,19541
24-02-2020,22 - 23,1261,2197,11683,3257,18398
24-02-2020,23 - 00,1292,2187,11166,3051,17696
25-02-2020,00 - 01,1236,2018,10759,2937,16950
25-02-2020,01 - 02,956,1916,10555,2853,16280
25-02-2020,02 - 03,1130,1883,10534,2828,16375
25-02-2020,03 - 04,1282,1954,10560,2935,16731
25-02-2020,04 - 05,1228,1956,10691,3044,16919
25-02-2020,05 - 06,1232,2021,11321,3242,17816
25-02-2020,06 - 07,1401,2398,12823,3587,20209
25-02-2020,07 - 08,1377,2472,13645,3964,21458
25-02-2020,08 - 09,1342,2523,13627,4010,21502
25-02-2020,09 - 10,1450,2456,13528,3924,21358
25-02-2020,10 - 11,1377,2379,13359,3884,20999
25-02-2020,11 - 12,1350,2410,13156,3881,20797
25-02-2020,12 - 13,1373,2330,13100,3863,20666
25-02-2020,13 - 14,1314,2260,12974,3821,20369
25-02-2020,14 - 15,1441,2296,13010,3801,20548
25-02-2020,15 - 16,1394,2346,13156,3860,20756
25-02-2020,16 - 17,1497,2523,13226,3893,21139
25-02-2020,17 - 18,1627,2554,13766,4019,21966
25-02-2020,18 - 19,1639,2487,13823,4028,21977
25-02-2020,19 - 20,1346,2454,13518,3884,21202
25-02-2020,20 - 21,1361,2432,13020,3762,20575
25-02-2020,21 - 22,1448,2368,12488,3531,19835
25-02-2020,22 - 23,1368,2198,11852,3410,18828
25-02-2020,23 - 00,1348,2088,11324,3244,18004
26-02-2020,00 - 01,1397,2181,10989,3029,17596
26-02-2020,01 - 02,1338,2167,10891,2986,17382
26-02-2020,02 - 03,1328,2217,10965,2995,17505
26-02-2020,03 - 04,1371,2173,11020,2975,17539
26-02-2020,04 - 05,1447,2221,11280,3062,18010
26-02-2020,05 - 06,1528,2370,11897,3225,19020
26-02-2020,06 - 07,1709,2611,13080,3626,21026
26-02-2020,07 - 08,1449,2690,13721,3981,21841
26-02-2020,08 - 09,1491,2728,14126,4099,22444
26-02-2020,09 - 10,1450,2810,14129,4036,22425
26-02-2020,10 - 11,1360,2728,14037,3960,22085
26-02-2020,11 - 12,1244,2642,13874,4013,21773
26-02-2020,12 - 13,1407,2543,13716,3957,21623
26-02-2020,13 - 14,1495,2481,13487,3889,21352
26-02-2020,14 - 15,1482,2449,13477,3966,21374
26-02-2020,15 - 16,1305,2491,13429,3952,21177
26-02-2020,16 - 17,1340,2562,13710,3960,21572
26-02-2020,17 - 18,1334,2564,14154,4123,22175
26-02-2020,18 - 19,1366,2611,14236,4133,22346
26-02-2020,19 - 20,1345,2564,14027,4030,21966
26-02-2020,20 - 21,1371,2496,13729,3866,21462
26-02-2020,21 - 22,1480,2343,13149,3717,20689
26-02-2020,22 - 23,1529,2363,12485,3552,19929
26-02-2020,23 - 00,1339,2317,11863,3412,18931
27-02-2020,00 - 01,1120,2182,11385,3266,17953
27-02-2020,01 - 02,1270,2264,11320,3264,18118
27-02-2020,02 - 03,1361,2202,11354,3264,18181
27-02-2020,03 - 04,1434,2204,11336,3278,18252
27-02-2020,04 - 05,1437,2208,11605,3358,18608
27-02-2020,05 - 06,1504,2149,12092,3540,19285
27-02-2020,06 - 07,1580,2307,13294,3949,21130
27-02-2020,07 - 08,1560,2251,14132,4267,22210
27-02-2020,08 - 09,1582,2215,14268,4261,22326
27-02-2020,09 - 10,1550,2346,14057,4105,22058
27-02-2020,10 - 11,1420,2407,13885,3993,21705
27-02-2020,11 - 12,1403,2214,14179,3905,21701
27-02-2020,12 - 13,1410,2167,13962,3798,21337
27-02-2020,13 - 14,1405,2226,13649,3707,20987
27-02-2020,14 - 15,1300,2411,13247,3690,20648
27-02-2020,15 - 16,1393,2450,13512,3730,21085
27-02-2020,16 - 17,1424,2382,13514,3720,21040
27-02-2020,17 - 18,1488,2343,13995,3835,21661
27-02-2020,18 - 19,1443,2251,14140,3910,21744
27-02-2020,19 - 20,1323,2278,13809,3880,21290
27-02-2020,20 - 21,1330,2313,13406,3772,20821
27-02-2020,21 - 22,1502,2342,13002,3605,20451
27-02-2020,22 - 23,1416,2042,12521,3410,19389
27-02-2020,23 - 00,1233,1835,11868,3237,18173
28-02-2020,00 - 01,1195,1874,11659,3165,17893
28-02-2020,01 - 02,979,1915,11524,3127,17545
28-02-2020,02 - 03,1126,2000,11544,3141,17811
28-02-2020,03 - 04,1390,2041,11567,3181,18179
28-02-2020,04 - 05,1353,2051,11665,3186,18255
28-02-2020,05 - 06,1346,2170,12250,3350,19116
28-02-2020,06 - 07,1530,2254,13434,3671,20889
28-02-2020,07 - 08,1543,2444,14239,3964,22190
28-02-2020,08 - 09,1449,2352,14422,4005,22228
28-02-2020,09 - 10,1498,2366,14156,3907,21927
28-02-2020,10 - 11,1594,2413,13809,3897,21713
28-02-2020,11 - 12,1509,2363,13539,3901,21312
28-02-2020,12 - 13,1408,2333,13155,3766,20662
28-02-2020,13 - 14,1315,2305,12770,3633,20023
28-02-2020,14 - 15,1273,2235,12524,3445,19477
28-02-2020,15 - 16,1407,2240,12423,3398,19468
28-02-2020,16 - 17,1372,2359,12538,3453,19722
28-02-2020,17 - 18,1279,2311,12969,3692,20251
28-02-2020,18 - 19,1238,2187,13295,3812,20532
28-02-2020,19 - 20,1291,2140,12859,3632,19922
28-02-2020,20 - 21,1304,2096,12396,3458,19254
28-02-2020,21 - 22,1323,2153,11891,3305,18672
28-02-2020,22 - 23,1181,2175,11340,3242,17938
28-02-2020,23 - 00,1237,2127,10838,3140,17342
29-02-2020,00 - 01,1236,2346,10531,2977,17090
29-02-2020,01 - 02,1301,2254,10501,2934,16990
29-02-2020,02 - 03,1265,2077,10407,2944,16693
29-02-2020,03 - 04,1389,2046,10434,2844,16713
29-02-2020,04 - 05,1439,1897,10390,2780,16506
29-02-2020,05 - 06,1342,1998,10560,2800,16700
29-02-2020,06 - 07,1316,2135,10893,2912,17256
29-02-2020,07 - 08,1323,2091,11092,3065,17571
29-02-2020,08 - 09,1440,2173,11533,3174,18320
29-02-2020,09 - 10,1420,2339,11722,3396,18877
29-02-2020,10 - 11,1385,2373,11805,3449,19012
29-02-2020,11 - 12,1452,2181,11796,3426,18855
29-02-2020,12 - 13,1437,2041,11672,3432,18582
29-02-2020,13 - 14,1441,1960,11559,3424,18384
29-02-2020,14 - 15,1478,2011,11471,3396,18356
29-02-2020,15 - 16,1524,1989,11434,3364,18311
29-02-2020,16 - 17,1566,2140,11712,3328,18746
29-02-2020,17 - 18,1507,2337,12200,3423,19467
29-02-2020,18 - 19,1578,2462,12301,3455,19796
29-02-2020,19 - 20,1389,2330,11974,3318,19011
29-02-2020,20 - 21,1281,2137,11540,3194,18152
29-02-2020,21 - 22,1261,2156,11133,2996,17546
29-02-2020,22 - 23,1305,2092,10775,2877,17049
29-02-2020,23 - 00,1364,2099,10393,2683,16539
01-03-2020,00 - 01,1346,1990,10085,2653,16074
01-03-2020,01 - 02,1218,1848,9833,2654,15553
01-03-2020,02 - 03,1143,1865,9701,2671,15380
01-03-2020,03 - 04,1214,1883,9726,2676,15499
01-03-2020,04 - 05,1336,1764,9789,2707,15596
01-03-2020,05 - 06,1326,1653,9844,2685,15508
01-03-2020,06 - 07,1424,1849,10111,2707,16091
01-03-2020,07 - 08,1473,1965,10485,2712,16635
01-03-2020,08 - 09,1363,2015,11022,2837,17237
01-03-2020,09 - 10,1356,1988,11245,3018,17607
01-03-2020,10 - 11,1407,1858,11363,3069,17697
01-03-2020,11 - 12,1463,2103,11432,3110,18108
01-03-2020,12 - 13,1474,2272,11454,3081,18281
01-03-2020,13 - 14,1430,2240,11425,3129,18224
01-03-2020,14 - 15,1445,2139,11409,3113,18106
01-03-2020,15 - 16,1404,2125,11407,3103,18039
01-03-2020,16 - 17,1439,2175,11658,3169,18441
01-03-2020,17 - 18,1404,2270,12186,3395,19255
01-03-2020,18 - 19,1469,2351,12383,3633,19836
01-03-2020,19 - 20,1517,2469,12097,3532,19615
01-03-2020,20 - 21,1478,2324,11733,3425,18960
01-03-2020,21 - 22,1458,2262,11196,3227,18143
01-03-2020,22 - 23,1581,2165,10584,3008,17338
01-03-2020,23 - 00,1536,2092,10084,2908,16620
02-03-2020,00 - 01,1389,2189,9996,2913,16487
02-03-2020,01 - 02,1197,2143,9904,2835,16079
02-03-2020,02 - 03,1276,2081,9875,2827,16059
02-03-2020,03 - 04,1391,2123,9950,2930,16394
02-03-2020,04 - 05,1425,2076,10066,2990,16557
02-03-2020,05 - 06,1530,2136,10847,3111,17624
02-03-2020,06 - 07,1620,2312,12047,3429,19408
02-03-2020,07 - 08,1416,2568,12774,3718,20476
02-03-2020,08 - 09,1422,2386,12913,3780,20501
02-03-2020,09 - 10,1428,2434,12921,3810,20593
02-03-2020,10 - 11,1580,2192,12675,3846,20293
02-03-2020,11 - 12,1532,2119,12525,3801,19977
02-03-2020,12 - 13,1547,2152,12294,3731,19724
02-03-2020,13 - 14,1499,2297,12218,3673,19687
02-03-2020,14 - 15,1440,2433,12102,3664,19639
02-03-2020,15 - 16,1427,2359,11964,3561,19311
02-03-2020,16 - 17,1411,2400,11987,3510,19308
02-03-2020,17 - 18,1432,2398,12433,3629,19892
02-03-2020,18 - 19,1359,2516,12751,3750,20376
02-03-2020,19 - 20,1373,2499,12567,3727,20166
02-03-2020,20 - 21,1409,2322,12287,3638,19656
02-03-2020,21 - 22,1394,2342,11824,3482,19042
02-03-2020,22 - 23,1444,2263,11186,3317,18210
02-03-2020,23 - 00,1387,2228,10643,3122,17380
03-03-2020,00 - 01,1220,2164,10175,2997,16556
03-03-2020,01 - 02,1211,2077,9945,2988,16221
03-03-2020,02 - 03,1317,2013,9839,2959,16128
03-03-2020,03 - 04,1352,1979,9824,3007,16162
03-03-2020,04 - 05,1392,2087,9949,3060,16488
03-03-2020,05 - 06,1530,1991,10477,3217,17215
03-03-2020,06 - 07,1494,2196,11705,3496,18891
03-03-2020,07 - 08,1455,2650,12492,3802,20399
03-03-2020,08 - 09,1472,2460,12745,3871,20548
03-03-2020,09 - 10,1543,2475,12838,3845,20701
03-03-2020,10 - 11,1607,2279,13227,3871,20984
03-03-2020,11 - 12,1538,2376,13330,3864,21108
03-03-2020,12 - 13,1527,2365,12711,3871,20474
03-03-2020,13 - 14,1435,2299,12536,3821,20091
03-03-2020,14 - 15,1392,2336,12559,3805,20092
03-03-2020,15 - 16,1373,2331,12614,3824,20142
03-03-2020,16 - 17,1311,2199,12538,3770,19818
03-03-2020,17 - 18,1366,2165,12964,3834,20329
03-03-2020,18 - 19,1299,2371,13111,3864,20645
03-03-2020,19 - 20,1305,2341,12721,3799,20166
03-03-2020,20 - 21,1379,2408,12311,3647,19745
03-03-2020,21 - 22,1310,2351,11911,3492,19064
03-03-2020,22 - 23,1308,2170,11210,3282,17970
03-03-2020,23 - 00,1370,1980,10470,3115,16935
04-03-2020,00 - 01,1378,2083,10189,2990,16640
04-03-2020,01 - 02,1363,2013,9996,2946,16318
04-03-2020,02 - 03,1367,2160,9855,2924,16306
04-03-2020,03 - 04,1383,2221,9948,2924,16476
04-03-2020,04 - 05,1448,2251,10231,2977,16907
04-03-2020,05 - 06,1537,2255,10754,3121,17667
04-03-2020,06 - 07,1576,2348,11954,3448,19326
04-03-2020,07 - 08,1439,2364,12844,3729,20376
04-03-2020,08 - 09,1476,2457,13132,3870,20935
04-03-2020,09 - 10,1512,2477,13191,3940,21120
04-03-2020,10 - 11,1564,2572,13234,3943,21313
04-03-2020,11 - 12,1538,2577,13342,3885,21342
04-03-2020,12 - 13,1519,2414,13146,3800,20879
04-03-2020,13 - 14,1553,2456,12974,3714,20697
04-03-2020,14 - 15,1512,2436,12959,3676,20583
04-03-2020,15 - 16,1518,2467,12964,3700,20649
04-03-2020,16 - 17,1426,2572,12965,3674,20637
04-03-2020,17 - 18,1478,2577,13352,3739,21146
04-03-2020,18 - 19,1491,2633,13558,3833,21515
04-03-2020,19 - 20,1513,2511,13238,3736,20998
04-03-2020,20 - 21,1509,2575,12830,3591,20505
04-03-2020,21 - 22,1548,2457,12367,3413,19785
04-03-2020,22 - 23,1482,2345,11692,3243,18762
04-03-2020,23 - 00,1383,2367,11052,3101,17903
05-03-2020,00 - 01,1354,2225,10611,3044,17234
05-03-2020,01 - 02,1315,2406,10452,2985,17158
05-03-2020,02 - 03,1276,2386,10351,2943,16956
05-03-2020,03 - 04,1369,2428,10441,2922,17160
05-03-2020,04 - 05,1417,2399,10595,2965,17376
05-03-2020,05 - 06,1475,2592,11127,3158,18352
05-03-2020,06 - 07,1459,2608,12219,3491,19777
05-03-2020,07 - 08,1574,2675,12920,3764,20933
05-03-2020,08 - 09,1417,2723,13081,3819,21040
05-03-2020,09 - 10,1469,2601,12974,3792,20836
05-03-2020,10 - 11,1458,2521,12857,3747,20583
05-03-2020,11 - 12,1434,2456,12633,3684,20207
05-03-2020,12 - 13,1432,2434,12537,3577,19980
05-03-2020,13 - 14,1450,2474,12388,3543,19855
05-03-2020,14 - 15,1375,2434,12344,3491,19644
05-03-2020,15 - 16,1454,2489,12502,3535,19980
05-03-2020,16 - 17,1453,2486,12472,3526,19937
05-03-2020,17 - 18,1476,2408,12896,3641,20421
05-03-2020,18 - 19,1501,2473,13213,3785,20972
05-03-2020,19 - 20,1501,2268,12970,3807,20546
05-03-2020,20 - 21,1432,2360,12676,3688,20156
05-03-2020,21 - 22,1394,2387,12238,3511,19530
05-03-2020,22 - 23,1381,2281,11742,3296,18700
05-03-2020,23 - 00,1373,2151,11225,3121,17870
06-03-2020,00 - 01,1264,2013,10914,3051,17242
06-03-2020,01 - 02,1225,1975,10800,2991,16991
06-03-2020,02 - 03,1303,2106,10806,3000,17215
06-03-2020,03 - 04,1282,1965,10862,2972,17081
06-03-2020,04 - 05,1408,1925,11059,3004,17396
06-03-2020,05 - 06,1460,2033,11591,3161,18245
06-03-2020,06 - 07,1400,2421,12730,3491,20042
06-03-2020,07 - 08,1375,2520,13556,3736,21187
06-03-2020,08 - 09,1425,2372,13429,3856,21082
06-03-2020,09 - 10,1439,2247,13270,3846,20802
06-03-2020,10 - 11,1420,2243,13046,3859,20568
06-03-2020,11 - 12,1262,2261,12670,3793,19986
06-03-2020,12 - 13,1297,2255,12492,3664,19708
06-03-2020,13 - 14,1429,2154,12200,3645,19428
06-03-2020,14 - 15,1414,2226,11911,3535,19086
06-03-2020,15 - 16,1426,2213,11898,3510,19047
06-03-2020,16 - 17,1307,2298,12047,3486,19138
06-03-2020,17 - 18,1223,2288,12558,3557,19626
06-03-2020,18 - 19,1179,2368,12859,3624,20030
06-03-2020,19 - 20,1212,2366,12498,3556,19632
06-03-2020,20 - 21,1328,2198,12101,3429,19056
06-03-2020,21 - 22,1302,2203,11622,3256,18383
06-03-2020,22 - 23,1197,2083,11150,3104,17534
06-03-2020,23 - 00,1107,2071,10790,2942,16910
07-03-2020,00 - 01,1260,2108,10538,2893,16799
07-03-2020,01 - 02,1191,2096,10393,2821,16501
07-03-2020,02 - 03,1169,2124,10187,2774,16254
07-03-2020,03 - 04,1233,1993,10146,2794,16166
07-03-2020,04 - 05,1258,2091,10209,2812,16370
07-03-2020,05 - 06,1225,2214,10407,2836,16682
07-03-2020,06 - 07,1255,2314,10705,2885,17159
07-03-2020,07 - 08,1258,2404,10961,2980,17603
07-03-2020,08 - 09,1177,2388,11465,3204,18234
07-03-2020,09 - 10,1184,2493,11718,3304,18699
07-03-2020,10 - 11,1358,2295,11825,3311,18789
07-03-2020,11 - 12,1467,2239,11736,3249,18691
07-03-2020,12 - 13,1273,2125,11515,3203,18116
07-03-2020,13 - 14,1187,2007,11240,3169,17603
07-03-2020,14 - 15,1213,1933,11134,3145,17425
07-03-2020,15 - 16,1170,1938,11046,3127,17281
07-03-2020,16 - 17,1170,1958,11301,3161,17590
07-03-2020,17 - 18,1153,1844,11895,3278,18170
07-03-2020,18 - 19,1087,1633,12334,3410,18464
07-03-2020,19 - 20,1073,1707,12036,3368,18184
07-03-2020,20 - 21,1049,1698,11527,3261,17535
07-03-2020,21 - 22,1127,1616,11082,3140,16965
07-03-2020,22 - 23,1075,1417,10552,3050,16094
07-03-2020,23 - 00,1078,1463,10227,2935,15703
08-03-2020,00 - 01,1159,1571,10134,2837,15701
08-03-2020,01 - 02,1083,1647,9920,2739,15389
08-03-2020,02 - 03,1085,1865,9663,2637,15250
08-03-2020,03 - 04,1079,1776,9614,2582,15051
08-03-2020,04 - 05,1176,1786,9586,2503,15051
08-03-2020,05 - 06,1332,1731,9701,2537,15301
08-03-2020,06 - 07,1326,1769,9853,2617,15565
08-03-2020,07 - 08,1272,1901,10047,2721,15941
08-03-2020,08 - 09,1241,1991,10493,2874,16599
08-03-2020,09 - 10,1233,1963,10900,3014,17110
08-03-2020,10 - 11,1359,2030,11087,3052,17528
08-03-2020,11 - 12,1468,2089,11130,3069,17756
08-03-2020,12 - 13,1505,1987,11072,3044,17608
08-03-2020,13 - 14,1294,2026,11025,3059,17404
08-03-2020,14 - 15,1238,2054,10993,3003,17288
08-03-2020,15 - 16,1266,2163,11103,2990,17522
08-03-2020,16 - 17,1211,2141,11272,3048,17672
08-03-2020,17 - 18,1290,2181,11638,3194,18303
08-03-2020,18 - 19,1370,2212,11854,3366,18802
08-03-2020,19 - 20,1389,2200,11627,3265,18481
08-03-2020,20 - 21,1227,2134,11190,3095,17646
08-03-2020,21 - 22,1253,1997,10681,2982,16913
08-03-2020,22 - 23,1242,1898,10110,2907,16157
08-03-2020,23 - 00,1247,1894,9644,2764,15549
09-03-2020,00 - 01,1145,1936,9448,2671,15200
09-03-2020,01 - 02,1141,1822,9340,2625,14928
09-03-2020,02 - 03,1082,1851,9296,2602,14831
09-03-2020,03 - 04,1094,1842,9290,2622,14848
09-03-2020,04 - 05,1200,2160,9499,2688,15547
09-03-2020,05 - 06,1207,2055,10064,2890,16216
09-03-2020,06 - 07,1317,1995,11267,3224,17803
09-03-2020,07 - 08,1347,2200,12184,3502,19233
09-03-2020,08 - 09,1242,2044,12484,3608,19378
09-03-2020,09 - 10,1241,2126,12366,3588,19321
09-03-2020,10 - 11,1240,2048,12231,3604,19123
09-03-2020,11 - 12,1239,2029,12155,3619,19042
09-03-2020,12 - 13,1312,1917,12086,3570,18885
09-03-2020,13 - 14,1259,1889,12078,3575,18801
09-03-2020,14 - 15,1312,1729,12011,3499,18551
09-03-2020,15 - 16,1351,1852,12040,3498,18741
09-03-2020,16 - 17,1350,2039,12008,3413,18810
09-03-2020,17 - 18,1457,2103,12399,3493,19452
09-03-2020,18 - 19,1348,2214,12684,3584,19830
09-03-2020,19 - 20,1199,2113,12465,3523,19300
09-03-2020,20 - 21,1174,1973,11991,3398,18536
09-03-2020,21 - 22,1197,2048,11385,3233,17863
09-03-2020,22 - 23,1209,2001,10677,3084,16971
09-03-2020,23 - 00,1193,2101,10113,2805,16212
10-03-2020,00 - 01,1109,1921,9829,2752,15611
10-03-2020,01 - 02,1128,1797,9529,2777,15231
10-03-2020,02 - 03,1118,1777,9443,2791,15129
10-03-2020,03 - 04,1178,1651,9445,2688,14962
10-03-2020,04 - 05,1191,1734,9655,2797,15377
10-03-2020,05 - 06,1180,1802,10137,2942,16061
10-03-2020,06 - 07,1258,2016,11310,3300,17884
10-03-2020,07 - 08,1345,2374,12259,3647,19625
10-03-2020,08 - 09,1404,2146,12472,3775,19797
10-03-2020,09 - 10,1443,2051,12521,3788,19803
10-03-2020,10 - 11,1385,1988,12530,3790,19693
10-03-2020,11 - 12,1306,1987,12520,3870,19683
10-03-2020,12 - 13,1289,2016,12533,3802,19640
10-03-2020,13 - 14,1228,1992,12320,3781,19321
10-03-2020,14 - 15,1245,1956,12120,3760,19081
10-03-2020,15 - 16,1239,1918,12145,3729,19031
10-03-2020,16 - 17,1261,1999,12194,3647,19101
10-03-2020,17 - 18,1307,2051,12536,3718,19612
10-03-2020,18 - 19,1288,1976,12538,3701,19503
10-03-2020,19 - 20,1316,1873,12238,3553,18980
10-03-2020,20 - 21,1286,1733,11818,3455,18292
10-03-2020,21 - 22,1388,1645,11300,3283,17616
10-03-2020,22 - 23,1314,1689,10692,3016,16711
10-03-2020,23 - 00,1232,1573,10401,2745,15951
11-03-2020,00 - 01,1287,1697,9892,2628,15504
11-03-2020,01 - 02,1283,1667,9573,2552,15075
11-03-2020,02 - 03,1294,1717,9493,2500,15004
11-03-2020,03 - 04,1300,1708,9493,2515,15016
11-03-2020,04 - 05,1299,1818,9633,2639,15389
11-03-2020,05 - 06,1403,1938,10063,2799,16203
11-03-2020,06 - 07,1297,2197,11261,3161,17916
11-03-2020,07 - 08,1351,2247,12301,3512,19411
11-03-2020,08 - 09,1345,2214,12496,3593,19648
11-03-2020,09 - 10,1411,2249,12414,3509,19583
11-03-2020,10 - 11,1346,2221,12422,3514,19503
11-03-2020,11 - 12,1379,2193,12431,3483,19486
11-03-2020,12 - 13,1410,2173,12213,3417,19213
11-03-2020,13 - 14,1366,2129,11995,3329,18819
11-03-2020,14 - 15,1360,2041,11862,3255,18518
11-03-2020,15 - 16,1374,2090,11720,3294,18478
11-03-2020,16 - 17,1483,2013,11718,3265,18479
11-03-2020,17 - 18,1506,2007,12016,3430,18959
11-03-2020,18 - 19,1502,2040,12421,3548,19511
11-03-2020,19 - 20,1468,1877,12354,3456,19155
11-03-2020,20 - 21,1376,1930,12075,3355,18736
11-03-2020,21 - 22,1371,2194,11446,3168,18179
11-03-2020,22 - 23,1318,2313,10787,3006,17424
11-03-2020,23 - 00,1255,2043,10143,2830,16271
12-03-2020,00 - 01,1275,1955,9757,2680,15667
12-03-2020,01 - 02,1314,1971,9541,2608,15434
12-03-2020,02 - 03,1363,1940,9455,2634,15392
12-03-2020,03 - 04,1252,1908,9380,2622,15162
12-03-2020,04 - 05,1251,1889,9632,2645,15417
12-03-2020,05 - 06,1267,1714,10084,2795,15860
12-03-2020,06 - 07,1446,2109,11113,3208,17876
12-03-2020,07 - 08,1356,2131,12080,3461,19028
12-03-2020,08 - 09,1415,2207,12417,3519,19558
12-03-2020,09 - 10,1304,2112,12334,3524,19274
12-03-2020,10 - 11,1268,2111,12356,3627,19362
12-03-2020,11 - 12,1340,2178,12722,3793,20033
12-03-2020,12 - 13,1235,2087,12822,3981,20125
12-03-2020,13 - 14,1262,2201,12845,3974,20282
12-03-2020,14 - 15,1229,2163,12778,3908,20078
12-03-2020,15 - 16,1283,2336,12778,3915,20312
12-03-2020,16 - 17,1291,2304,12725,3819,20139
12-03-2020,17 - 18,1291,2168,13036,3807,20302
12-03-2020,18 - 19,1253,2163,13207,3878,20501
12-03-2020,19 - 20,1240,2219,12928,3827,20214
12-03-2020,20 - 21,1266,2084,12411,3650,19411
12-03-2020,21 - 22,1246,1954,11873,3476,18549
12-03-2020,22 - 23,1177,1947,11257,3284,17665
12-03-2020,23 - 00,1143,1845,10754,3064,16806
13-03-2020,00 - 01,1135,1762,10310,2959,16166
13-03-2020,01 - 02,1241,1975,10078,2915,16209
13-03-2020,02 - 03,1247,1994,10023,2879,16143
13-03-2020,03 - 04,1314,1931,10120,2844,16209
13-03-2020,04 - 05,1351,1914,10402,2829,16496
13-03-2020,05 - 06,1444,2128,10989,2986,17547
13-03-2020,06 - 07,1397,2293,11920,3280,18890
13-03-2020,07 - 08,1312,2552,12856,3544,20264
13-03-2020,08 - 09,1367,2648,13005,3665,20685
13-03-2020,09 - 10,1432,2488,12726,3615,20261
13-03-2020,10 - 11,1529,2314,12810,3548,20201
13-03-2020,11 - 12,1476,2230,12792,3539,20037
13-03-2020,12 - 13,1550,2334,12616,3398,19898
13-03-2020,13 - 14,1495,2119,12193,3887,19694
13-03-2020,14 - 15,1427,2117,12092,3965,19601
13-03-2020,15 - 16,1378,2123,11933,3919,19353
13-03-2020,16 - 17,1360,2113,12038,4184,19695
13-03-2020,17 - 18,1300,2234,12664,4276,20474
13-03-2020,18 - 19,1460,2247,13302,4358,21367
13-03-2020,19 - 20,1172,2042,13033,4441,20688
13-03-2020,20 - 21,1255,2190,12576,4218,20239
13-03-2020,21 - 22,1249,2238,12139,4047,19673
13-03-2020,22 - 23,1247,2175,11741,3908,19071
13-03-2020,23 - 00,1266,2166,11510,3786,18728
14-03-2020,00 - 01,1291,2069,11238,3763,18361
14-03-2020,01 - 02,1177,2041,11090,3775,18083
14-03-2020,02 - 03,1286,2110,11124,3751,18271
14-03-2020,03 - 04,1315,1978,11102,3735,18130
14-03-2020,04 - 05,1411,2062,11294,3821,18588
14-03-2020,05 - 06,1363,2161,11554,3930,19008
14-03-2020,06 - 07,1409,2251,11752,3938,19350
14-03-2020,07 - 08,1527,2391,12082,4010,20010
14-03-2020,08 - 09,1626,2583,12341,3985,20535
14-03-2020,09 - 10,1558,2719,12347,4099,20723
14-03-2020,10 - 11,1356,2516,12124,3988,19984
14-03-2020,11 - 12,1317,2189,11992,3813,19311
14-03-2020,12 - 13,1295,2116,11641,3822,18874
14-03-2020,13 - 14,1248,2076,11324,3708,18356
14-03-2020,14 - 15,1171,1877,11086,3599,17733
14-03-2020,15 - 16,1178,1896,11046,3629,17749
14-03-2020,16 - 17,1127,2133,11258,3689,18207
14-03-2020,17 - 18,1163,2471,11878,3908,19420
14-03-2020,18 - 19,956,2342,12602,4118,20018
14-03-2020,19 - 20,978,2011,12324,4055,19368
14-03-2020,20 - 21,1074,1852,11789,3863,18578
14-03-2020,21 - 22,1182,2013,11386,3731,18312
14-03-2020,22 - 23,1204,2040,11043,3648,17935
14-03-2020,23 - 00,1140,1984,10552,3539,17215
15-03-2020,00 - 01,1121,1641,10399,3475,16636
15-03-2020,01 - 02,1159,1717,10132,3447,16455
15-03-2020,02 - 03,1238,1670,9979,3411,16298
15-03-2020,03 - 04,1232,1777,10106,3420,16535
15-03-2020,04 - 05,1140,1721,10138,3446,16445
15-03-2020,05 - 06,1094,1847,10167,3496,16604
15-03-2020,06 - 07,1142,1688,10117,3509,16456
15-03-2020,07 - 08,1212,1863,10294,3567,16936
15-03-2020,08 - 09,1234,1879,10564,3625,17302
15-03-2020,09 - 10,1363,1968,10911,3697,17939
15-03-2020,10 - 11,1400,2063,11136,3779,18378
15-03-2020,11 - 12,1231,1974,11249,3856,18310
15-03-2020,12 - 13,1065,2009,11439,3852,18365
15-03-2020,13 - 14,1194,1963,11359,3865,18381
15-03-2020,14 - 15,1292,1939,11317,3865,18413
15-03-2020,15 - 16,1360,1907,11326,3866,18459
15-03-2020,16 - 17,1426,1921,11398,3925,18670
15-03-2020,17 - 18,1469,2028,11811,4089,19397
15-03-2020,18 - 19,1319,1949,12143,4219,19630
15-03-2020,19 - 20,1367,1782,11793,4106,19048
15-03-2020,20 - 21,1152,1825,11328,3940,18245
15-03-2020,21 - 22,1150,1771,10777,3720,17418
15-03-2020,22 - 23,1103,1769,10335,3556,16763
15-03-2020,23 - 00,968,1722,10004,3360,16054
16-03-2020,00 - 01,956,1672,9654,2916,15198
16-03-2020,01 - 02,906,1720,9626,2793,15045
16-03-2020,02 - 03,1004,1695,9619,2844,15162
16-03-2020,03 - 04,1074,1849,9592,2816,15331
16-03-2020,04 - 05,1157,2175,9747,2946,16025
16-03-2020,05 - 06,1178,2198,10465,3346,17187
16-03-2020,06 - 07,1305,2346,11396,3931,18978
16-03-2020,07 - 08,1406,2539,12390,4157,20492
16-03-2020,08 - 09,1434,2690,12575,4110,20809
16-03-2020,09 - 10,1344,2590,12582,4257,20773
16-03-2020,10 - 11,1323,2408,12479,4320,20530
16-03-2020,11 - 12,1235,2316,12329,4146,20026
16-03-2020,12 - 13,1264,2212,12202,4072,19750
16-03-2020,13 - 14,1225,2245,12011,4117,19598
16-03-2020,14 - 15,1214,2225,11793,4128,19360
16-03-2020,15 - 16,1214,2272,11809,4134,19429
16-03-2020,16 - 17,1272,2340,11762,4012,19386
16-03-2020,17 - 18,1343,2501,12145,3430,19419
16-03-2020,18 - 19,1365,2309,12676,3529,19879
16-03-2020,19 - 20,1214,2084,12594,3521,19413
16-03-2020,20 - 21,1223,1995,12019,3360,18597
16-03-2020,21 - 22,1160,2006,11437,3199,17802
16-03-2020,22 - 23,1187,2111,10975,2980,17253
16-03-2020,23 - 00,971,1864,10388,2820,16043
17-03-2020,00 - 01,1112,1937,9951,2731,15731
17-03-2020,01 - 02,1169,1850,9729,2728,15476
17-03-2020,02 - 03,1069,1994,9636,2724,15423
17-03-2020,03 - 04,1120,2060,9547,2685,15412
17-03-2020,04 - 05,1227,1984,9727,2657,15595
17-03-2020,05 - 06,1191,1914,10001,2841,15947
17-03-2020,06 - 07,1220,2072,10913,3172,17377
17-03-2020,07 - 08,1221,2185,11589,3417,18412
17-03-2020,08 - 09,1167,2031,11915,3511,18624
17-03-2020,09 - 10,1243,2245,12032,3473,18993
17-03-2020,10 - 11,1413,2258,12105,3530,19306
17-03-2020,11 - 12,1370,2178,12154,3555,19257
17-03-2020,12 - 13,1267,1974,12066,3484,18791
17-03-2020,13 - 14,1239,1873,11982,3443,18537
17-03-2020,14 - 15,1225,2040,11812,3340,18417
17-03-2020,15 - 16,1180,1925,11767,3347,18219
17-03-2020,16 - 17,1245,2020,11762,3270,18297
17-03-2020,17 - 18,1205,2278,12021,3350,18854
17-03-2020,18 - 19,1254,2088,12083,3488,18913
17-03-2020,19 - 20,1195,1919,11814,3464,18392
17-03-2020,20 - 21,1200,1898,11434,3241,17773
17-03-2020,21 - 22,1238,1920,10765,3073,16996
17-03-2020,22 - 23,1164,1749,10315,2887,16115
17-03-2020,23 - 00,1142,1874,9795,2715,15526
18-03-2020,00 - 01,1093,1856,9294,2600,14843
18-03-2020,01 - 02,1056,1610,9018,2497,14181
18-03-2020,02 - 03,1053,1552,8993,2552,14150
18-03-2020,03 - 04,1060,1819,9212,2612,14703
18-03-2020,04 - 05,1082,1802,9376,2587,14847
18-03-2020,05 - 06,1053,1719,9863,2627,15262
18-03-2020,06 - 07,1186,1770,10715,2953,16624
18-03-2020,07 - 08,1309,1900,11693,3311,18213
18-03-2020,08 - 09,1313,2049,12049,3400,18811
18-03-2020,09 - 10,1208,2146,12093,3444,18891
18-03-2020,10 - 11,1224,1930,12313,3543,19010
18-03-2020,11 - 12,1275,1885,12238,3573,18971
18-03-2020,12 - 13,1241,1910,12090,3587,18828
18-03-2020,13 - 14,1123,1888,11808,3554,18373
18-03-2020,14 - 15,1188,1838,11652,3509,18187
18-03-2020,15 - 16,1137,1860,11539,3481,18017
18-03-2020,16 - 17,1213,2112,11672,3390,18387
18-03-2020,17 - 18,1269,2249,12098,3510,19126
18-03-2020,18 - 19,1104,2245,12329,3569,19247
18-03-2020,19 - 20,1151,2282,12398,3543,19374
18-03-2020,20 - 21,1085,2317,11907,3428,18737
18-03-2020,21 - 22,1144,2162,11377,3251,17934
18-03-2020,22 - 23,1095,1879,10860,3086,16920
18-03-2020,23 - 00,1094,1847,10267,2883,16091
19-03-2020,00 - 01,1124,1933,9906,2694,15657
19-03-2020,01 - 02,1199,1873,9734,2651,15457
19-03-2020,02 - 03,1231,2016,9690,2617,15554
19-03-2020,03 - 04,1154,2088,9899,2660,15801
19-03-2020,04 - 05,1139,2122,10130,2719,16110
19-03-2020,05 - 06,1107,2134,10555,2884,16680
19-03-2020,06 - 07,1222,2250,11338,3131,17941
19-03-2020,07 - 08,1313,2190,12073,3402,18978
19-03-2020,08 - 09,1624,2294,12045,3418,19381
19-03-2020,09 - 10,1449,2326,11748,3349,18872
19-03-2020,10 - 11,1215,2127,11633,3302,18277
19-03-2020,11 - 12,1272,2135,11615,3229,18251
19-03-2020,12 - 13,1377,2265,11411,3175,18228
19-03-2020,13 - 14,1384,2252,11134,3198,17968
19-03-2020,14 - 15,1272,2333,11086,3131,17822
19-03-2020,15 - 16,1354,2395,11166,3131,18046
19-03-2020,16 - 17,1418,2422,11057,3141,18038
19-03-2020,17 - 18,1406,2378,11443,3291,18518
19-03-2020,18 - 19,1506,2287,11899,3409,19101
19-03-2020,19 - 20,1328,2288,11976,3440,19032
19-03-2020,20 - 21,1365,2145,11499,3284,18293
19-03-2020,21 - 22,1549,1953,11011,3125,17638
19-03-2020,22 - 23,1323,2120,10536,2990,16969
19-03-2020,23 - 00,1371,1980,10107,2833,16291
20-03-2020,00 - 01,1265,1788,9630,2734,15417
20-03-2020,01 - 02,1297,1740,9439,2668,15144
20-03-2020,02 - 03,1316,1819,9382,2635,15152
20-03-2020,03 - 04,1416,1833,9420,2674,15343
20-03-2020,04 - 05,1221,1958,9598,2673,15450
20-03-2020,05 - 06,1055,2118,10149,2790,16112
20-03-2020,06 - 07,1263,2222,11076,3089,17650
20-03-2020,07 - 08,1463,2299,11900,3386,19048
20-03-2020,08 - 09,1524,2361,12208,3470,19563
20-03-2020,09 - 10,1381,2446,12165,3454,19446
20-03-2020,10 - 11,1211,2387,12062,3478,19138
20-03-2020,11 - 12,1196,2214,12009,3446,18865
20-03-2020,12 - 13,1200,2121,11927,3392,18640
20-03-2020,13 - 14,1103,2001,11608,3191,17903
20-03-2020,14 - 15,1025,1874,11391,2953,17243
20-03-2020,15 - 16,1207,2051,11331,2896,17485
20-03-2020,16 - 17,1251,1981,11376,2937,17545
20-03-2020,17 - 18,1273,2223,11907,3066,18469
20-03-2020,18 - 19,1434,2273,12478,3282,19467
20-03-2020,19 - 20,1359,2098,12438,3326,19221
20-03-2020,20 - 21,1125,2070,12068,3164,18427
20-03-2020,21 - 22,1165,1924,11722,3101,17912
20-03-2020,22 - 23,1253,1986,11305,2981,17525
20-03-2020,23 - 00,1273,1887,10966,2902,17028
21-03-2020,00 - 01,1254,1887,10701,2875,16717
21-03-2020,01 - 02,1154,1841,10612,2855,16462
21-03-2020,02 - 03,1181,1705,10533,2906,16325
21-03-2020,03 - 04,1274,1781,10467,2957,16479
21-03-2020,04 - 05,1203,1484,10431,2945,16063
21-03-2020,05 - 06,1203,1606,10331,2988,16128
21-03-2020,06 - 07,1243,1708,10408,2973,16332
21-03-2020,07 - 08,1238,2096,10736,3047,17117
21-03-2020,08 - 09,1325,2311,11046,3128,17810
21-03-2020,09 - 10,1367,2148,10994,3093,17602
21-03-2020,10 - 11,1279,1980,10865,3040,17164
21-03-2020,11 - 12,1138,1877,10817,2941,16773
21-03-2020,12 - 13,1128,1598,10695,2899,16320
21-03-2020,13 - 14,1147,1880,10657,2887,16571
21-03-2020,14 - 15,1154,1918,10550,2807,16429
21-03-2020,15 - 16,1277,1985,10554,2770,16586
21-03-2020,16 - 17,1280,2076,10820,2830,17006
21-03-2020,17 - 18,1282,2237,11480,3074,18073
21-03-2020,18 - 19,1438,2222,12110,3248,19018
21-03-2020,19 - 20,1488,2140,12136,3303,19067
21-03-2020,20 - 21,1315,2191,11854,3174,18534
21-03-2020,21 - 22,1306,2197,11498,3032,18033
21-03-2020,22 - 23,1177,2156,11298,2992,17623
21-03-2020,23 - 00,1239,2003,11067,2969,17278
22-03-2020,00 - 01,1254,1699,10757,2891,16601
22-03-2020,01 - 02,1310,1714,10695,2846,16565
22-03-2020,02 - 03,1137,1609,10755,2864,16365
22-03-2020,03 - 04,1140,1600,10770,2862,16372
22-03-2020,04 - 05,1293,1487,10804,2868,16452
22-03-2020,05 - 06,1270,1676,10958,2944,16848
22-03-2020,06 - 07,1094,1895,10962,2918,16869
22-03-2020,07 - 08,1189,1840,10983,2980,16992
22-03-2020,08 - 09,1163,1931,11138,3004,17236
22-03-2020,09 - 10,1086,2223,11188,2992,17489
22-03-2020,10 - 11,1250,2163,10997,2952,17362
22-03-2020,11 - 12,1373,2005,10885,2927,17190
22-03-2020,12 - 13,1392,1917,10811,2940,17060
22-03-2020,13 - 14,1253,1889,10566,2870,16578
22-03-2020,14 - 15,1329,1756,10528,2840,16453
22-03-2020,15 - 16,1355,1886,10538,2827,16606
22-03-2020,16 - 17,1259,1943,10817,2897,16916
22-03-2020,17 - 18,1268,2234,11594,3123,18219
22-03-2020,18 - 19,1134,2421,12190,3341,19086
22-03-2020,19 - 20,1240,2408,12294,3410,19352
22-03-2020,20 - 21,1233,2267,11995,3304,18799
22-03-2020,21 - 22,1235,2229,11583,3189,18236
22-03-2020,22 - 23,1164,2043,11176,3071,17454
22-03-2020,23 - 00,1231,1959,10740,2915,16845
23-03-2020,00 - 01,1170,2050,10446,2884,16550
23-03-2020,01 - 02,1200,1947,10193,2866,16206
23-03-2020,02 - 03,1202,1994,10214,2897,16307
23-03-2020,03 - 04,1181,2078,10365,2976,16600
23-03-2020,04 - 05,1141,2005,10464,3060,16670
23-03-2020,05 - 06,1166,2038,10837,3239,17280
23-03-2020,06 - 07,1276,2163,11665,3479,18583
23-03-2020,07 - 08,1212,2193,12516,3673,19594
23-03-2020,08 - 09,1358,2271,12752,3736,20117
23-03-2020,09 - 10,1453,2241,12456,3618,19768
23-03-2020,10 - 11,1322,1879,12302,3585,19088
23-03-2020,11 - 12,1284,1719,12257,3540,18800
23-03-2020,12 - 13,1214,1803,12168,3420,18605
23-03-2020,13 - 14,1057,1776,11962,3385,18180
23-03-2020,14 - 15,1168,1764,11845,3387,18164
23-03-2020,15 - 16,1176,1804,11961,3366,18307
23-03-2020,16 - 17,1187,2031,12071,3324,18613
23-03-2020,17 - 18,1185,2177,12387,3489,19238
23-03-2020,18 - 19,1275,2030,12688,3612,19605
23-03-2020,19 - 20,1281,2086,12660,3714,19741
23-03-2020,20 - 21,1229,2160,12144,3566,19099
23-03-2020,21 - 22,1209,2012,11551,3387,18159
23-03-2020,22 - 23,1109,1871,11103,3200,17283
23-03-2020,23 - 00,1065,1908,10646,3083,16702
24-03-2020,00 - 01,1104,2027,10256,2980,16367
24-03-2020,01 - 02,1122,1889,10140,2901,16052
24-03-2020,02 - 03,1071,1855,9986,2921,15833
24-03-2020,03 - 04,1025,1915,10003,2994,15937
24-03-2020,04 - 05,1155,1796,10148,3028,16127
24-03-2020,05 - 06,1065,1966,10691,3126,16848
24-03-2020,06 - 07,1098,2135,11496,3355,18084
24-03-2020,07 - 08,1228,2139,12155,3596,19118
24-03-2020,08 - 09,1382,2058,12118,3654,19212
24-03-2020,09 - 10,1254,2017,11798,3455,18524
24-03-2020,10 - 11,1123,1914,11624,3479,18140
24-03-2020,11 - 12,1274,1875,11591,3527,18267
24-03-2020,12 - 13,1223,1735,11502,3436,17896
24-03-2020,13 - 14,1172,1788,11228,3384,17572
24-03-2020,14 - 15,1309,1863,11008,3346,17526
24-03-2020,15 - 16,1258,1922,11090,3316,17586
24-03-2020,16 - 17,1120,1960,11241,3350,17671
24-03-2020,17 - 18,1275,2040,11751,3467,18533
24-03-2020,18 - 19,1393,2094,11984,3579,19050
24-03-2020,19 - 20,1117,2046,11989,3590,18742
24-03-2020,20 - 21,1061,2082,11565,3442,18150
24-03-2020,21 - 22,1177,2039,11067,3314,17597
24-03-2020,22 - 23,1120,1972,10390,3175,16657
24-03-2020,23 - 00,1293,1928,9887,2959,16067
25-03-2020,00 - 01,1179,1861,9531,2858,15429
25-03-2020,01 - 02,1065,1806,9449,2763,15083
25-03-2020,02 - 03,1091,1821,9485,2854,15251
25-03-2020,03 - 04,1121,1859,9586,2830,15396
25-03-2020,04 - 05,1105,1927,9741,2889,15662
25-03-2020,05 - 06,1066,1937,10216,3052,16271
25-03-2020,06 - 07,1205,2029,11135,3286,17655
25-03-2020,07 - 08,1233,2121,12007,3547,18908
25-03-2020,08 - 09,1227,2073,11918,3554,18772
25-03-2020,09 - 10,1275,2012,11670,3440,18397
25-03-2020,10 - 11,1208,1902,11664,3414,18188
25-03-2020,11 - 12,1222,1909,11536,3407,18074
25-03-2020,12 - 13,1180,1906,11345,3340,17771
25-03-2020,13 - 14,1215,1957,11038,3267,17477
25-03-2020,14 - 15,1174,1971,10893,3275,17313
25-03-2020,15 - 16,1435,1881,10848,3281,17445
25-03-2020,16 - 17,1401,1925,10911,3242,17479
25-03-2020,17 - 18,1254,2078,11320,3354,18006
25-03-2020,18 - 19,1234,1983,11653,3480,18350
25-03-2020,19 - 20,1259,1949,11845,3567,18620
25-03-2020,20 - 21,1169,1945,11343,3410,17867
25-03-2020,21 - 22,1072,1985,10685,3271,17013
25-03-2020,22 - 23,1145,2161,10163,3088,16557
25-03-2020,23 - 00,1167,2126,9834,2934,16061
26-03-2020,00 - 01,1144,1944,9645,2842,15575
26-03-2020,01 - 02,1136,1957,9453,2711,15257
26-03-2020,02 - 03,1152,1965,9400,2716,15233
26-03-2020,03 - 04,1193,1917,9627,2858,15595
26-03-2020,04 - 05,1200,1856,9729,2987,15772
26-03-2020,05 - 06,1138,2039,10045,3151,16373
26-03-2020,06 - 07,1355,2152,10970,3426,17903
26-03-2020,07 - 08,1410,2231,11851,3657,19149
26-03-2020,08 - 09,1487,2301,11847,3665,19300
26-03-2020,09 - 10,1425,2396,11555,3534,18910
26-03-2020,10 - 11,1171,2180,11261,3430,18042
26-03-2020,11 - 12,1124,2190,11175,3351,17840
26-03-2020,12 - 13,1121,2245,10946,3260,17572
26-03-2020,13 - 14,1047,2195,10730,3193,17165
26-03-2020,14 - 15,1184,2122,10628,3175,17109
26-03-2020,15 - 16,1239,2137,10533,3175,17084
26-03-2020,16 - 17,1341,2092,10533,3108,17074
26-03-2020,17 - 18,1389,2201,10921,3211,17722
26-03-2020,18 - 19,1144,2175,11225,3349,17893
26-03-2020,19 - 20,1080,2226,11449,3385,18140
26-03-2020,20 - 21,1260,2175,11271,3272,17978
26-03-2020,21 - 22,1124,2050,10988,3161,17323
26-03-2020,22 - 23,1099,2022,10429,3023,16573
26-03-2020,23 - 00,1102,1980,9988,2907,15977
27-03-2020,00 - 01,1155,1906,9787,2874,15722
27-03-2020,01 - 02,1098,1858,9727,2887,15570
27-03-2020,02 - 03,1134,2004,9764,2909,15811
27-03-2020,03 - 04,1141,2089,9833,2949,16012
27-03-2020,04 - 05,1091,2191,10103,3036,16421
27-03-2020,05 - 06,1070,2230,10652,3158,17110
27-03-2020,06 - 07,1201,2248,11442,3395,18286
27-03-2020,07 - 08,1347,2192,11976,3595,19110
27-03-2020,08 - 09,1303,2348,11946,3546,19143
27-03-2020,09 - 10,1171,2344,11625,3520,18660
27-03-2020,10 - 11,1185,2270,11432,3436,18323
27-03-2020,11 - 12,1076,2221,11220,3333,17850
27-03-2020,12 - 13,984,2241,11001,3222,17448
27-03-2020,13 - 14,1077,2192,10670,3100,17039
27-03-2020,14 - 15,1119,2053,10406,2986,16564
27-03-2020,15 - 16,1127,2081,10288,2906,16402
27-03-2020,16 - 17,1226,2091,10358,2870,16545
27-03-2020,17 - 18,1339,2210,10783,2971,17303
27-03-2020,18 - 19,1160,2255,11047,3078,17540
27-03-2020,19 - 20,1203,2185,11205,3154,17747
27-03-2020,20 - 21,1121,1888,10913,3050,16972
27-03-2020,21 - 22,1049,1733,10573,2984,16339
27-03-2020,22 - 23,1057,1846,10441,2911,16255
27-03-2020,23 - 00,1075,1783,10222,2807,15887
28-03-2020,00 - 01,1155,1858,9558,2721,15292
28-03-2020,01 - 02,1060,1825,9436,2704,15025
28-03-2020,02 - 03,1052,1759,9475,2697,14983
28-03-2020,03 - 04,1069,1763,9503,2710,15045
28-03-2020,04 - 05,1116,1779,9457,2740,15092
28-03-2020,05 - 06,1100,1923,9454,2788,15265
28-03-2020,06 - 07,1131,1849,9584,2848,15412
28-03-2020,07 - 08,1152,2085,9757,2864,15858
28-03-2020,08 - 09,1119,1758,9975,2875,15727
28-03-2020,09 - 10,1206,1698,10148,2830,15882
28-03-2020,10 - 11,1179,1962,10278,2792,16211
28-03-2020,11 - 12,1160,1813,10305,2756,16034
28-03-2020,12 - 13,1170,1726,10078,2678,15652
28-03-2020,13 - 14,1195,1853,9988,2588,15624
28-03-2020,14 - 15,1219,1890,9937,2568,15614
28-03-2020,15 - 16,1248,1846,9802,2610,15506
28-03-2020,16 - 17,1212,1774,10001,2688,15675
28-03-2020,17 - 18,1218,2016,10381,2899,16514
28-03-2020,18 - 19,1331,2191,10866,3043,17431
28-03-2020,19 - 20,1268,2212,10955,3098,17533
28-03-2020,20 - 21,1122,2030,10748,2936,16836
28-03-2020,21 - 22,1181,1922,10264,2800,16167
28-03-2020,22 - 23,1154,2022,9968,2724,15868
28-03-2020,23 - 00,1130,1931,9782,2601,15444
29-03-2020,00 - 01,1174,1773,9670,2619,15236
29-03-2020,01 - 02,1226,1678,9749,2617,15270
29-03-2020,02 - 03,,,,,
29-03-2020,03 - 04,1143,1674,9797,2642,15256
29-03-2020,04 - 05,1225,1836,9867,2704,15632
29-03-2020,05 - 06,1221,2003,10144,2763,16131
29-03-2020,06 - 07,1186,1829,10263,2793,16071
29-03-2020,07 - 08,1240,1989,10387,2846,16462
29-03-2020,08 - 09,1427,2317,10684,2938,17366
29-03-2020,09 - 10,1468,2523,10949,2999,17939
29-03-2020,10 - 11,1215,2368,11089,3016,17688
29-03-2020,11 - 12,1177,2126,11034,3012,17349
29-03-2020,12 - 13,1163,2106,10925,2909,17103
29-03-2020,13 - 14,1178,2123,10665,2917,16883
29-03-2020,14 - 15,1090,2054,10383,2896,16423
29-03-2020,15 - 16,1072,1867,10116,2902,15957
29-03-2020,16 - 17,1260,1792,10053,2818,15923
29-03-2020,17 - 18,1483,1830,10375,2743,16431
29-03-2020,18 - 19,1193,1928,10746,2810,16677
29-03-2020,19 - 20,1317,1867,11222,3038,17444
29-03-2020,20 - 21,1200,2005,11495,3202,17902
29-03-2020,21 - 22,1161,1942,10997,3083,17183
29-03-2020,22 - 23,1184,1791,10549,3011,16535
29-03-2020,23 - 00,1125,1771,10082,2892,15870
30-03-2020,00 - 01,1295,1915,9810,2841,15861
30-03-2020,01 - 02,1287,1977,9864,2839,15967
30-03-2020,02 - 03,1253,1697,9804,2835,15589
30-03-2020,03 - 04,1231,1725,9862,2898,15716
30-03-2020,04 - 05,1131,1562,9917,2951,15561
30-03-2020,05 - 06,1319,1783,10450,3053,16605
30-03-2020,06 - 07,1427,1816,11395,3427,18065
30-03-2020,07 - 08,1523,2093,12293,3700,19609
30-03-2020,08 - 09,1956,2304,12547,3782,20589
30-03-2020,09 - 10,1471,2524,12219,3676,19890
30-03-2020,10 - 11,1869,2358,12186,3622,20035
30-03-2020,11 - 12,1497,2394,12111,3572,19574
30-03-2020,12 - 13,1432,2338,11978,3486,19234
30-03-2020,13 - 14,1885,2079,11927,3409,19300
30-03-2020,14 - 15,2038,2107,11712,3333,19190
30-03-2020,15 - 16,2121,2122,11785,3264,19292
30-03-2020,16 - 17,1148,2053,11644,3211,18056
30-03-2020,17 - 18,1275,2061,11637,3333,18306
30-03-2020,18 - 19,1425,2160,11732,3384,18701
30-03-2020,19 - 20,1534,2415,12077,3499,19525
30-03-2020,20 - 21,1530,2379,12234,3566,19709
30-03-2020,21 - 22,1394,2328,11812,3411,18945
30-03-2020,22 - 23,1391,2143,11423,3279,18236
30-03-2020,23 - 00,1110,1956,11076,3178,17320
31-03-2020,00 - 01,957,1889,10890,3155,16891
31-03-2020,01 - 02,982,1753,10856,3133,16724
31-03-2020,02 - 03,1088,1727,10749,3146,16710
31-03-2020,03 - 04,1149,1823,10905,3200,17077
31-03-2020,04 - 05,1167,1958,10980,3297,17402
31-03-2020,05 - 06,1290,1922,11462,3444,18118
31-03-2020,06 - 07,1211,1975,12118,3732,19036
31-03-2020,07 - 08,1287,1985,12745,3995,20012
31-03-2020,08 - 09,1259,2150,12741,4013,20163
31-03-2020,09 - 10,1297,2258,12489,3822,19866
31-03-2020,10 - 11,1330,2291,12075,3678,19374
31-03-2020,11 - 12,1243,2222,11790,3523,18778
31-03-2020,12 - 13,1138,2134,11648,3386,18306
31-03-2020,13 - 14,1190,1984,11236,3303,17713
31-03-2020,14 - 15,1190,1999,10968,3218,17375
31-03-2020,15 - 16,1161,2043,10799,3139,17142
31-03-2020,16 - 17,1152,2042,10713,3104,17011
31-03-2020,17 - 18,1232,1985,11078,3144,17439
31-03-2020,18 - 19,1258,2009,11321,3232,17820
31-03-2020,19 - 20,1303,2069,11398,3295,18065
31-03-2020,20 - 21,1373,2098,11325,3292,18088
31-03-2020,21 - 22,1320,2005,10743,3141,17209
31-03-2020,22 - 23,1211,1987,10106,2964,16268
31-03-2020,23 - 00,1187,1873,9641,2803,15504
01-04-2020,00 - 01,1148,1945,9270,2631,14994
01-04-2020,01 - 02,1094,1727,9184,2633,14638
01-04-2020,02 - 03,1131,1626,9202,2618,14577
01-04-2020,03 - 04,1196,1568,9372,2656,14792
01-04-2020,04 - 05,1236,1710,9444,2748,15138
01-04-2020,05 - 06,1224,1914,10001,2893,16032
01-04-2020,06 - 07,1253,2167,10946,3225,17591
01-04-2020,07 - 08,1337,2133,11762,3484,18716
01-04-2020,08 - 09,1329,2350,11690,3580,18949
01-04-2020,09 - 10,1291,2100,11518,3571,18480
01-04-2020,10 - 11,1260,2185,11504,3603,18552
01-04-2020,11 - 12,1296,2181,11364,3610,18451
01-04-2020,12 - 13,1253,2162,11161,3582,18158
01-04-2020,13 - 14,1272,2048,11008,3524,17852
01-04-2020,14 - 15,1360,1844,10797,3444,17445
01-04-2020,15 - 16,1316,1753,10772,3383,17224
01-04-2020,16 - 17,1302,1724,10734,3308,17068
01-04-2020,17 - 18,1217,1747,10998,3357,17319
01-04-2020,18 - 19,1286,1751,11092,3364,17493
01-04-2020,19 - 20,1325,1790,11286,3327,17728
01-04-2020,20 - 21,1250,1854,11172,3248,17524
01-04-2020,21 - 22,1244,1660,10658,3054,16616
01-04-2020,22 - 23,1310,1696,10329,2892,16227
01-04-2020,23 - 00,1242,1687,9576,2730,15235
02-04-2020,00 - 01,1262,1838,9179,2680,14959
02-04-2020,01 - 02,1139,1865,9137,2624,14765
02-04-2020,02 - 03,1158,1754,9087,2621,14620
02-04-2020,03 - 04,1231,1628,8919,2643,14421
02-04-2020,04 - 05,1136,1874,9186,2676,14872
02-04-2020,05 - 06,1180,2003,9833,2824,15840
02-04-2020,06 - 07,1253,2031,10428,3131,16843
02-04-2020,07 - 08,1282,2115,11125,3418,17940
02-04-2020,08 - 09,1383,1931,11403,3505,18222
02-04-2020,09 - 10,1370,1791,11451,3553,18165
02-04-2020,10 - 11,1352,1746,11399,3563,18060
02-04-2020,11 - 12,1296,1763,11233,3460,17752
02-04-2020,12 - 13,1355,1908,11441,3482,18186
02-04-2020,13 - 14,1358,1929,11503,3481,18271
02-04-2020,14 - 15,1368,2129,11529,3446,18472
02-04-2020,15 - 16,1324,2145,11617,3466,18552
02-04-2020,16 - 17,1359,1970,11639,3414,18382
02-04-2020,17 - 18,1396,2221,12028,3463,19108
02-04-2020,18 - 19,1395,2108,11973,3486,18962
02-04-2020,19 - 20,1416,1819,11980,3447,18662
02-04-2020,20 - 21,1482,1794,12029,3425,18730
02-04-2020,21 - 22,1458,1897,11522,3289,18166
02-04-2020,22 - 23,1423,1749,10815,3124,17111
02-04-2020,23 - 00,1360,1816,10194,2955,16325
03-04-2020,00 - 01,1436,1753,9931,2845,15965
03-04-2020,01 - 02,1364,1516,9819,2802,15501
03-04-2020,02 - 03,1336,1605,9738,2776,15455
03-04-2020,03 - 04,1429,1707,9802,2781,15719
03-04-2020,04 - 05,1468,1892,9944,2809,16113
03-04-2020,05 - 06,1401,2092,10457,2951,16901
03-04-2020,06 - 07,1554,2369,11386,3248,18557
03-04-2020,07 - 08,1546,2323,12301,3534,19704
03-04-2020,08 - 09,1542,2265,12486,3579,19872
03-04-2020,09 - 10,1411,2355,12309,3572,19647
03-04-2020,10 - 11,1375,2270,12158,3550,19353
03-04-2020,11 - 12,1358,2368,12055,3509,19290
03-04-2020,12 - 13,1267,2343,11641,3445,18696
03-04-2020,13 - 14,1269,2115,11091,3385,17860
03-04-2020,14 - 15,1245,1976,10756,3308,17285
03-04-2020,15 - 16,1199,2032,10735,3257,17223
03-04-2020,16 - 17,1161,1975,10844,3328,17308
03-04-2020,17 - 18,1261,2001,10938,3304,17504
03-04-2020,18 - 19,1313,1989,10986,3250,17538
03-04-2020,19 - 20,1283,2159,11107,3243,17792
03-04-2020,20 - 21,1194,2317,11295,3325,18131
03-04-2020,21 - 22,1392,2084,10875,3204,17555
03-04-2020,22 - 23,1340,2040,10526,3060,16966
03-04-2020,23 - 00,1306,2110,10253,2876,16545
04-04-2020,00 - 01,1190,2084,10017,2779,16070
04-04-2020,01 - 02,1128,1942,9955,2775,15800
04-04-2020,02 - 03,1125,1970,9853,2790,15738
04-04-2020,03 - 04,1231,2196,9810,2743,15980
04-04-2020,04 - 05,1313,2126,9990,2761,16190
04-04-2020,05 - 06,1292,1919,10153,2798,16162
04-04-2020,06 - 07,1170,1914,10186,2800,16070
04-04-2020,07 - 08,1299,2090,10280,2926,16595
04-04-2020,08 - 09,1312,2373,10422,3106,17213
04-04-2020,09 - 10,1298,2418,10343,3085,17144
04-04-2020,10 - 11,1162,2229,10239,2984,16614
04-04-2020,11 - 12,1020,2141,10072,2956,16189
04-04-2020,12 - 13,1086,1870,9953,2883,15792
04-04-2020,13 - 14,1089,1802,9831,2796,15518
04-04-2020,14 - 15,1006,1876,9682,2717,15281
04-04-2020,15 - 16,1025,2087,9750,2660,15522
04-04-2020,16 - 17,1033,1962,9902,2625,15522
04-04-2020,17 - 18,1144,1907,10292,2770,16113
04-04-2020,18 - 19,1222,1933,10604,2869,16628
04-04-2020,19 - 20,1275,2062,10740,2930,17007
04-04-2020,20 - 21,1338,2068,10853,2952,17211
04-04-2020,21 - 22,1133,1999,10616,2791,16539
04-04-2020,22 - 23,1088,1977,10301,2675,16041
04-04-2020,23 - 00,1092,1979,9963,2616,15650
05-04-2020,00 - 01,1068,1943,9607,2561,15179
05-04-2020,01 - 02,1084,1875,9469,2505,14933
05-04-2020,02 - 03,1080,2000,9432,2490,15002
05-04-2020,03 - 04,1186,1881,9421,2541,15029
05-04-2020,04 - 05,1120,1920,9488,2540,15068
05-04-2020,05 - 06,1042,2085,9623,2575,15325
05-04-2020,06 - 07,1110,1926,9560,2607,15203
05-04-2020,07 - 08,1152,2007,9717,2662,15538
05-04-2020,08 - 09,1187,2031,9929,2745,15892
05-04-2020,09 - 10,1240,2006,10110,2790,16146
05-04-2020,10 - 11,1220,1866,10085,2768,15939
05-04-2020,11 - 12,1109,1881,10115,2623,15728
05-04-2020,12 - 13,1055,1886,9985,2584,15510
05-04-2020,13 - 14,1178,1936,9996,2554,15664
05-04-2020,14 - 15,1138,1970,9896,2458,15462
05-04-2020,15 - 16,1223,1879,9723,2369,15194
05-04-2020,16 - 17,1212,1932,9686,2337,15167
05-04-2020,17 - 18,1250,2068,9851,2470,15639
05-04-2020,18 - 19,1297,2165,10167,2646,16275
05-04-2020,19 - 20,1266,2059,10320,2791,16436
05-04-2020,20 - 21,1269,1789,10375,2813,16246
05-04-2020,21 - 22,1268,1664,10020,2649,15601
05-04-2020,22 - 23,1201,1534,9573,2504,14812
05-04-2020,23 - 00,1114,1394,9155,2387,14050
06-04-2020,00 - 01,1123,1559,8910,2273,13865
06-04-2020,01 - 02,1211,1544,8775,2259,13789
06-04-2020,02 - 03,1204,1862,8841,2335,14242
06-04-2020,03 - 04,1228,1806,8875,2369,14278
06-04-2020,04 - 05,1189,1708,9058,2379,14334
06-04-2020,05 - 06,1207,1788,9504,2455,14954
06-04-2020,06 - 07,1277,1892,10354,2743,16266
06-04-2020,07 - 08,1219,1888,11178,3063,17348
06-04-2020,08 - 09,1142,1803,11464,3222,17631
06-04-2020,09 - 10,1246,1889,11545,3245,17925
06-04-2020,10 - 11,1394,2062,11172,3143,17771
06-04-2020,11 - 12,1352,1872,10468,3027,16719
06-04-2020,12 - 13,1286,1694,10097,2901,15978
06-04-2020,13 - 14,1256,1688,10075,2817,15836
06-04-2020,14 - 15,1168,1828,9883,2754,15633
06-04-2020,15 - 16,1153,1873,9859,2761,15646
06-04-2020,16 - 17,1144,1907,9716,2758,15525
06-04-2020,17 - 18,1132,1764,9923,2801,15620
06-04-2020,18 - 19,1141,1818,10161,2873,15993
06-04-2020,19 - 20,1211,1925,10345,2926,16407
06-04-2020,20 - 21,1256,1806,10379,2899,16340
06-04-2020,21 - 22,1160,1683,9941,2702,15486
06-04-2020,22 - 23,1048,1651,9392,2541,14632
06-04-2020,23 - 00,1114,1690,8787,2379,13970
07-04-2020,00 - 01,1249,1632,8510,2290,13681
07-04-2020,01 - 02,1046,1569,8579,2205,13399
07-04-2020,02 - 03,977,1579,8593,2189,13338
07-04-2020,03 - 04,977,1610,8506,2238,13331
07-04-2020,04 - 05,1045,1731,8762,2368,13906
07-04-2020,05 - 06,1113,1948,9279,2529,14869
07-04-2020,06 - 07,1237,2167,10184,2772,16360
07-04-2020,07 - 08,1240,2176,10911,3037,17364
07-04-2020,08 - 09,1134,2013,10971,3112,17230
07-04-2020,09 - 10,1094,1787,10837,3047,16765
07-04-2020,10 - 11,1090,1632,10971,2944,16637
07-04-2020,11 - 12,1261,1768,11018,2821,16868
07-04-2020,12 - 13,1326,1980,10794,2807,16907
07-04-2020,13 - 14,1118,2035,10747,2840,16740
07-04-2020,14 - 15,1088,1791,10507,2751,16137
07-04-2020,15 - 16,1108,1793,10437,2671,16009
07-04-2020,16 - 17,1038,1721,10271,2583,15613
07-04-2020,17 - 18,1113,1728,10400,2660,15901
07-04-2020,18 - 19,1114,1855,10306,2755,16030
07-04-2020,19 - 20,1203,2164,10479,2888,16734
07-04-2020,20 - 21,1292,2123,10750,2924,17089
07-04-2020,21 - 22,1339,1992,10404,2832,16567
07-04-2020,22 - 23,1115,2014,9983,2663,15775
07-04-2020,23 - 00,946,1912,9568,2503,14929
08-04-2020,00 - 01,1111,1631,8982,2374,14098
08-04-2020,01 - 02,1133,1618,8809,2323,13883
08-04-2020,02 - 03,1148,1780,8817,2355,14100
08-04-2020,03 - 04,1150,1854,8872,2454,14330
08-04-2020,04 - 05,1138,1794,9019,2534,14485
08-04-2020,05 - 06,1174,1758,9485,2710,15127
08-04-2020,06 - 07,1186,1839,10273,2984,16282
08-04-2020,07 - 08,1326,2020,10936,3173,17455
08-04-2020,08 - 09,1211,2036,11033,3169,17449
08-04-2020,09 - 10,1311,1961,10813,3113,17198
08-04-2020,10 - 11,1345,1997,10539,2934,16815
08-04-2020,11 - 12,1206,1916,10292,2863,16277
08-04-2020,12 - 13,1148,1867,10236,2807,16058
08-04-2020,13 - 14,1015,1922,9979,2805,15721
08-04-2020,14 - 15,1095,1808,9808,2760,15471
08-04-2020,15 - 16,1138,1951,9810,2668,15567
08-04-2020,16 - 17,1150,1907,9744,2618,15419
08-04-2020,17 - 18,1155,1887,9819,2672,15533
08-04-2020,18 - 19,1171,1964,9742,2704,15581
08-04-2020,19 - 20,1253,2037,9803,2763,15856
08-04-2020,20 - 21,1269,2081,10084,2756,16190
08-04-2020,21 - 22,1093,1864,9673,2673,15303
08-04-2020,22 - 23,1067,1754,9126,2509,14456
08-04-2020,23 - 00,1195,1772,8585,2385,13937
09-04-2020,00 - 01,1119,1895,8414,2281,13709
09-04-2020,01 - 02,1142,1916,8362,2128,13548
09-04-2020,02 - 03,1123,1877,8229,2163,13392
09-04-2020,03 - 04,1144,1812,8306,2225,13487
09-04-2020,04 - 05,1161,1786,8445,2337,13729
09-04-2020,05 - 06,1138,1792,8905,2409,14244
09-04-2020,06 - 07,1231,1872,9514,2672,15289
09-04-2020,07 - 08,1257,1962,10099,3015,16333
09-04-2020,08 - 09,1288,2047,10253,3057,16645
09-04-2020,09 - 10,1209,1970,10213,3046,16438
09-04-2020,10 - 11,1202,2070,10156,2995,16423
09-04-2020,11 - 12,1342,2160,10162,2919,16583
09-04-2020,12 - 13,1439,2131,9912,2750,16232
09-04-2020,13 - 14,1300,1989,9754,2664,15707
09-04-2020,14 - 15,1191,2036,9693,2589,15509
09-04-2020,15 - 16,1231,1925,9576,2563,15295
09-04-2020,16 - 17,1237,1883,9583,2519,15222
09-04-2020,17 - 18,1109,1980,9773,2590,15452
09-04-2020,18 - 19,1279,2070,9813,2627,15789
09-04-2020,19 - 20,1278,2055,9961,2730,16024
09-04-2020,20 - 21,1336,1953,9992,2837,16118
09-04-2020,21 - 22,1330,1921,9540,2714,15505
09-04-2020,22 - 23,1233,1834,9095,2528,14690
09-04-2020,23 - 00,1178,1969,8811,2415,14373
10-04-2020,00 - 01,1156,2015,8581,2352,14104
10-04-2020,01 - 02,1194,1869,8405,2293,13761
10-04-2020,02 - 03,1229,1821,8318,2278,13646
10-04-2020,03 - 04,1102,1877,8361,2327,13667
10-04-2020,04 - 05,1102,1909,8503,2408,13922
10-04-2020,05 - 06,1167,1855,8862,2477,14361
10-04-2020,06 - 07,1238,1864,9184,2576,14862
10-04-2020,07 - 08,1220,2074,9399,2636,15329
10-04-2020,08 - 09,1175,1964,9528,2653,15320
10-04-2020,09 - 10,1325,1714,9542,2648,15229
10-04-2020,10 - 11,1198,1786,9520,2596,15100
10-04-2020,11 - 12,1178,1747,9380,2536,14841
10-04-2020,12 - 13,1141,1946,9185,2470,14742
10-04-2020,13 - 14,1019,1962,8972,2354,14307
10-04-2020,14 - 15,1012,1924,8855,2282,14073
10-04-2020,15 - 16,1069,1838,8759,2252,13918
10-04-2020,16 - 17,1133,1837,8940,2289,14199
10-04-2020,17 - 18,1375,1919,9060,2368,14722
10-04-2020,18 - 19,1323,2077,9213,2448,15061
10-04-2020,19 - 20,1175,1980,9293,2500,14948
10-04-2020,20 - 21,1264,2092,9482,2563,15401
10-04-2020,21 - 22,1381,1948,9383,2475,15187
10-04-2020,22 - 23,1151,1981,9179,2398,14709
10-04-2020,23 - 00,1101,2052,8876,2318,14347
11-04-2020,00 - 01,1081,1721,8669,2294,13765
11-04-2020,01 - 02,1177,1623,8520,2272,13592
11-04-2020,02 - 03,1239,1585,8533,2256,13613
11-04-2020,03 - 04,1104,1683,8709,2284,13780
11-04-2020,04 - 05,1146,1868,8787,2334,14135
11-04-2020,05 - 06,1201,1688,8922,2412,14223
11-04-2020,06 - 07,1128,1820,8819,2444,14211
11-04-2020,07 - 08,1247,1948,8878,2444,14517
11-04-2020,08 - 09,1281,1906,9063,2450,14700
11-04-2020,09 - 10,1258,1944,9088,2465,14755
11-04-2020,10 - 11,1213,1904,8999,2438,14554
11-04-2020,11 - 12,1136,1913,8910,2390,14349
11-04-2020,12 - 13,1158,1844,8774,2341,14117
11-04-2020,13 - 14,1121,1813,8767,2282,13983
11-04-2020,14 - 15,1063,1778,8712,2260,13813
11-04-2020,15 - 16,1171,1930,8693,2230,14024
11-04-2020,16 - 17,1149,1945,8912,2292,14298
11-04-2020,17 - 18,1207,1924,9232,2421,14784
11-04-2020,18 - 19,1219,1904,9132,2494,14749
11-04-2020,19 - 20,1245,1813,9085,2505,14648
11-04-2020,20 - 21,1253,1637,9279,2584,14753
11-04-2020,21 - 22,1195,1760,9019,2536,14510
11-04-2020,22 - 23,1094,1804,8765,2431,14094
11-04-2020,23 - 00,970,1827,8321,2287,13405
12-04-2020,00 - 01,1011,1757,8016,2229,13013
12-04-2020,01 - 02,1108,1691,7855,2192,12846
12-04-2020,02 - 03,988,1722,7761,2133,12604
12-04-2020,03 - 04,895,1805,7768,2075,12543
12-04-2020,04 - 05,1013,1735,7798,2051,12597
12-04-2020,05 - 06,1135,1537,7858,2090,12620
12-04-2020,06 - 07,1169,1549,7821,2082,12621
12-04-2020,07 - 08,1290,1619,7968,2152,13029
12-04-2020,08 - 09,1209,1839,8298,2243,13589
12-04-2020,09 - 10,1128,1791,8780,2344,14043
12-04-2020,10 - 11,1152,1795,9028,2419,14394
12-04-2020,11 - 12,1199,1807,9231,2381,14618
12-04-2020,12 - 13,1194,1787,9136,2280,14397
12-04-2020,13 - 14,1286,1871,8765,2108,14030
12-04-2020,14 - 15,1251,1826,8466,1961,13504
12-04-2020,15 - 16,1264,1792,8392,1953,13401
12-04-2020,16 - 17,1206,1678,8391,2003,13278
12-04-2020,17 - 18,1169,1929,8802,2155,14055
12-04-2020,18 - 19,1145,1847,8909,2225,14126
12-04-2020,19 - 20,1214,1908,8930,2288,14340
12-04-2020,20 - 21,1259,1925,9112,2440,14736
12-04-2020,21 - 22,1334,1884,8947,2393,14558
12-04-2020,22 - 23,1032,1811,8677,2256,13776
12-04-2020,23 - 00,936,1724,8432,2114,13206
13-04-2020,00 - 01,1144,1771,8183,2047,13145
13-04-2020,01 - 02,1072,1814,8035,2024,12945
13-04-2020,02 - 03,1110,1748,7938,2042,12838
13-04-2020,03 - 04,1123,1686,8167,2082,13058
13-04-2020,04 - 05,1166,1717,8348,2169,13400
13-04-2020,05 - 06,1208,1760,8532,2283,13783
13-04-2020,06 - 07,1220,1825,8538,2379,13962
13-04-2020,07 - 08,1175,1910,8756,2405,14246
13-04-2020,08 - 09,1302,1968,9033,2349,14652
13-04-2020,09 - 10,1331,1975,9307,2365,14978
13-04-2020,10 - 11,1320,2012,9477,2506,15315
13-04-2020,11 - 12,1315,2008,9576,2555,15454
13-04-2020,12 - 13,1282,2034,9550,2618,15484
13-04-2020,13 - 14,1311,2034,9491,2605,15441
13-04-2020,14 - 15,1293,1957,9504,2504,15258
13-04-2020,15 - 16,1269,1943,9493,2456,15161
13-04-2020,16 - 17,1292,1945,9579,2521,15337
13-04-2020,17 - 18,1265,2026,9827,2674,15792
13-04-2020,18 - 19,1288,2101,9995,2818,16202
13-04-2020,19 - 20,1308,2088,10081,2876,16353
13-04-2020,20 - 21,1400,2088,10332,2920,16740
13-04-2020,21 - 22,1381,2075,10128,2888,16472
13-04-2020,22 - 23,1302,2022,9692,2707,15723
13-04-2020,23 - 00,1248,2003,9337,2515,15103
14-04-2020,00 - 01,1341,1972,9116,2440,14869
14-04-2020,01 - 02,1107,1975,9050,2461,14593
14-04-2020,02 - 03,1146,1995,9130,2483,14754
14-04-2020,03 - 04,1098,1968,9232,2558,14856
14-04-2020,04 - 05,1149,1936,9409,2580,15074
14-04-2020,05 - 06,1100,1933,9600,2742,15375
14-04-2020,06 - 07,1070,2048,10580,3034,16732
14-04-2020,07 - 08,1084,1941,11406,3261,17692
14-04-2020,08 - 09,1194,1998,11508,3279,17979
14-04-2020,09 - 10,1229,2179,11208,3206,17822
14-04-2020,10 - 11,1225,2055,10973,3171,17424
14-04-2020,11 - 12,1224,2166,10722,3006,17118
14-04-2020,12 - 13,1104,2128,10638,2908,16778
14-04-2020,13 - 14,1178,2326,10427,2957,16888
14-04-2020,14 - 15,1227,2127,10396,2873,16623
14-04-2020,15 - 16,1299,2157,10365,2829,16650
14-04-2020,16 - 17,1323,1964,10135,2773,16195
14-04-2020,17 - 18,1283,1692,10457,2805,16237
14-04-2020,18 - 19,1215,1708,10624,2935,16482
14-04-2020,19 - 20,1225,1897,10584,3074,16780
14-04-2020,20 - 21,1160,1889,10598,3092,16739
14-04-2020,21 - 22,1060,1804,10347,2890,16101
14-04-2020,22 - 23,1106,1744,9788,2671,15309
14-04-2020,23 - 00,1207,1757,9195,2525,14684
15-04-2020,00 - 01,1137,1728,8944,2403,14212
15-04-2020,01 - 02,1040,1724,8739,2360,13863
15-04-2020,02 - 03,1064,1758,8654,2369,13845
15-04-2020,03 - 04,1135,1811,8695,2403,14044
15-04-2020,04 - 05,1251,1838,8807,2422,14318
15-04-2020,05 - 06,1245,1967,9136,2563,14911
15-04-2020,06 - 07,1062,2268,9922,2833,16085
15-04-2020,07 - 08,1056,2165,10621,3132,16974
15-04-2020,08 - 09,1188,2167,10717,3237,17309
15-04-2020,09 - 10,1236,2088,10504,3286,17114
15-04-2020,10 - 11,1272,2184,10409,3280,17145
15-04-2020,11 - 12,1325,2325,10322,3209,17181
15-04-2020,12 - 13,1318,2294,10066,3085,16763
15-04-2020,13 - 14,1254,2149,9761,3020,16184
15-04-2020,14 - 15,1214,2167,9570,2930,15881
15-04-2020,15 - 16,1136,1921,9404,2855,15316
15-04-2020,16 - 17,1137,1794,9489,2770,15190
15-04-2020,17 - 18,1224,1944,9763,2826,15757
15-04-2020,18 - 19,1243,1949,9763,2860,15815
15-04-2020,19 - 20,1223,1957,9809,2864,15853
15-04-2020,20 - 21,1200,1961,9787,2897,15845
15-04-2020,21 - 22,1274,1674,9587,2855,15390
15-04-2020,22 - 23,1299,1638,9050,2620,14607
15-04-2020,23 - 00,1195,1924,8692,2512,14323
16-04-2020,00 - 01,1252,2033,8378,2400,14063
16-04-2020,01 - 02,1176,1955,8226,2342,13699
16-04-2020,02 - 03,1116,1821,8129,2339,13405
16-04-2020,03 - 04,1131,1873,8124,2351,13479
16-04-2020,04 - 05,1191,1882,8239,2397,13709
16-04-2020,05 - 06,1169,1926,8573,2476,14144
16-04-2020,06 - 07,1256,1900,9364,2726,15246
16-04-2020,07 - 08,1181,2043,10168,3034,16426
16-04-2020,08 - 09,1179,2059,10242,3022,16502
16-04-2020,09 - 10,1244,2012,10225,2930,16411
16-04-2020,10 - 11,1220,1932,10282,2959,16393
16-04-2020,11 - 12,1188,2075,10438,2955,16656
16-04-2020,12 - 13,1261,1962,10313,2890,16426
16-04-2020,13 - 14,1182,1992,10074,2771,16019
16-04-2020,14 - 15,1062,2003,9937,2664,15666
16-04-2020,15 - 16,1099,1940,9928,2632,15599
16-04-2020,16 - 17,1223,2043,9936,2587,15789
16-04-2020,17 - 18,1172,2059,10169,2623,16023
16-04-2020,18 - 19,975,2061,10191,2642,15869
16-04-2020,19 - 20,1118,2204,10170,2704,16196
16-04-2020,20 - 21,1281,2147,10229,2779,16436
16-04-2020,21 - 22,1123,1969,10118,2747,15957
16-04-2020,22 - 23,1024,2068,9711,2565,15368
16-04-2020,23 - 00,1136,1977,9143,2364,14620
17-04-2020,00 - 01,1250,1796,8889,2260,14195
17-04-2020,01 - 02,1137,1793,8809,2248,13987
17-04-2020,02 - 03,1163,1821,8768,2265,14017
17-04-2020,03 - 04,1081,1873,8849,2359,14162
17-04-2020,04 - 05,1111,1829,9121,2410,14471
17-04-2020,05 - 06,1132,1766,9413,2528,14839
17-04-2020,06 - 07,1186,1804,10065,2754,15809
17-04-2020,07 - 08,1216,1899,10687,3040,16842
17-04-2020,08 - 09,1182,1991,10837,3113,17123
17-04-2020,09 - 10,1202,1917,10685,3011,16815
17-04-2020,10 - 11,1228,1961,10554,2993,16736
17-04-2020,11 - 12,1183,1833,10463,2913,16392
17-04-2020,12 - 13,1208,1849,10331,2796,16184
17-04-2020,13 - 14,1124,1823,10128,2712,15787
17-04-2020,14 - 15,1125,1857,9982,2648,15612
17-04-2020,15 - 16,1041,1899,9837,2573,15350
17-04-2020,16 - 17,1080,1844,9788,2536,15248
17-04-2020,17 - 18,1158,1876,9898,2564,15496
17-04-2020,18 - 19,1079,1984,9926,2590,15579
17-04-2020,19 - 20,1148,2006,9838,2613,15605
17-04-2020,20 - 21,1189,2010,9948,2637,15784
17-04-2020,21 - 22,1177,1942,9852,2592,15563
17-04-2020,22 - 23,1216,1848,9467,2462,14993
17-04-2020,23 - 00,1245,1797,9057,2390,14489
18-04-2020,00 - 01,1103,1825,8849,2214,13991
18-04-2020,01 - 02,1104,1715,8709,2187,13715
18-04-2020,02 - 03,1099,1669,8630,2242,13640
18-04-2020,03 - 04,1028,1894,8709,2282,13913
18-04-2020,04 - 05,1004,1956,8890,2308,14158
18-04-2020,05 - 06,1080,1814,9028,2363,14285
18-04-2020,06 - 07,1057,1789,9049,2357,14252
18-04-2020,07 - 08,1031,1844,9226,2432,14533
18-04-2020,08 - 09,1119,1856,9386,2568,14929
18-04-2020,09 - 10,1219,2073,9499,2617,15408
18-04-2020,10 - 11,1032,1797,9410,2547,14786
18-04-2020,11 - 12,941,1747,9388,2509,14585
18-04-2020,12 - 13,907,1930,9342,2421,14600
18-04-2020,13 - 14,1028,1793,9250,2337,14408
18-04-2020,14 - 15,1074,1816,9134,2315,14339
18-04-2020,15 - 16,1097,1812,9104,2312,14325
18-04-2020,16 - 17,1209,1807,9214,2406,14636
18-04-2020,17 - 18,1178,1888,9278,2480,14824
18-04-2020,18 - 19,1151,1920,9294,2544,14909
18-04-2020,19 - 20,1308,1932,9330,2582,15152
18-04-2020,20 - 21,1354,1817,9343,2559,15073
18-04-2020,21 - 22,1250,1669,9416,2528,14863
18-04-2020,22 - 23,1230,1753,9136,2446,14565
18-04-2020,23 - 00,1112,1742,8851,2309,14014
19-04-2020,00 - 01,1054,1803,8736,2305,13898
19-04-2020,01 - 02,1069,1636,8517,2284,13506
19-04-2020,02 - 03,1087,1642,8423,2332,13484
19-04-2020,03 - 04,1112,1725,8406,2396,13639
19-04-2020,04 - 05,1097,1713,8480,2398,13688
19-04-2020,05 - 06,1059,1687,8491,2406,13643
19-04-2020,06 - 07,1065,1566,8514,2387,13532
19-04-2020,07 - 08,1057,1648,8755,2417,13877
19-04-2020,08 - 09,1115,1812,8911,2464,14302
19-04-2020,09 - 10,1108,1788,8964,2450,14310
19-04-2020,10 - 11,1062,1624,8933,2430,14049
19-04-2020,11 - 12,1095,1640,8880,2422,14037
19-04-2020,12 - 13,1115,1482,8801,2364,13762
19-04-2020,13 - 14,1093,1642,8715,2315,13765
19-04-2020,14 - 15,1111,1725,8470,2254,13560
19-04-2020,15 - 16,1146,1757,8398,2188,13489
19-04-2020,16 - 17,1190,1634,8610,2200,13634
19-04-2020,17 - 18,1116,1687,8890,2308,14001
19-04-2020,18 - 19,1181,1789,9062,2359,14391
19-04-2020,19 - 20,1336,1805,9054,2398,14593
19-04-2020,20 - 21,1267,1551,9127,2493,14438
19-04-2020,21 - 22,1050,1603,9210,2466,14329
19-04-2020,22 - 23,1015,1421,8748,2349,13533
19-04-2020,23 - 00,1176,1622,8306,2234,13338
20-04-2020,00 - 01,1159,1416,8102,2208,12885
20-04-2020,01 - 02,947,1552,8050,2220,12769
20-04-2020,02 - 03,933,1512,7978,2212,12635
20-04-2020,03 - 04,1025,1617,8005,2240,12887
20-04-2020,04 - 05,997,1448,8153,2347,12945
20-04-2020,05 - 06,904,1417,8549,2537,13407
20-04-2020,06 - 07,988,1414,9331,2816,14549
20-04-2020,07 - 08,1194,1438,10078,3037,15747
20-04-2020,08 - 09,1239,1583,10299,3120,16241
20-04-2020,09 - 10,1125,1721,10173,3082,16101
20-04-2020,10 - 11,1069,1796,10084,3007,15956
20-04-2020,11 - 12,1060,1630,9935,2941,15566
20-04-2020,12 - 13,991,1737,9902,2882,15512
20-04-2020,13 - 14,1013,1808,9612,2849,15282
20-04-2020,14 - 15,1093,1802,9502,2791,15188
20-04-2020,15 - 16,1140,1683,9478,2739,15040
20-04-2020,16 - 17,1162,1536,9326,2616,14640
20-04-2020,17 - 18,1087,1588,9479,2658,14812
20-04-2020,18 - 19,1177,1718,9381,2674,14950
20-04-2020,19 - 20,1244,1852,9316,2691,15103
20-04-2020,20 - 21,1216,1933,9484,2683,15316
20-04-2020,21 - 22,1071,1850,9469,2688,15078
20-04-2020,22 - 23,960,1752,9015,2556,14283
20-04-2020,23 - 00,981,1803,8616,2383,13783
21-04-2020,00 - 01,1077,1577,8311,2267,13232
21-04-2020,01 - 02,940,1738,8053,2255,12986
21-04-2020,02 - 03,1064,1798,8059,2257,13178
21-04-2020,03 - 04,1087,1710,8211,2306,13314
21-04-2020,04 - 05,1111,1748,8479,2349,13687
21-04-2020,05 - 06,1273,1763,8814,2508,14358
21-04-2020,06 - 07,1327,1713,9578,2770,15388
21-04-2020,07 - 08,1266,1704,10153,2980,16103
21-04-2020,08 - 09,1248,1639,10188,3038,16113
21-04-2020,09 - 10,1139,1634,10009,2955,15737
21-04-2020,10 - 11,1080,1575,9785,2901,15341
21-04-2020,11 - 12,1016,1684,9692,2848,15240
21-04-2020,12 - 13,1081,1607,9683,2754,15125
21-04-2020,13 - 14,1033,1469,9263,2734,14499
21-04-2020,14 - 15,1035,1448,9143,2674,14300
21-04-2020,15 - 16,1192,1446,9354,2623,14615
21-04-2020,16 - 17,1120,1387,9348,2571,14426
21-04-2020,17 - 18,1109,1470,9414,2582,14575
21-04-2020,18 - 19,1145,1491,9368,2613,14617
21-04-2020,19 - 20,1213,1613,9233,2673,14732
21-04-2020,20 - 21,1152,1579,9372,2719,14822
21-04-2020,21 - 22,1053,1521,9112,2686,14372
21-04-2020,22 - 23,1104,1652,8698,2551,14005
21-04-2020,23 - 00,1087,1454,8259,2417,13217
22-04-2020,00 - 01,1074,1319,7857,2336,12586
22-04-2020,01 - 02,1071,1290,7665,2295,12321
22-04-2020,02 - 03,1045,1237,7634,2298,12214
22-04-2020,03 - 04,1054,1300,7702,2318,12374
22-04-2020,04 - 05,982,1314,7902,2394,12592
22-04-2020,05 - 06,988,1358,8249,2527,13122
22-04-2020,06 - 07,1022,1452,9060,2746,14280
22-04-2020,07 - 08,985,1461,9787,2967,15200
22-04-2020,08 - 09,1097,1599,10037,3015,15748
22-04-2020,09 - 10,1107,1680,9950,2942,15679
22-04-2020,10 - 11,1141,1725,9771,2879,15516
22-04-2020,11 - 12,1123,1649,9619,2860,15251
22-04-2020,12 - 13,1038,1660,9463,2793,14954
22-04-2020,13 - 14,1003,1318,9265,2705,14291
22-04-2020,14 - 15,961,1327,9105,2655,14048
22-04-2020,15 - 16,899,1195,8948,2601,13643
22-04-2020,16 - 17,1115,1541,8979,2560,14195
22-04-2020,17 - 18,1201,1408,9232,2667,14508
22-04-2020,18 - 19,1187,1305,9135,2652,14279
22-04-2020,19 - 20,1141,1431,9066,2650,14288
22-04-2020,20 - 21,1122,1243,9077,2626,14068
22-04-2020,21 - 22,1117,1334,8914,2587,13952
22-04-2020,22 - 23,1124,1478,8294,2418,13314
22-04-2020,23 - 00,1012,1396,7814,2268,12490
23-04-2020,00 - 01,987,1250,7467,2199,11903
23-04-2020,01 - 02,986,1269,7400,2143,11798
23-04-2020,02 - 03,1083,1309,7470,2094,11956
23-04-2020,03 - 04,1089,1301,7508,2073,11971
23-04-2020,04 - 05,1080,1364,7721,2144,12309
23-04-2020,05 - 06,1078,1343,7916,2249,12586
23-04-2020,06 - 07,1117,1483,8648,2538,13786
23-04-2020,07 - 08,1113,1709,9432,2845,15099
23-04-2020,08 - 09,1135,1677,9675,2933,15420
23-04-2020,09 - 10,1128,1630,9548,2859,15165
23-04-2020,10 - 11,1126,1657,9498,2774,15055
23-04-2020,11 - 12,1030,1683,9547,2711,14971
23-04-2020,12 - 13,1057,1598,9439,2665,14759
23-04-2020,13 - 14,1119,1390,9226,2655,14390
23-04-2020,14 - 15,1141,1402,8984,2629,14156
23-04-2020,15 - 16,1052,1526,8968,2570,14116
23-04-2020,16 - 17,1107,1616,8884,2499,14106
23-04-2020,17 - 18,1087,1477,8885,2500,13949
23-04-2020,18 - 19,1097,1546,8856,2483,13982
23-04-2020,19 - 20,1156,1685,8891,2476,14208
23-04-2020,20 - 21,1069,1618,8902,2491,14080
23-04-2020,21 - 22,1127,1397,8804,2518,13846
23-04-2020,22 - 23,1231,1561,8233,2327,13352
23-04-2020,23 - 00,1185,1610,7827,2170,12792
24-04-2020,00 - 01,1061,1441,7589,2099,12190
24-04-2020,01 - 02,1090,1387,7496,2070,12043
24-04-2020,02 - 03,1089,1244,7557,2064,11954
24-04-2020,03 - 04,1059,1242,7493,2077,11871
24-04-2020,04 - 05,1085,1378,7539,2077,12079
24-04-2020,05 - 06,1155,1428,7759,2161,12503
24-04-2020,06 - 07,1168,1836,8592,2389,13985
24-04-2020,07 - 08,1208,1945,9549,2660,15362
24-04-2020,08 - 09,1187,2004,9889,2769,15849
24-04-2020,09 - 10,1236,1999,9817,2691,15743
24-04-2020,10 - 11,1178,1918,9788,2608,15492
24-04-2020,11 - 12,1142,1957,9773,2585,15457
24-04-2020,12 - 13,1313,1920,9739,2506,15478
24-04-2020,13 - 14,1204,1704,9529,2393,14830
24-04-2020,14 - 15,1132,1811,9306,2347,14596
24-04-2020,15 - 16,1205,1678,9230,2346,14459
24-04-2020,16 - 17,1060,1650,9387,2282,14379
24-04-2020,17 - 18,837,1638,9489,2347,14311
24-04-2020,18 - 19,1019,1711,9537,2378,14645
24-04-2020,19 - 20,1114,1668,9392,2348,14522
24-04-2020,20 - 21,1083,1486,9126,2320,14015
24-04-2020,21 - 22,1189,1530,8861,2292,13872
24-04-2020,22 - 23,1045,1487,8424,2188,13144
24-04-2020,23 - 00,980,1501,8040,2138,12659
25-04-2020,00 - 01,1132,1440,7744,2183,12499
25-04-2020,01 - 02,1311,1350,7584,2092,12337
25-04-2020,02 - 03,1177,1360,7520,1977,12034
25-04-2020,03 - 04,968,1303,7524,1960,11755
25-04-2020,04 - 05,1043,1230,7498,2000,11771
25-04-2020,05 - 06,1155,1129,7503,2015,11802
25-04-2020,06 - 07,1038,1255,7802,2036,12131
25-04-2020,07 - 08,1160,1476,8116,2129,12881
25-04-2020,08 - 09,1095,1413,8324,2307,13139
25-04-2020,09 - 10,1133,1450,8691,2424,13698
25-04-2020,10 - 11,1287,1508,8830,2368,13993
25-04-2020,11 - 12,1188,1551,8920,2340,13999
25-04-2020,12 - 13,1216,1699,8878,2306,14099
25-04-2020,13 - 14,1183,1563,8847,2228,13821
25-04-2020,14 - 15,1119,1428,8680,2143,13370
25-04-2020,15 - 16,1112,1338,8545,2044,13039
25-04-2020,16 - 17,1082,1562,8581,2113,13338
25-04-2020,17 - 18,1056,1551,8893,2263,13763
25-04-2020,18 - 19,1165,1463,9028,2360,14016
25-04-2020,19 - 20,1303,1461,8962,2451,14177
25-04-2020,20 - 21,1158,1418,8904,2479,13959
25-04-2020,21 - 22,1188,1454,8863,2451,13956
25-04-2020,22 - 23,1134,1534,8585,2337,13590
25-04-2020,23 - 00,946,1529,8168,2247,12890
26-04-2020,00 - 01,1072,1406,7944,2154,12576
26-04-2020,01 - 02,1186,1405,7862,2084,12537
26-04-2020,02 - 03,1192,1461,7776,2044,12473
26-04-2020,03 - 04,1201,1461,7751,2044,12457
26-04-2020,04 - 05,1144,1501,7805,2106,12556
26-04-2020,05 - 06,1159,1462,7763,2158,12542
26-04-2020,06 - 07,1162,1558,7848,2126,12694
26-04-2020,07 - 08,1163,1645,8065,2195,13068
26-04-2020,08 - 09,1210,1579,8399,2243,13431
26-04-2020,09 - 10,1188,1565,8552,2311,13616
26-04-2020,10 - 11,1149,1544,8767,2280,13740
26-04-2020,11 - 12,1225,1555,8801,2303,13884
26-04-2020,12 - 13,1180,1642,8708,2272,13802
26-04-2020,13 - 14,1126,1687,8526,2220,13559
26-04-2020,14 - 15,1163,1618,8444,2178,13403
26-04-2020,15 - 16,1135,1508,8469,2125,13237
26-04-2020,16 - 17,1248,1584,8512,2158,13502
26-04-2020,17 - 18,1241,1633,8707,2280,13861
26-04-2020,18 - 19,1114,1660,8992,2404,14170
26-04-2020,19 - 20,1116,1615,9025,2440,14196
26-04-2020,20 - 21,1231,1676,9188,2453,14548
26-04-2020,21 - 22,1121,1596,9184,2420,14321
26-04-2020,22 - 23,1169,1681,8799,2291,13940
26-04-2020,23 - 00,1142,1636,8502,2188,13468
27-04-2020,00 - 01,1024,1614,8261,2100,12999
27-04-2020,01 - 02,1058,1546,8175,2076,12855
27-04-2020,02 - 03,999,1559,8187,2097,12842
27-04-2020,03 - 04,970,1587,8261,2139,12957
27-04-2020,04 - 05,1009,1601,8415,2239,13264
27-04-2020,05 - 06,1103,1602,8568,2324,13597
27-04-2020,06 - 07,1175,1677,9480,2591,14923
27-04-2020,07 - 08,1209,1747,10253,2853,16062
27-04-2020,08 - 09,1210,1758,10294,2944,16206
27-04-2020,09 - 10,1120,1830,10332,2894,16176
27-04-2020,10 - 11,1116,1761,10529,2930,16336
27-04-2020,11 - 12,1138,1782,10615,2902,16437
27-04-2020,12 - 13,1129,1830,10665,2907,16531
27-04-2020,13 - 14,1138,1784,10520,2928,16370
27-04-2020,14 - 15,1023,1818,10363,2902,16106
27-04-2020,15 - 16,1043,1858,10552,2891,16344
27-04-2020,16 - 17,1032,1836,10609,2737,16214
27-04-2020,17 - 18,979,1882,10849,2798,16508
27-04-2020,18 - 19,1013,1805,10810,2831,16459
27-04-2020,19 - 20,1023,1838,10673,2787,16321
27-04-2020,20 - 21,1040,1742,10543,2728,16053
27-04-2020,21 - 22,1076,1734,10320,2686,15816
27-04-2020,22 - 23,1153,1814,9869,2536,15372
27-04-2020,23 - 00,1153,1781,9336,2395,14665
28-04-2020,00 - 01,1101,1675,8985,2312,14073
28-04-2020,01 - 02,1066,1688,8955,2234,13943
28-04-2020,02 - 03,1045,1760,8961,2231,13997
28-04-2020,03 - 04,1089,1792,8871,2206,13958
28-04-2020,04 - 05,1047,1788,8981,2281,14097
28-04-2020,05 - 06,1023,1768,9283,2334,14408
28-04-2020,06 - 07,1126,1904,10142,2623,15795
28-04-2020,07 - 08,1185,1924,11131,2980,17220
28-04-2020,08 - 09,1058,1963,11305,3077,17403
28-04-2020,09 - 10,1137,1941,11295,3063,17436
28-04-2020,10 - 11,1113,1917,11227,3025,17282
28-04-2020,11 - 12,1183,2006,11243,2975,17407
28-04-2020,12 - 13,1216,1954,11184,2862,17216
28-04-2020,13 - 14,1125,1852,11011,2850,16838
28-04-2020,14 - 15,1158,1905,10833,2770,16666
28-04-2020,15 - 16,1106,1858,10818,2703,16485
28-04-2020,16 - 17,1062,1904,10792,2690,16448
28-04-2020,17 - 18,1040,1966,11019,2741,16766
28-04-2020,18 - 19,1033,1987,10891,2776,16687
28-04-2020,19 - 20,1135,1924,10813,2762,16634
28-04-2020,20 - 21,1179,2009,10708,2752,16648
28-04-2020,21 - 22,1137,2041,10613,2735,16526
28-04-2020,22 - 23,1051,1947,10189,2566,15753
28-04-2020,23 - 00,1030,1872,9702,2435,15039
29-04-2020,00 - 01,1023,1756,9420,2253,14452
29-04-2020,01 - 02,995,1748,9303,2241,14287
29-04-2020,02 - 03,1086,1784,9291,2264,14425
29-04-2020,03 - 04,1126,1828,9412,2262,14628
29-04-2020,04 - 05,1096,1881,9526,2320,14823
29-04-2020,05 - 06,1108,1839,9735,2389,15071
29-04-2020,06 - 07,1115,1944,10595,2695,16349
29-04-2020,07 - 08,1150,2106,11350,3025,17631
29-04-2020,08 - 09,1132,2068,11372,3130,17702
29-04-2020,09 - 10,1143,1956,11172,3049,17320
29-04-2020,10 - 11,1129,1947,11106,3039,17221
29-04-2020,11 - 12,1114,2056,11059,3040,17269
29-04-2020,12 - 13,1079,1980,10966,2966,16991
29-04-2020,13 - 14,1080,1914,10751,2938,16683
29-04-2020,14 - 15,1154,1918,10596,2880,16548
29-04-2020,15 - 16,1201,1920,10560,2870,16551
29-04-2020,16 - 17,1106,1908,10342,2849,16205
29-04-2020,17 - 18,1118,1905,10442,2894,16359
29-04-2020,18 - 19,1156,1885,10344,2943,16328
29-04-2020,19 - 20,1177,1924,10276,2935,16312
29-04-2020,20 - 21,1121,1924,10364,2889,16298
29-04-2020,21 - 22,1183,1863,10198,2792,16036
29-04-2020,22 - 23,1191,1731,9800,2640,15362
29-04-2020,23 - 00,1063,1722,9390,2465,14640
30-04-2020,00 - 01,982,1720,9202,2406,14310
30-04-2020,01 - 02,1075,1720,9122,2369,14286
30-04-2020,02 - 03,1037,1703,9134,2365,14239
30-04-2020,03 - 04,1034,1783,9208,2361,14386
30-04-2020,04 - 05,1065,1757,9352,2412,14586
30-04-2020,05 - 06,1033,1732,9594,2484,14843
30-04-2020,06 - 07,1161,1893,10384,2758,16196
30-04-2020,07 - 08,1145,2133,11083,3050,17411
30-04-2020,08 - 09,1159,2072,11043,3161,17435
30-04-2020,09 - 10,1122,2012,10853,3220,17207
30-04-2020,10 - 11,1089,1865,10713,3270,16937
30-04-2020,11 - 12,1089,1805,10575,3245,16714
30-04-2020,12 - 13,1115,1736,10569,3208,16628
30-04-2020,13 - 14,1066,1628,10324,3182,16200
30-04-2020,14 - 15,1061,1677,10177,3116,16031
30-04-2020,15 - 16,1123,1631,10119,3065,15938
30-04-2020,16 - 17,999,1581,10190,3034,15804
30-04-2020,17 - 18,1066,1649,10406,3047,16168
30-04-2020,18 - 19,1119,1629,10365,3003,16116
30-04-2020,19 - 20,1086,1703,10309,2936,16034
30-04-2020,20 - 21,1112,1655,10138,2822,15727
30-04-2020,21 - 22,988,1651,9810,2664,15113
30-04-2020,22 - 23,867,1550,9173,2622,14212
30-04-2020,23 - 00,885,1549,8759,2577,13770
01-05-2020,00 - 01,966,1456,8536,2383,13341
01-05-2020,01 - 02,881,1242,8314,2293,12730
01-05-2020,02 - 03,965,1314,8241,2237,12757
01-05-2020,03 - 04,1023,1403,8254,2200,12880
01-05-2020,04 - 05,984,1511,8193,2183,12871
01-05-2020,05 - 06,1030,1490,8114,2196,12830
01-05-2020,06 - 07,1130,1491,8273,2271,13165
01-05-2020,07 - 08,1238,1652,8601,2356,13847
01-05-2020,08 - 09,1229,1868,9006,2526,14629
01-05-2020,09 - 10,1101,1836,9365,2693,14995
01-05-2020,10 - 11,1107,1856,9673,2744,15380
01-05-2020,11 - 12,1102,1742,9850,2728,15422
01-05-2020,12 - 13,1113,1765,9947,2616,15441
01-05-2020,13 - 14,1028,1892,9992,2506,15418
01-05-2020,14 - 15,1097,1653,9943,2453,15146
01-05-2020,15 - 16,1140,1786,9839,2462,15227
01-05-2020,16 - 17,1174,1802,9880,2502,15358
01-05-2020,17 - 18,1112,1709,10071,2613,15505
01-05-2020,18 - 19,1081,1769,10058,2613,15521
01-05-2020,19 - 20,1093,1723,9791,2530,15137
01-05-2020,20 - 21,978,1684,9481,2491,14634
01-05-2020,21 - 22,934,1731,9279,2453,14397
01-05-2020,22 - 23,1030,1854,8828,2343,14055
01-05-2020,23 - 00,1011,1660,8480,2212,13363
02-05-2020,00 - 01,986,1572,8160,2118,12836
02-05-2020,01 - 02,1034,1520,7988,2093,12635
02-05-2020,02 - 03,999,1469,7886,2071,12425
02-05-2020,03 - 04,954,1600,7880,2068,12502
02-05-2020,04 - 05,905,1650,7925,2088,12568
02-05-2020,05 - 06,914,1676,7849,2070,12509
02-05-2020,06 - 07,912,1656,8041,2071,12680
02-05-2020,07 - 08,1042,1785,8234,2141,13202
02-05-2020,08 - 09,1105,1835,8517,2246,13703
02-05-2020,09 - 10,1240,1857,8746,2326,14169
02-05-2020,10 - 11,1164,1957,8878,2362,14361
02-05-2020,11 - 12,1129,1962,8882,2386,14359
02-05-2020,12 - 13,1054,1908,8806,2417,14185
02-05-2020,13 - 14,1015,2017,8668,2422,14122
02-05-2020,14 - 15,1062,2034,8509,2377,13982
02-05-2020,15 - 16,994,1779,8375,2337,13485
02-05-2020,16 - 17,1067,1838,8398,2389,13692
02-05-2020,17 - 18,1175,1921,8653,2427,14176
02-05-2020,18 - 19,1182,1885,8834,2486,14387
02-05-2020,19 - 20,1076,1828,8733,2490,14127
02-05-2020,20 - 21,1011,1847,8693,2474,14025
02-05-2020,21 - 22,1071,1882,8771,2472,14196
02-05-2020,22 - 23,1019,1832,8494,2369,13714
02-05-2020,23 - 00,1024,1729,7966,2244,12963
03-05-2020,00 - 01,1046,1693,7813,2145,12697
03-05-2020,01 - 02,1000,1664,7727,2059,12450
03-05-2020,02 - 03,1005,1745,7689,2044,12483
03-05-2020,03 - 04,1069,1760,7660,2070,12559
03-05-2020,04 - 05,1042,1818,7839,2084,12783
03-05-2020,05 - 06,995,1562,7593,2054,12204
03-05-2020,06 - 07,1032,1414,7514,2053,12013
03-05-2020,07 - 08,1035,1589,7674,2112,12410
03-05-2020,08 - 09,1119,1678,7909,2202,12908
03-05-2020,09 - 10,1102,1818,8166,2272,13358
03-05-2020,10 - 11,1064,1823,8244,2289,13420
03-05-2020,11 - 12,1129,1595,8224,2318,13266
03-05-2020,12 - 13,1045,1775,8196,2270,13286
03-05-2020,13 - 14,998,1664,8197,2182,13041
03-05-2020,14 - 15,930,1717,8074,2075,12796
03-05-2020,15 - 16,1036,1657,8016,2059,12768
03-05-2020,16 - 17,1226,1552,8273,2060,13111
03-05-2020,17 - 18,1188,1519,8670,2230,13607
03-05-2020,18 - 19,1043,1624,8732,2324,13723
03-05-2020,19 - 20,1049,1889,8668,2356,13962
03-05-2020,20 - 21,1111,1765,8733,2409,14018
03-05-2020,21 - 22,1093,1683,8846,2404,14026
03-05-2020,22 - 23,1048,1657,8601,2308,13614
03-05-2020,23 - 00,1021,1610,8082,2140,12853
04-05-2020,00 - 01,1005,1533,7840,2064,12442
04-05-2020,01 - 02,940,1587,7709,2036,12272
04-05-2020,02 - 03,927,1525,7897,2072,12421
04-05-2020,03 - 04,900,1559,7960,2114,12533
04-05-2020,04 - 05,881,1602,8120,2167,12770
04-05-2020,05 - 06,1045,1678,8348,2239,13310
04-05-2020,06 - 07,1196,1906,9191,2550,14843
04-05-2020,07 - 08,1117,2069,10077,2877,16140
04-05-2020,08 - 09,1125,1921,10393,2954,16393
04-05-2020,09 - 10,1138,1835,10451,2878,16302
04-05-2020,10 - 11,1066,1961,10473,2857,16357
04-05-2020,11 - 12,1046,1947,10441,2820,16254
04-05-2020,12 - 13,1047,1968,10594,2769,16378
04-05-2020,13 - 14,1076,2012,10598,2734,16420
04-05-2020,14 - 15,1070,1954,10432,2656,16112
04-05-2020,15 - 16,1098,1933,10380,2548,15959
04-05-2020,16 - 17,1112,1878,10313,2458,15761
04-05-2020,17 - 18,1035,1802,10456,2453,15746
04-05-2020,18 - 19,1074,1928,10500,2533,16035
04-05-2020,19 - 20,1068,1830,10422,2553,15873
04-05-2020,20 - 21,1112,1758,10251,2587,15708
04-05-2020,21 - 22,1122,1931,10233,2605,15891
04-05-2020,22 - 23,1084,1792,9761,2398,15035
04-05-2020,23 - 00,960,1495,9279,2277,14011
05-05-2020,00 - 01,931,1294,8812,2212,13249
05-05-2020,01 - 02,832,1330,8579,2144,12885
05-05-2020,02 - 03,824,1549,8558,2266,13197
05-05-2020,03 - 04,923,1639,8620,2302,13484
05-05-2020,04 - 05,930,1736,8696,2276,13638
05-05-2020,05 - 06,1002,1712,8870,2352,13936
05-05-2020,06 - 07,1076,1742,9673,2651,15142
05-05-2020,07 - 08,1064,1913,10612,2982,16571
05-05-2020,08 - 09,997,2088,10965,3105,17155
05-05-2020,09 - 10,1010,1980,10863,3180,17033
05-05-2020,10 - 11,1044,1866,10840,3233,16983
05-05-2020,11 - 12,1041,1722,10764,3219,16746
05-05-2020,12 - 13,977,1703,10642,3164,16486
05-05-2020,13 - 14,922,1693,10351,3156,16122
05-05-2020,14 - 15,889,1724,10151,3021,15785
05-05-2020,15 - 16,853,1719,10019,2949,15540
05-05-2020,16 - 17,896,1901,9920,2809,15526
05-05-2020,17 - 18,930,1836,9990,2737,15493
05-05-2020,18 - 19,953,1680,9874,2677,15184
05-05-2020,19 - 20,813,1877,9869,2661,15220
05-05-2020,20 - 21,765,1864,9937,2633,15199
05-05-2020,21 - 22,814,1796,9838,2578,15026
05-05-2020,22 - 23,854,1705,9462,2487,14508
05-05-2020,23 - 00,799,1713,8993,2313,13818
06-05-2020,00 - 01,915,1684,8618,2227,13444
06-05-2020,01 - 02,902,1573,8515,2177,13167
06-05-2020,02 - 03,895,1604,8499,2220,13218
06-05-2020,03 - 04,830,1625,8529,2235,13219
06-05-2020,04 - 05,791,1603,8650,2262,13306
06-05-2020,05 - 06,823,1634,8637,2393,13487
06-05-2020,06 - 07,998,1587,9306,2582,14473
06-05-2020,07 - 08,907,1492,9999,2863,15261
06-05-2020,08 - 09,846,1717,10232,2932,15727
06-05-2020,09 - 10,889,1679,10106,2809,15483
06-05-2020,10 - 11,949,1571,9891,2734,15145
06-05-2020,11 - 12,947,1650,10009,2731,15337
06-05-2020,12 - 13,986,1662,9968,2693,15309
06-05-2020,13 - 14,1011,1646,9847,2626,15130
06-05-2020,14 - 15,1070,1783,9726,2553,15132
06-05-2020,15 - 16,1031,1798,9476,2451,14756
06-05-2020,16 - 17,977,1636,9278,2396,14287
06-05-2020,17 - 18,998,1587,9344,2414,14343
06-05-2020,18 - 19,911,1440,9300,2385,14036
06-05-2020,19 - 20,1043,1558,9444,2404,14449
06-05-2020,20 - 21,987,1776,9589,2476,14828
06-05-2020,21 - 22,850,1699,9450,2540,14539
06-05-2020,22 - 23,697,1579,9015,2406,13697
06-05-2020,23 - 00,736,1524,8701,2186,13147
07-05-2020,00 - 01,820,1552,8499,2056,12927
07-05-2020,01 - 02,775,1432,8306,1987,12500
07-05-2020,02 - 03,773,1467,8264,2018,12522
07-05-2020,03 - 04,698,1543,8266,2058,12565
07-05-2020,04 - 05,760,1399,8141,2107,12407
07-05-2020,05 - 06,885,1511,8443,2202,13041
07-05-2020,06 - 07,929,1672,9336,2499,14436
07-05-2020,07 - 08,887,1735,10092,2785,15499
07-05-2020,08 - 09,868,1598,10183,2826,15475
07-05-2020,09 - 10,1024,1791,10047,2760,15622
07-05-2020,10 - 11,954,1887,10026,2714,15581
07-05-2020,11 - 12,952,1803,9867,2661,15283
07-05-2020,12 - 13,954,1692,9750,2628,15024
07-05-2020,13 - 14,945,1847,9687,2579,15058
07-05-2020,14 - 15,947,1806,9706,2505,14964
07-05-2020,15 - 16,904,1878,9681,2510,14973
07-05-2020,16 - 17,960,1975,9559,2445,14939
07-05-2020,17 - 18,1064,1883,9681,2440,15068
07-05-2020,18 - 19,1001,1776,9541,2419,14737
07-05-2020,19 - 20,1074,1800,9587,2461,14922
07-05-2020,20 - 21,1240,1798,9652,2503,15193
07-05-2020,21 - 22,1170,1797,9662,2433,15062
07-05-2020,22 - 23,1126,1857,9317,2305,14605
07-05-2020,23 - 00,964,1886,8778,2104,13732
08-05-2020,00 - 01,944,1787,8507,2005,13243
08-05-2020,01 - 02,917,1771,8303,2069,13060
08-05-2020,02 - 03,857,1700,8202,2029,12788
08-05-2020,03 - 04,962,1614,8189,1997,12762
08-05-2020,04 - 05,963,1609,8202,2016,12790
08-05-2020,05 - 06,962,1623,8367,2106,13058
08-05-2020,06 - 07,1056,1715,9225,2396,14392
08-05-2020,07 - 08,1140,1762,9935,2663,15500
08-05-2020,08 - 09,1098,1987,10137,2727,15949
08-05-2020,09 - 10,1143,1898,10031,2756,15828
08-05-2020,10 - 11,1135,1885,9801,2759,15580
08-05-2020,11 - 12,1063,1763,9845,2713,15384
08-05-2020,12 - 13,1108,1643,9755,2669,15175
08-05-2020,13 - 14,1132,1687,9418,2572,14809
08-05-2020,14 - 15,1055,1616,9126,2498,14295
08-05-2020,15 - 16,1033,1528,9051,2447,14059
08-05-2020,16 - 17,1120,1537,8950,2341,13948
08-05-2020,17 - 18,1273,1641,9086,2417,14417
08-05-2020,18 - 19,1258,1585,9055,2379,14277
08-05-2020,19 - 20,1197,1726,8914,2338,14175
08-05-2020,20 - 21,1031,1650,8810,2397,13888
08-05-2020,21 - 22,959,1621,8918,2430,13928
08-05-2020,22 - 23,1266,1560,8668,2328,13822
08-05-2020,23 - 00,1076,1590,8304,2171,13141
09-05-2020,00 - 01,869,1621,7990,2034,12514
09-05-2020,01 - 02,941,1559,7913,1985,12398
09-05-2020,02 - 03,915,1575,7855,1960,12305
09-05-2020,03 - 04,889,1650,7781,1961,12281
09-05-2020,04 - 05,838,1522,7708,1923,11991
09-05-2020,05 - 06,719,1561,7743,1883,11906
09-05-2020,06 - 07,775,1878,7825,1919,12397
09-05-2020,07 - 08,932,1733,8033,2058,12756
09-05-2020,08 - 09,1029,1679,8360,2180,13248
09-05-2020,09 - 10,1122,1777,8610,2230,13739
09-05-2020,10 - 11,1075,1828,8672,2227,13802
09-05-2020,11 - 12,1013,1816,8634,2238,13701
09-05-2020,12 - 13,927,1668,8487,2197,13279
09-05-2020,13 - 14,916,1636,8327,2125,13004
09-05-2020,14 - 15,992,1625,8312,2062,12991
09-05-2020,15 - 16,1047,1672,8248,2003,12970
09-05-2020,16 - 17,1143,1675,8272,2025,13115
09-05-2020,17 - 18,1055,1754,8493,2117,13419
09-05-2020,18 - 19,1151,1680,8796,2171,13798
09-05-2020,19 - 20,1061,1654,8714,2157,13586
09-05-2020,20 - 21,1037,1808,8813,2136,13794
09-05-2020,21 - 22,1164,1849,8579,2145,13737
09-05-2020,22 - 23,956,1713,8411,2117,13197
09-05-2020,23 - 00,729,1600,8182,2028,12539
10-05-2020,00 - 01,699,1588,7972,1982,12241
10-05-2020,01 - 02,797,1747,7642,1939,12125
10-05-2020,02 - 03,753,1791,7499,1919,11962
10-05-2020,03 - 04,816,1839,7402,1931,11988
10-05-2020,04 - 05,997,1823,7212,1872,11904
10-05-2020,05 - 06,937,1762,7039,1746,11484
10-05-2020,06 - 07,985,1776,7088,1723,11572
10-05-2020,07 - 08,990,1745,7379,1835,11949
10-05-2020,08 - 09,1095,1743,7788,2068,12694
10-05-2020,09 - 10,1102,1604,8133,2147,12986
10-05-2020,10 - 11,1105,1639,8355,2259,13358
10-05-2020,11 - 12,1089,1851,8600,2298,13838
10-05-2020,12 - 13,1135,1742,8784,2268,13929
10-05-2020,13 - 14,1015,1654,8667,2244,13580
10-05-2020,14 - 15,966,1484,8537,2190,13177
10-05-2020,15 - 16,974,1732,8532,2115,13353
10-05-2020,16 - 17,555,1686,8548,2163,12952
10-05-2020,17 - 18,898,1829,8965,2227,13919
10-05-2020,18 - 19,861,1698,9102,2196,13857
10-05-2020,19 - 20,905,1609,9050,2241,13805
10-05-2020,20 - 21,814,1628,8828,2189,13459
10-05-2020,21 - 22,956,1788,8743,2231,13718
10-05-2020,22 - 23,969,1639,8721,2152,13481
10-05-2020,23 - 00,807,1557,8310,2022,12696
11-05-2020,00 - 01,756,1518,8329,1865,12468
11-05-2020,01 - 02,728,1352,8371,1848,12299
11-05-2020,02 - 03,795,1490,8544,1793,12622
11-05-2020,03 - 04,716,1506,8541,1867,12630
11-05-2020,04 - 05,724,1485,8518,1928,12655
11-05-2020,05 - 06,814,1537,8861,2049,13261
11-05-2020,06 - 07,1039,1892,9824,2475,15230
11-05-2020,07 - 08,958,2026,10711,2788,16483
11-05-2020,08 - 09,1127,2080,10762,2869,16838
11-05-2020,09 - 10,1055,2010,10730,2936,16731
11-05-2020,10 - 11,1002,1801,10547,2999,16349
11-05-2020,11 - 12,880,1606,10441,2923,15850
11-05-2020,12 - 13,962,1595,10258,2884,15699
11-05-2020,13 - 14,945,1436,10047,2843,15271
11-05-2020,14 - 15,998,1643,9863,2751,15255
11-05-2020,15 - 16,1199,1938,9803,2703,15643
11-05-2020,16 - 17,1139,1895,9588,2644,15266
11-05-2020,17 - 18,985,1613,9770,2672,15040
11-05-2020,18 - 19,995,1788,9736,2641,15160
11-05-2020,19 - 20,1021,1892,9681,2573,15167
11-05-2020,20 - 21,1213,1915,9693,2579,15400
11-05-2020,21 - 22,1122,1972,9749,2618,15461
11-05-2020,22 - 23,977,1836,9370,2492,14675
11-05-2020,23 - 00,986,1564,8888,2320,13758
12-05-2020,00 - 01,964,1600,8716,2285,13565
12-05-2020,01 - 02,1005,1914,8615,2267,13801
12-05-2020,02 - 03,870,1703,8756,2269,13598
12-05-2020,03 - 04,822,1580,8852,2332,13586
12-05-2020,04 - 05,915,1667,8806,2319,13707
12-05-2020,05 - 06,1055,1811,8902,2416,14184
12-05-2020,06 - 07,1176,1967,9553,2638,15334
12-05-2020,07 - 08,1128,1904,10127,2934,16093
12-05-2020,08 - 09,1046,1834,10047,2873,15800
12-05-2020,09 - 10,1048,1767,9871,2778,15464
12-05-2020,10 - 11,1063,1681,9964,2795,15503
12-05-2020,11 - 12,1098,1721,10034,2847,15700
12-05-2020,12 - 13,1034,1739,9967,2872,15612
12-05-2020,13 - 14,1057,1761,9773,2871,15462
12-05-2020,14 - 15,986,1732,9703,2882,15303
12-05-2020,15 - 16,1042,1724,9907,2909,15582
12-05-2020,16 - 17,1060,1882,9937,2893,15772
12-05-2020,17 - 18,1178,1920,10203,3038,16339
12-05-2020,18 - 19,1169,1827,10169,3026,16191
12-05-2020,19 - 20,1161,1674,10020,2883,15738
12-05-2020,20 - 21,1287,1824,10078,2694,15883
12-05-2020,21 - 22,1229,1951,9955,2747,15882
12-05-2020,22 - 23,1157,1967,9578,2682,15384
12-05-2020,23 - 00,1124,1916,9090,2523,14653
13-05-2020,00 - 01,1207,1722,8733,2422,14084
13-05-2020,01 - 02,1097,1749,8674,2415,13935
13-05-2020,02 - 03,1110,1524,8624,2439,13697
13-05-2020,03 - 04,1149,1517,8670,2390,13726
13-05-2020,04 - 05,1117,1482,8773,2399,13771
13-05-2020,05 - 06,1161,1425,9070,2477,14133
13-05-2020,06 - 07,1170,1743,10011,2833,15757
13-05-2020,07 - 08,1127,1940,10820,3083,16970
13-05-2020,08 - 09,1118,1925,11079,3127,17249
13-05-2020,09 - 10,1021,1879,11145,3006,17051
13-05-2020,10 - 11,1001,1815,11065,2931,16812
13-05-2020,11 - 12,1032,1738,10955,2878,16603
13-05-2020,12 - 13,1044,1653,10894,2804,16395
13-05-2020,13 - 14,1020,1695,10703,2751,16169
13-05-2020,14 - 15,1087,1529,10408,2698,15722
13-05-2020,15 - 16,1064,1466,10168,2638,15336
13-05-2020,16 - 17,1099,1689,9992,2618,15398
13-05-2020,17 - 18,1060,1545,10022,2677,15304
13-05-2020,18 - 19,1033,1543,9774,2643,14993
13-05-2020,19 - 20,1097,1679,9768,2645,15189
13-05-2020,20 - 21,1106,1782,9790,2661,15339
13-05-2020,21 - 22,1114,1784,9858,2665,15421
13-05-2020,22 - 23,1105,1711,9620,2559,14995
13-05-2020,23 - 00,1012,1651,9146,2397,14206
14-05-2020,00 - 01,1044,1648,8951,2327,13970
14-05-2020,01 - 02,1066,1848,8915,2366,14195
14-05-2020,02 - 03,1137,1696,8817,2367,14017
14-05-2020,03 - 04,1120,1615,9024,2397,14156
14-05-2020,04 - 05,1091,1693,8916,2371,14071
14-05-2020,05 - 06,1113,1737,9105,2379,14334
14-05-2020,06 - 07,1076,1835,9713,2572,15196
14-05-2020,07 - 08,998,1937,10377,2831,16143
14-05-2020,08 - 09,951,1860,10317,2824,15952
14-05-2020,09 - 10,1041,1801,9997,2707,15546
14-05-2020,10 - 11,1089,1729,9750,2751,15319
14-05-2020,11 - 12,1052,1679,9824,2714,15269
14-05-2020,12 - 13,1018,1627,9972,2703,15320
14-05-2020,13 - 14,966,1464,9767,2681,14878
14-05-2020,14 - 15,950,1632,9425,2607,14614
14-05-2020,15 - 16,902,1671,9489,2547,14609
14-05-2020,16 - 17,988,1593,9532,2492,14605
14-05-2020,17 - 18,953,1743,9736,2502,14934
14-05-2020,18 - 19,969,1691,9642,2474,14776
14-05-2020,19 - 20,1016,1625,9666,2459,14766
14-05-2020,20 - 21,1034,1701,9476,2577,14788
14-05-2020,21 - 22,1257,1812,9345,2532,14946
14-05-2020,22 - 23,1077,1736,9024,2398,14235
14-05-2020,23 - 00,969,1637,8554,2164,13324
15-05-2020,00 - 01,936,1594,8208,2049,12787
15-05-2020,01 - 02,884,1507,8018,1975,12384
15-05-2020,02 - 03,848,1430,8044,1994,12316
15-05-2020,03 - 04,1004,1362,8103,2059,12528
15-05-2020,04 - 05,912,1407,8090,2106,12515
15-05-2020,05 - 06,937,1620,8335,2254,13146
15-05-2020,06 - 07,1071,1789,9109,2609,14578
15-05-2020,07 - 08,1090,1793,9897,2856,15636
15-05-2020,08 - 09,984,1706,9953,2937,15580
15-05-2020,09 - 10,918,1774,9778,2950,15420
15-05-2020,10 - 11,978,1704,9677,3006,15365
15-05-2020,11 - 12,964,1751,9583,2921,15219
15-05-2020,12 - 13,1147,1806,9479,2766,15198
15-05-2020,13 - 14,1062,1826,9222,2719,14829
15-05-2020,14 - 15,1053,1675,9084,2672,14484
15-05-2020,15 - 16,970,1600,9057,2668,14295
15-05-2020,16 - 17,894,1724,9003,2587,14208
15-05-2020,17 - 18,1021,1698,9140,2581,14440
15-05-2020,18 - 19,979,1584,9188,2586,14337
15-05-2020,19 - 20,1096,1598,8929,2518,14141
15-05-2020,20 - 21,1093,1706,8693,2483,13975
15-05-2020,21 - 22,1046,1669,8619,2445,13779
15-05-2020,22 - 23,1014,1655,8471,2301,13441
15-05-2020,23 - 00,1016,1484,8042,2134,12676
16-05-2020,00 - 01,993,1591,7668,2101,12353
16-05-2020,01 - 02,1030,1706,7585,2052,12373
16-05-2020,02 - 03,1046,1806,7592,1963,12407
16-05-2020,03 - 04,972,1659,7517,1939,12087
16-05-2020,04 - 05,917,1621,7319,1984,11841
16-05-2020,05 - 06,990,1556,7224,1971,11741
16-05-2020,06 - 07,1103,1593,7299,2047,12042
16-05-2020,07 - 08,1074,1662,7489,2124,12349
16-05-2020,08 - 09,1196,1566,7794,2253,12809
16-05-2020,09 - 10,1010,1771,8060,2367,13208
16-05-2020,10 - 11,1020,1754,8249,2521,13544
16-05-2020,11 - 12,1003,1591,8298,2576,13468
16-05-2020,12 - 13,1074,1583,8293,2569,13519
16-05-2020,13 - 14,1011,1596,8150,2506,13263
16-05-2020,14 - 15,1112,1522,8034,2527,13195
16-05-2020,15 - 16,1087,1530,7982,2519,13118
16-05-2020,16 - 17,1099,1666,8148,2510,13423
16-05-2020,17 - 18,1055,1855,8457,2492,13859
16-05-2020,18 - 19,1065,1837,8574,2551,14027
16-05-2020,19 - 20,1113,1771,8484,2507,13875
16-05-2020,20 - 21,1119,1818,8395,2492,13824
16-05-2020,21 - 22,1017,1845,8445,2504,13811
16-05-2020,22 - 23,1044,1784,8334,2452,13614
16-05-2020,23 - 00,1013,1829,8097,2310,13249
17-05-2020,00 - 01,1089,1794,7804,2152,12839
17-05-2020,01 - 02,978,1759,7635,2034,12406
17-05-2020,02 - 03,906,1723,7545,2022,12196
17-05-2020,03 - 04,963,1686,7533,2085,12267
17-05-2020,04 - 05,1017,1612,7317,2130,12076
17-05-2020,05 - 06,962,1612,7266,2160,12000
17-05-2020,06 - 07,925,1566,7407,2182,12080
17-05-2020,07 - 08,896,1526,7433,2228,12083
17-05-2020,08 - 09,1002,1547,7663,2294,12506
17-05-2020,09 - 10,965,1532,7896,2375,12768
17-05-2020,10 - 11,1051,1536,8249,2413,13249
17-05-2020,11 - 12,1035,1476,8252,2490,13253
17-05-2020,12 - 13,937,1504,8279,2468,13188
17-05-2020,13 - 14,936,1467,8225,2470,13098
17-05-2020,14 - 15,955,1474,8138,2466,13033
17-05-2020,15 - 16,977,1536,8241,2471,13225
17-05-2020,16 - 17,1021,1623,8402,2537,13583
17-05-2020,17 - 18,1048,1686,8639,2597,13970
17-05-2020,18 - 19,1113,1594,8839,2600,14146
17-05-2020,19 - 20,980,1699,8924,2596,14199
17-05-2020,20 - 21,1059,1699,8866,2564,14188
17-05-2020,21 - 22,1064,1749,8772,2538,14123
17-05-2020,22 - 23,995,1743,8638,2403,13779
17-05-2020,23 - 00,923,1687,8415,2285,13310
18-05-2020,00 - 01,973,1644,8216,2289,13122
18-05-2020,01 - 02,1014,1600,8037,2268,12919
18-05-2020,02 - 03,959,1579,8057,2294,12889
18-05-2020,03 - 04,978,1547,8049,2283,12857
18-05-2020,04 - 05,988,1557,8033,2238,12816
18-05-2020,05 - 06,1013,1547,8252,2323,13135
18-05-2020,06 - 07,1061,1728,9158,2695,14642
18-05-2020,07 - 08,1126,1844,9963,3013,15946
18-05-2020,08 - 09,1076,1749,10073,3076,15974
18-05-2020,09 - 10,1049,1820,9893,2980,15742
18-05-2020,10 - 11,990,1761,9772,2925,15448
18-05-2020,11 - 12,1034,1806,9751,2896,15487
18-05-2020,12 - 13,1025,1777,9720,2868,15390
18-05-2020,13 - 14,977,1567,9499,2802,14845
18-05-2020,14 - 15,1030,1593,9374,2734,14731
18-05-2020,15 - 16,1020,1755,9301,2711,14787
18-05-2020,16 - 17,1059,1791,9376,2703,14929
18-05-2020,17 - 18,1110,1735,9606,2738,15189
18-05-2020,18 - 19,1054,1451,9569,2730,14804
18-05-2020,19 - 20,975,1432,9448,2688,14543
18-05-2020,20 - 21,1064,1458,9337,2635,14494
18-05-2020,21 - 22,1070,1665,9118,2591,14444
18-05-2020,22 - 23,1057,1819,8786,2482,14144
18-05-2020,23 - 00,1076,1626,8292,2288,13282
19-05-2020,00 - 01,959,1508,8016,2172,12655
19-05-2020,01 - 02,929,1436,7944,2145,12454
19-05-2020,02 - 03,924,1403,7864,2069,12260
19-05-2020,03 - 04,939,1194,7817,2018,11968
19-05-2020,04 - 05,930,1382,7847,2044,12203
19-05-2020,05 - 06,1043,1501,8193,2136,12873
19-05-2020,06 - 07,1087,1689,8987,2461,14224
19-05-2020,07 - 08,1068,1686,9931,2807,15492
19-05-2020,08 - 09,1065,1612,10133,2954,15764
19-05-2020,09 - 10,1052,1705,9995,2954,15706
19-05-2020,10 - 11,1031,1589,9954,2961,15535
19-05-2020,11 - 12,959,1750,9836,2938,15483
19-05-2020,12 - 13,955,1648,9806,2742,15151
19-05-2020,13 - 14,994,1574,9552,2660,14780
19-05-2020,14 - 15,995,1466,9405,2615,14481
19-05-2020,15 - 16,955,1502,9220,2656,14333
19-05-2020,16 - 17,1206,1518,9198,2634,14556
19-05-2020,17 - 18,1308,1639,9396,2608,14951
19-05-2020,18 - 19,1101,1647,9216,2567,14531
19-05-2020,19 - 20,1115,1667,9250,2587,14619
19-05-2020,20 - 21,1126,1701,9240,2642,14709
19-05-2020,21 - 22,1215,1781,9144,2560,14700
19-05-2020,22 - 23,1130,1868,8774,2453,14225
19-05-2020,23 - 00,1080,1694,8338,2258,13370
20-05-2020,00 - 01,958,1584,7955,2177,12674
20-05-2020,01 - 02,995,1463,7774,2113,12345
20-05-2020,02 - 03,1041,1537,7714,2111,12403
20-05-2020,03 - 04,1041,1500,7924,2157,12622
20-05-2020,04 - 05,1066,1614,7925,2173,12778
20-05-2020,05 - 06,1097,1683,8204,2270,13254
20-05-2020,06 - 07,1169,1971,8950,2536,14626
20-05-2020,07 - 08,1101,2034,9796,2804,15735
20-05-2020,08 - 09,1016,1858,9890,2835,15599
20-05-2020,09 - 10,979,1699,9648,2735,15061
20-05-2020,10 - 11,997,1816,9642,2741,15196
20-05-2020,11 - 12,1000,1736,9519,2709,14964
20-05-2020,12 - 13,1008,1853,9434,2671,14966
20-05-2020,13 - 14,1099,1750,9325,2588,14762
20-05-2020,14 - 15,1100,1716,9105,2594,14515
20-05-2020,15 - 16,1031,1680,8890,2526,14127
20-05-2020,16 - 17,1094,1582,8807,2438,13921
20-05-2020,17 - 18,1129,1667,8896,2485,14177
20-05-2020,18 - 19,1127,1640,8903,2475,14145
20-05-2020,19 - 20,1133,1772,8817,2460,14182
20-05-2020,20 - 21,1241,1710,8838,2423,14212
20-05-2020,21 - 22,1095,1771,8746,2422,14034
20-05-2020,22 - 23,1128,1734,8633,2364,13859
20-05-2020,23 - 00,1006,1550,8205,2174,12935
21-05-2020,00 - 01,1004,1536,7900,2050,12490
21-05-2020,01 - 02,1013,1685,7805,2040,12543
21-05-2020,02 - 03,1019,1734,7772,2051,12576
21-05-2020,03 - 04,1026,1705,7828,2081,12640
21-05-2020,04 - 05,948,1746,7753,2059,12506
21-05-2020,05 - 06,1021,1629,7688,2047,12385
21-05-2020,06 - 07,1056,1614,7776,2048,12494
21-05-2020,07 - 08,986,1664,7870,2117,12637
21-05-2020,08 - 09,968,1727,8113,2166,12974
21-05-2020,09 - 10,1118,1664,8234,2200,13216
21-05-2020,10 - 11,1111,1588,8301,2200,13200
21-05-2020,11 - 12,1023,1607,8239,2176,13045
21-05-2020,12 - 13,1065,1545,8165,2141,12916
21-05-2020,13 - 14,1135,1523,8003,2120,12781
21-05-2020,14 - 15,953,1392,7757,2090,12192
21-05-2020,15 - 16,978,1357,7716,2082,12133
21-05-2020,16 - 17,1068,1391,7823,2091,12373
21-05-2020,17 - 18,857,1570,7986,2143,12556
21-05-2020,18 - 19,1065,1477,8054,2177,12773
21-05-2020,19 - 20,1101,1564,8053,2180,12898
21-05-2020,20 - 21,1078,1460,7984,2195,12717
21-05-2020,21 - 22,972,1497,7971,2167,12607
21-05-2020,22 - 23,942,1364,7850,2106,12262
21-05-2020,23 - 00,883,1288,7421,1995,11587
22-05-2020,00 - 01,916,1261,7134,1884,11195
22-05-2020,01 - 02,953,1093,6975,1806,10827
22-05-2020,02 - 03,941,1287,6889,1779,10896
22-05-2020,03 - 04,946,1301,6920,1765,10932
22-05-2020,04 - 05,918,1252,6834,1745,10749
22-05-2020,05 - 06,893,1188,6947,1829,10857
22-05-2020,06 - 07,1009,1257,7467,2017,11750
22-05-2020,07 - 08,1085,1480,7982,2208,12755
22-05-2020,08 - 09,1106,1463,8301,2355,13225
22-05-2020,09 - 10,1049,1592,8451,2395,13487
22-05-2020,10 - 11,1091,1389,8410,2337,13227
22-05-2020,11 - 12,1081,1316,8278,2270,12945
22-05-2020,12 - 13,1089,1460,8217,2269,13035
22-05-2020,13 - 14,1071,1453,8038,2262,12824
22-05-2020,14 - 15,953,1425,7912,2211,12501
22-05-2020,15 - 16,936,1421,7767,2177,12301
22-05-2020,16 - 17,934,1449,7746,2211,12340
22-05-2020,17 - 18,946,1368,7869,2306,12489
22-05-2020,18 - 19,915,1339,7885,2357,12496
22-05-2020,19 - 20,939,1512,7891,2383,12725
22-05-2020,20 - 21,1094,1533,7860,2406,12893
22-05-2020,21 - 22,1016,1376,7633,2452,12477
22-05-2020,22 - 23,876,1188,7522,2331,11917
22-05-2020,23 - 00,952,1269,7254,2111,11586
23-05-2020,00 - 01,1085,1360,7099,1980,11524
23-05-2020,01 - 02,1001,1413,6911,1962,11287
23-05-2020,02 - 03,861,1230,6837,1949,10877
23-05-2020,03 - 04,730,1145,6798,1926,10599
23-05-2020,04 - 05,759,1021,6743,1921,10444
23-05-2020,05 - 06,1028,1308,6660,1993,10989
23-05-2020,06 - 07,1047,1423,6861,2024,11355
23-05-2020,07 - 08,1079,1333,7212,2108,11732
23-05-2020,08 - 09,1009,1350,7632,2257,12248
23-05-2020,09 - 10,1001,1184,8090,2373,12648
23-05-2020,10 - 11,1007,1285,8388,2427,13107
23-05-2020,11 - 12,949,1467,8540,2461,13417
23-05-2020,12 - 13,930,1498,8589,2456,13473
23-05-2020,13 - 14,915,1517,8539,2467,13438
23-05-2020,14 - 15,928,1558,8402,2332,13220
23-05-2020,15 - 16,843,1536,8422,2190,12991
23-05-2020,16 - 17,936,1517,8547,2201,13201
23-05-2020,17 - 18,907,1736,8576,2171,13390
23-05-2020,18 - 19,995,1530,8629,2150,13304
23-05-2020,19 - 20,1114,1659,8541,2123,13437
23-05-2020,20 - 21,1232,1690,8357,2068,13347
23-05-2020,21 - 22,1239,1624,8223,2078,13164
23-05-2020,22 - 23,1028,1612,8099,2108,12847
23-05-2020,23 - 00,819,1436,7661,2012,11928
24-05-2020,00 - 01,609,1470,7327,1919,11325
24-05-2020,01 - 02,724,1391,7088,1855,11058
24-05-2020,02 - 03,874,1324,6870,1818,10886
24-05-2020,03 - 04,888,1302,6721,1796,10707
24-05-2020,04 - 05,983,1373,6619,1790,10765
24-05-2020,05 - 06,1050,1242,6553,1755,10600
24-05-2020,06 - 07,1048,1227,6722,1827,10824
24-05-2020,07 - 08,995,1400,6938,1960,11293
24-05-2020,08 - 09,859,1405,7236,2057,11557
24-05-2020,09 - 10,926,1501,7535,2095,12057
24-05-2020,10 - 11,904,1690,7816,2152,12562
24-05-2020,11 - 12,909,1726,7893,2236,12764
24-05-2020,12 - 13,1008,1814,7892,2265,12979
24-05-2020,13 - 14,1114,1636,7842,2221,12813
24-05-2020,14 - 15,929,1588,7749,2187,12453
24-05-2020,15 - 16,891,1568,7713,2143,12315
24-05-2020,16 - 17,1116,1737,7982,2129,12964
24-05-2020,17 - 18,1077,1676,8162,2252,13167
24-05-2020,18 - 19,941,1652,8285,2357,13235
24-05-2020,19 - 20,1055,1680,8311,2367,13413
24-05-2020,20 - 21,1036,1788,8203,2308,13335
24-05-2020,21 - 22,1015,1764,7930,2236,12945
24-05-2020,22 - 23,942,1579,7819,2256,12596
24-05-2020,23 - 00,963,1510,7413,2080,11966
25-05-2020,00 - 01,909,1516,7106,2020,11551
25-05-2020,01 - 02,888,1427,7033,1939,11287
25-05-2020,02 - 03,923,1523,7004,1888,11338
25-05-2020,03 - 04,848,1401,7100,1889,11238
25-05-2020,04 - 05,836,1401,6972,1906,11115
25-05-2020,05 - 06,908,1443,7179,1993,11523
25-05-2020,06 - 07,1053,1719,8172,2347,13291
25-05-2020,07 - 08,1005,1727,9220,2689,14641
25-05-2020,08 - 09,1035,1724,9401,2799,14959
25-05-2020,09 - 10,1065,1767,9339,2789,14960
25-05-2020,10 - 11,1107,1775,9250,2779,14911
25-05-2020,11 - 12,1024,1767,9285,2774,14850
25-05-2020,12 - 13,1028,1708,9270,2719,14725
25-05-2020,13 - 14,1115,1634,9151,2677,14577
25-05-2020,14 - 15,944,1587,8985,2619,14135
25-05-2020,15 - 16,973,1755,8968,2614,14310
25-05-2020,16 - 17,1098,1637,8891,2555,14181
25-05-2020,17 - 18,1049,1616,8904,2558,14127
25-05-2020,18 - 19,988,1690,8698,2539,13915
25-05-2020,19 - 20,978,1681,8563,2504,13726
25-05-2020,20 - 21,964,1587,8448,2443,13442
25-05-2020,21 - 22,888,1577,8254,2362,13081
25-05-2020,22 - 23,825,1563,8134,2294,12816
25-05-2020,23 - 00,1067,1527,7654,2139,12387
26-05-2020,00 - 01,988,1495,7378,2059,11920
26-05-2020,01 - 02,882,1482,7208,1991,11563
26-05-2020,02 - 03,925,1462,7191,1981,11559
26-05-2020,03 - 04,883,1347,7140,1996,11366
26-05-2020,04 - 05,843,1188,7079,2015,11125
26-05-2020,05 - 06,837,1224,7368,2075,11504
26-05-2020,06 - 07,911,1448,8062,2344,12765
26-05-2020,07 - 08,972,1782,8743,2551,14048
26-05-2020,08 - 09,985,1632,8929,2624,14170
26-05-2020,09 - 10,996,1586,8839,2659,14080
26-05-2020,10 - 11,914,1445,8843,2655,13857
26-05-2020,11 - 12,858,1527,8948,2635,13968
26-05-2020,12 - 13,1156,1605,8977,2604,14342
26-05-2020,13 - 14,1063,1474,8832,2572,13941
26-05-2020,14 - 15,1126,1563,8616,2536,13841
26-05-2020,15 - 16,1083,1470,8502,2461,13516
26-05-2020,16 - 17,1030,1557,8405,2386,13378
26-05-2020,17 - 18,1146,1625,8418,2385,13574
26-05-2020,18 - 19,1055,1570,8335,2357,13317
26-05-2020,19 - 20,1141,1518,8217,2349,13225
26-05-2020,20 - 21,1125,1629,8153,2294,13201
26-05-2020,21 - 22,966,1648,7994,2189,12797
26-05-2020,22 - 23,994,1511,7790,2115,12410
26-05-2020,23 - 00,1027,1545,7204,1936,11712
27-05-2020,00 - 01,795,1420,6834,1865,10914
27-05-2020,01 - 02,934,1325,6658,1803,10720
27-05-2020,02 - 03,1124,1267,6720,1804,10915
27-05-2020,03 - 04,942,1184,6720,1849,10695
27-05-2020,04 - 05,812,987,6592,1871,10262
27-05-2020,05 - 06,890,1046,6820,1960,10716
27-05-2020,06 - 07,907,1427,7869,2201,12404
27-05-2020,07 - 08,1036,1503,8782,2538,13859
27-05-2020,08 - 09,976,1473,9068,2693,14210
27-05-2020,09 - 10,1024,1617,9093,2589,14323
27-05-2020,10 - 11,1010,1724,9217,2606,14557
27-05-2020,11 - 12,938,1642,9161,2658,14399
27-05-2020,12 - 13,986,1520,9139,2587,14232
27-05-2020,13 - 14,952,1409,8988,2531,13880
27-05-2020,14 - 15,989,1533,8816,2461,13799
27-05-2020,15 - 16,950,1453,8880,2450,13733
27-05-2020,16 - 17,900,1395,8863,2400,13558
27-05-2020,17 - 18,974,1414,8985,2357,13730
27-05-2020,18 - 19,998,1343,8835,2350,13526
27-05-2020,19 - 20,877,1344,8586,2345,13152
27-05-2020,20 - 21,840,1354,8520,2263,12977
27-05-2020,21 - 22,1042,1517,8259,2291,13109
27-05-2020,22 - 23,940,1400,8030,2217,12587
27-05-2020,23 - 00,861,1438,7628,2021,11948
28-05-2020,00 - 01,778,1321,7298,1879,11276
28-05-2020,01 - 02,750,1330,7122,1885,11087
28-05-2020,02 - 03,790,1356,7082,1869,11097
28-05-2020,03 - 04,815,1338,7101,1942,11196
28-05-2020,04 - 05,854,1353,7046,1964,11217
28-05-2020,05 - 06,1052,1537,7301,2001,11891
28-05-2020,06 - 07,1023,1848,8171,2261,13303
28-05-2020,07 - 08,1030,1857,9045,2566,14498
28-05-2020,08 - 09,895,1766,9077,2573,14311
28-05-2020,09 - 10,807,1721,9006,2548,14082
28-05-2020,10 - 11,901,1739,9057,2585,14282
28-05-2020,11 - 12,912,1737,9096,2598,14343
28-05-2020,12 - 13,945,1739,9087,2556,14327
28-05-2020,13 - 14,901,1728,8988,2518,14135
28-05-2020,14 - 15,1038,1728,8887,2482,14135
28-05-2020,15 - 16,1036,1726,8860,2459,14081
28-05-2020,16 - 17,1011,1724,8833,2376,13944
28-05-2020,17 - 18,946,1697,8972,2392,14007
28-05-2020,18 - 19,1123,1682,8716,2389,13910
28-05-2020,19 - 20,1116,1695,8557,2348,13716
28-05-2020,20 - 21,934,1699,8371,2289,13293
28-05-2020,21 - 22,991,1559,8140,2170,12860
28-05-2020,22 - 23,994,1458,8074,2117,12643
28-05-2020,23 - 00,885,1389,7622,1988,11884
29-05-2020,00 - 01,987,1273,7294,1881,11435
29-05-2020,01 - 02,945,1445,7147,1829,11366
29-05-2020,02 - 03,940,1387,7111,1824,11262
29-05-2020,03 - 04,953,1292,7108,1835,11188
29-05-2020,04 - 05,895,1285,7020,1805,11005
29-05-2020,05 - 06,620,1454,7274,1883,11231
29-05-2020,06 - 07,824,1641,8118,2143,12726
29-05-2020,07 - 08,990,1789,8850,2477,14106
29-05-2020,08 - 09,1086,1783,8986,2553,14408
29-05-2020,09 - 10,1202,1637,8964,2503,14306
29-05-2020,10 - 11,1051,1682,9005,2504,14242
29-05-2020,11 - 12,984,1641,8982,2456,14063
29-05-2020,12 - 13,865,1693,8908,2405,13871
29-05-2020,13 - 14,791,1773,8716,2370,13650
29-05-2020,14 - 15,935,1624,8507,2331,13397
29-05-2020,15 - 16,1016,1588,8356,2262,13222
29-05-2020,16 - 17,1044,1481,8283,2289,13097
29-05-2020,17 - 18,1019,1719,8328,2329,13395
29-05-2020,18 - 19,948,1666,8164,2302,13080
29-05-2020,19 - 20,889,1318,7954,2231,12392
29-05-2020,20 - 21,929,1469,7757,2129,12284
29-05-2020,21 - 22,980,1533,7494,2057,12064
29-05-2020,22 - 23,932,1444,7489,2064,11929
29-05-2020,23 - 00,932,1423,7201,1951,11507
30-05-2020,00 - 01,515,1085,6730,1870,10200
30-05-2020,01 - 02,758,1201,6446,1851,10256
30-05-2020,02 - 03,630,1168,6284,1816,9898
30-05-2020,03 - 04,657,1193,6251,1838,9939
30-05-2020,04 - 05,813,1357,6050,1818,10038
30-05-2020,05 - 06,1120,1413,6032,1777,10342
30-05-2020,06 - 07,1101,1578,6290,1805,10774
30-05-2020,07 - 08,1019,1555,6673,1958,11205
30-05-2020,08 - 09,1026,1697,7129,2098,11950
30-05-2020,09 - 10,1062,1712,7481,2120,12375
30-05-2020,10 - 11,1002,1700,7588,2145,12435
30-05-2020,11 - 12,991,1579,7516,2156,12242
30-05-2020,12 - 13,955,1535,7315,2110,11915
30-05-2020,13 - 14,975,1551,6994,2119,11639
30-05-2020,14 - 15,923,1438,6916,2069,11346
30-05-2020,15 - 16,862,1536,7117,2002,11517
30-05-2020,16 - 17,988,1494,7114,2038,11634
30-05-2020,17 - 18,905,1508,7226,2088,11727
30-05-2020,18 - 19,942,1559,7343,2143,11987
30-05-2020,19 - 20,997,1535,7307,2130,11969
30-05-2020,20 - 21,987,1550,7291,2098,11926
30-05-2020,21 - 22,877,1449,7200,2104,11630
30-05-2020,22 - 23,809,1301,7100,2061,11271
30-05-2020,23 - 00,966,1294,6795,1872,10927
31-05-2020,00 - 01,827,1207,6377,1773,10184
31-05-2020,01 - 02,869,1503,6082,1710,10164
31-05-2020,02 - 03,827,1382,5993,1697,9899
31-05-2020,03 - 04,795,1323,5877,1673,9668
31-05-2020,04 - 05,802,1297,5670,1571,9340
31-05-2020,05 - 06,855,1385,5795,1577,9612
31-05-2020,06 - 07,869,1411,5976,1700,9956
31-05-2020,07 - 08,931,1438,6261,1834,10464
31-05-2020,08 - 09,847,1411,6638,1952,10848
31-05-2020,09 - 10,935,1425,6956,2010,11326
31-05-2020,10 - 11,936,1505,7134,1907,11482
31-05-2020,11 - 12,896,1520,7157,1853,11426
31-05-2020,12 - 13,959,1421,7024,1916,11320
31-05-2020,13 - 14,970,1435,6969,1954,11328
31-05-2020,14 - 15,973,1422,6968,1949,11312
31-05-2020,15 - 16,961,1424,6969,1933,11287
31-05-2020,16 - 17,825,1409,6977,1949,11160
31-05-2020,17 - 18,905,1379,7168,2000,11452
31-05-2020,18 - 19,943,1460,7338,2095,11836
31-05-2020,19 - 20,999,1597,7472,2160,12228
31-05-2020,20 - 21,1068,1664,7450,2196,12378
31-05-2020,21 - 22,1016,1598,7755,2106,12475
31-05-2020,22 - 23,853,1527,7654,2023,12057
31-05-2020,23 - 00,780,1491,7228,1930,11429
01-06-2020,00 - 01,627,1409,6432,1815,10283
01-06-2020,01 - 02,887,1323,6341,1772,10323
01-06-2020,02 - 03,916,1354,6443,1773,10486
01-06-2020,03 - 04,747,1251,6419,1808,10225
01-06-2020,04 - 05,735,1286,6374,1793,10188
01-06-2020,05 - 06,829,1299,6658,1867,10653
01-06-2020,06 - 07,1051,1707,7580,2193,12531
01-06-2020,07 - 08,699,1734,8605,2546,13584
01-06-2020,08 - 09,984,1713,9250,2689,14636
01-06-2020,09 - 10,970,1711,9252,2696,14629
01-06-2020,10 - 11,951,1637,9416,2679,14683
01-06-2020,11 - 12,1018,1772,9490,2670,14950
01-06-2020,12 - 13,1038,1780,9123,2616,14557
01-06-2020,13 - 14,1082,1789,8956,2595,14422
01-06-2020,14 - 15,1028,1823,8888,2545,14284
01-06-2020,15 - 16,933,1694,8977,2510,14114
01-06-2020,16 - 17,1015,1744,8883,2482,14124
01-06-2020,17 - 18,1003,1624,8889,2513,14029
01-06-2020,18 - 19,977,1441,8760,2500,13678
01-06-2020,19 - 20,1073,1469,8641,2480,13663
01-06-2020,20 - 21,884,1545,8555,2406,13390
01-06-2020,21 - 22,807,1634,8287,2280,13008
01-06-2020,22 - 23,816,1580,7942,2258,12596
01-06-2020,23 - 00,798,1521,7187,2078,11584
02-06-2020,00 - 01,669,1272,6806,1878,10625
02-06-2020,01 - 02,699,1329,6754,1730,10512
02-06-2020,02 - 03,821,1354,6783,1738,10696
02-06-2020,03 - 04,899,1281,6688,1817,10685
02-06-2020,04 - 05,983,1214,6578,1766,10541
02-06-2020,05 - 06,1071,1353,6846,1818,11088
02-06-2020,06 - 07,1046,1502,7646,2103,12297
02-06-2020,07 - 08,1055,1750,8537,2447,13789
02-06-2020,08 - 09,963,2028,8921,2611,14523
02-06-2020,09 - 10,1052,1871,9029,2636,14588
02-06-2020,10 - 11,1058,1823,9121,2699,14701
02-06-2020,11 - 12,974,1808,9251,2688,14721
02-06-2020,12 - 13,1136,1731,9141,2654,14662
02-06-2020,13 - 14,1091,1799,9064,2548,14502
02-06-2020,14 - 15,1054,1806,8891,2459,14210
02-06-2020,15 - 16,1037,1704,8773,2463,13977
02-06-2020,16 - 17,1162,1517,8680,2491,13850
02-06-2020,17 - 18,1029,1480,8888,2518,13915
02-06-2020,18 - 19,1061,1199,8889,2505,13654
02-06-2020,19 - 20,1027,1322,8858,2504,13711
02-06-2020,20 - 21,997,1653,8596,2435,13681
02-06-2020,21 - 22,1002,1744,8328,2301,13375
02-06-2020,22 - 23,1009,1905,8087,2241,13242
02-06-2020,23 - 00,784,1718,7758,2059,12319
03-06-2020,00 - 01,681,1729,7343,1941,11694
03-06-2020,01 - 02,800,1563,7210,1923,11496
03-06-2020,02 - 03,837,1395,7145,1934,11311
03-06-2020,03 - 04,801,1383,7086,1965,11235
03-06-2020,04 - 05,795,1438,6943,1915,11091
03-06-2020,05 - 06,935,1408,7156,2046,11545
03-06-2020,06 - 07,779,1478,7943,2287,12487
03-06-2020,07 - 08,1066,1699,8911,2569,14245
03-06-2020,08 - 09,1078,1769,9265,2640,14752
03-06-2020,09 - 10,1020,1783,9310,2633,14746
03-06-2020,10 - 11,1015,1879,9331,2621,14846
03-06-2020,11 - 12,1086,1675,9220,2655,14636
03-06-2020,12 - 13,990,1667,9088,2616,14361
03-06-2020,13 - 14,1178,1894,9207,2628,14907
03-06-2020,14 - 15,1028,1877,9012,2577,14494
03-06-2020,15 - 16,1192,1700,9042,2539,14473
03-06-2020,16 - 17,1068,1606,8952,2471,14097
03-06-2020,17 - 18,964,1825,8973,2483,14245
03-06-2020,18 - 19,1156,1737,8927,2408,14228
03-06-2020,19 - 20,1010,1837,8817,2344,14008
03-06-2020,20 - 21,979,1713,8576,2302,13570
03-06-2020,21 - 22,1055,1666,8219,2223,13163
03-06-2020,22 - 23,1005,1629,7974,2182,12790
03-06-2020,23 - 00,939,1472,7613,2036,12060
04-06-2020,00 - 01,920,1387,7208,1984,11499
04-06-2020,01 - 02,887,1243,7024,1943,11097
04-06-2020,02 - 03,911,1077,7068,1896,10952
04-06-2020,03 - 04,774,1100,7032,1888,10794
04-06-2020,04 - 05,842,1231,7025,1829,10927
04-06-2020,05 - 06,836,1338,7325,1899,11398
04-06-2020,06 - 07,877,1519,8229,2214,12839
04-06-2020,07 - 08,989,1904,9037,2500,14430
04-06-2020,08 - 09,1044,1758,9212,2536,14550
04-06-2020,09 - 10,1025,1636,9225,2521,14407
04-06-2020,10 - 11,1085,1441,9307,2591,14424
04-06-2020,11 - 12,1026,1568,9309,2616,14519
04-06-2020,12 - 13,957,1360,9387,2573,14277
04-06-2020,13 - 14,1037,1443,9235,2561,14276
04-06-2020,14 - 15,943,1495,9161,2529,14128
04-06-2020,15 - 16,801,1601,9151,2504,14057
04-06-2020,16 - 17,865,1358,9041,2448,13712
04-06-2020,17 - 18,1177,1407,9155,2530,14269
04-06-2020,18 - 19,919,1426,9264,2534,14143
04-06-2020,19 - 20,1087,1480,9042,2514,14123
04-06-2020,20 - 21,1062,1580,8574,2440,13656
04-06-2020,21 - 22,1052,1414,8360,2345,13171
04-06-2020,22 - 23,954,1955,8176,2311,13396
04-06-2020,23 - 00,883,1795,7687,2103,12468
05-06-2020,00 - 01,897,1286,7299,2063,11545
05-06-2020,01 - 02,853,1146,7018,2041,11058
05-06-2020,02 - 03,816,805,6911,2069,10601
05-06-2020,03 - 04,756,1172,6837,2074,10839
05-06-2020,04 - 05,786,1289,6731,2054,10860
05-06-2020,05 - 06,822,1373,7018,2135,11348
05-06-2020,06 - 07,1033,1367,7825,2337,12562
05-06-2020,07 - 08,923,1533,8779,2678,13913
05-06-2020,08 - 09,1186,1664,9214,2754,14818
05-06-2020,09 - 10,902,1610,9457,2752,14721
05-06-2020,10 - 11,896,1632,9525,2728,14781
05-06-2020,11 - 12,1019,1443,9596,2753,14811
05-06-2020,12 - 13,996,1280,9448,2728,14452
05-06-2020,13 - 14,940,1411,9185,2660,14196
05-06-2020,14 - 15,937,1164,9034,2541,13676
05-06-2020,15 - 16,1056,1087,8941,2480,13564
05-06-2020,16 - 17,1126,1241,8779,2359,13505
05-06-2020,17 - 18,885,1243,8844,2340,13312
05-06-2020,18 - 19,910,1482,8816,2295,13503
05-06-2020,19 - 20,994,1314,8478,2200,12986
05-06-2020,20 - 21,930,1297,8136,2106,12469
05-06-2020,21 - 22,875,1313,7880,2026,12094
05-06-2020,22 - 23,894,1250,7834,2032,12010
05-06-2020,23 - 00,976,1408,7474,1905,11763
06-06-2020,00 - 01,805,1481,7261,1809,11356
06-06-2020,01 - 02,952,1388,6963,1724,11027
06-06-2020,02 - 03,855,1403,6724,1721,10703
06-06-2020,03 - 04,832,1429,6574,1677,10512
06-06-2020,04 - 05,874,1379,6430,1788,10471
06-06-2020,05 - 06,847,1309,6441,1854,10451
06-06-2020,06 - 07,914,1218,6539,1869,10540
06-06-2020,07 - 08,1048,1165,6847,1966,11026
06-06-2020,08 - 09,987,1201,7233,2107,11528
06-06-2020,09 - 10,967,1241,7701,2210,12119
06-06-2020,10 - 11,946,1621,7939,2333,12839
06-06-2020,11 - 12,1004,1402,8149,2410,12965
06-06-2020,12 - 13,1027,1222,8049,2303,12601
06-06-2020,13 - 14,996,1254,8148,2265,12663
06-06-2020,14 - 15,994,1502,8006,2284,12786
06-06-2020,15 - 16,955,1465,8009,2224,12653
06-06-2020,16 - 17,878,1567,8000,2258,12703
06-06-2020,17 - 18,866,1711,8232,2415,13224
06-06-2020,18 - 19,1012,1635,8148,2348,13143
06-06-2020,19 - 20,970,1642,7959,2324,12895
06-06-2020,20 - 21,899,1616,7800,2256,12571
06-06-2020,21 - 22,1038,1460,7588,2158,12244
06-06-2020,22 - 23,924,1571,7559,2092,12146
06-06-2020,23 - 00,626,1449,7291,1981,11347
07-06-2020,00 - 01,881,1347,7048,1861,11137
07-06-2020,01 - 02,870,1265,6857,1786,10778
07-06-2020,02 - 03,853,1041,6752,1724,10370
07-06-2020,03 - 04,736,1099,6672,1770,10277
07-06-2020,04 - 05,652,1067,6546,1778,10043
07-06-2020,05 - 06,911,1102,6567,1804,10384
07-06-2020,06 - 07,978,1310,6814,1856,10958
07-06-2020,07 - 08,909,1349,7035,1900,11193
07-06-2020,08 - 09,768,1502,7250,2013,11533
07-06-2020,09 - 10,991,1480,7604,2160,12235
07-06-2020,10 - 11,1081,1456,8018,2226,12781
07-06-2020,11 - 12,641,1473,8265,2251,12630
07-06-2020,12 - 13,522,1426,8309,2166,12423
07-06-2020,13 - 14,806,1366,8366,2097,12635
07-06-2020,14 - 15,909,1275,8134,2082,12400
07-06-2020,15 - 16,1041,1368,8082,2058,12549
07-06-2020,16 - 17,985,1483,8043,2110,12621
07-06-2020,17 - 18,1014,1358,8228,2240,12840
07-06-2020,18 - 19,1032,1385,8075,2289,12781
07-06-2020,19 - 20,1007,1581,8010,2262,12860
07-06-2020,20 - 21,1087,1648,7866,2200,12801
07-06-2020,21 - 22,918,1453,7645,2132,12148
07-06-2020,22 - 23,861,1410,7620,2139,12030
07-06-2020,23 - 00,846,1337,7241,2045,11469
08-06-2020,00 - 01,786,1208,7009,1942,10945
08-06-2020,01 - 02,811,1236,6928,1905,10880
08-06-2020,02 - 03,838,1134,6947,1878,10797
08-06-2020,03 - 04,982,1193,6878,1899,10952
08-06-2020,04 - 05,1059,1332,6905,1892,11188
08-06-2020,05 - 06,827,1374,7239,2018,11458
08-06-2020,06 - 07,833,1543,8025,2268,12669
08-06-2020,07 - 08,967,1620,8823,2541,13951
08-06-2020,08 - 09,1027,1661,9153,2630,14471
08-06-2020,09 - 10,925,2178,9283,2630,15016
08-06-2020,10 - 11,968,1755,9305,2653,14681
08-06-2020,11 - 12,1038,1362,9405,2668,14473
08-06-2020,12 - 13,1160,1597,9480,2648,14885
08-06-2020,13 - 14,1066,1575,9359,2645,14645
08-06-2020,14 - 15,878,1588,9259,2575,14300
08-06-2020,15 - 16,966,1543,9099,2528,14136
08-06-2020,16 - 17,969,1723,9008,2444,14144
08-06-2020,17 - 18,896,1670,9201,2455,14222
08-06-2020,18 - 19,946,1582,8921,2432,13881
08-06-2020,19 - 20,991,1636,8558,2377,13562
08-06-2020,20 - 21,987,1650,8289,2325,13251
08-06-2020,21 - 22,964,1585,8288,2247,13084
08-06-2020,22 - 23,991,1556,8166,2194,12907
08-06-2020,23 - 00,854,1251,7702,2080,11887
09-06-2020,00 - 01,758,1240,7403,1950,11351
09-06-2020,01 - 02,810,1307,7277,1928,11322
09-06-2020,02 - 03,990,1279,7192,1915,11376
09-06-2020,03 - 04,954,1349,6992,1922,11217
09-06-2020,04 - 05,842,1258,6996,1908,11004
09-06-2020,05 - 06,879,1372,7294,2031,11576
09-06-2020,06 - 07,938,1604,8053,2298,12893
09-06-2020,07 - 08,924,1632,8801,2562,13919
09-06-2020,08 - 09,997,1617,9141,2623,14378
09-06-2020,09 - 10,961,1610,9249,2606,14426
09-06-2020,10 - 11,946,1801,9269,2665,14681
09-06-2020,11 - 12,892,1743,9461,2641,14737
09-06-2020,12 - 13,1002,1727,9457,2630,14816
09-06-2020,13 - 14,953,1765,9394,2610,14722
09-06-2020,14 - 15,932,1633,9290,2594,14449
09-06-2020,15 - 16,942,1645,9189,2567,14343
09-06-2020,16 - 17,923,1674,9152,2503,14252
09-06-2020,17 - 18,946,1600,9161,2506,14213
09-06-2020,18 - 19,982,1628,8905,2447,13962
09-06-2020,19 - 20,952,1633,8752,2426,13763
09-06-2020,20 - 21,961,1651,8751,2334,13697
09-06-2020,21 - 22,949,1661,8456,2277,13343
09-06-2020,22 - 23,903,1477,8209,2222,12811
09-06-2020,23 - 00,874,1339,7872,2090,12175
10-06-2020,00 - 01,821,1371,7435,1985,11612
10-06-2020,01 - 02,859,1276,7208,1936,11279
10-06-2020,02 - 03,852,1273,7117,1889,11131
10-06-2020,03 - 04,805,1229,6988,1861,10883
10-06-2020,04 - 05,811,1294,6874,1804,10783
10-06-2020,05 - 06,901,1385,6970,1884,11140
10-06-2020,06 - 07,936,1668,7963,2177,12744
10-06-2020,07 - 08,1257,1704,8890,2500,14351
10-06-2020,08 - 09,1089,1774,9136,2586,14585
10-06-2020,09 - 10,965,1821,9206,2603,14595
10-06-2020,10 - 11,995,1818,9279,2591,14683
10-06-2020,11 - 12,1028,1689,9347,2622,14686
10-06-2020,12 - 13,1037,1601,9407,2643,14688
10-06-2020,13 - 14,1015,1645,9335,2631,14626
10-06-2020,14 - 15,990,1686,9135,2572,14383
10-06-2020,15 - 16,1010,1661,9138,2582,14391
10-06-2020,16 - 17,1055,1544,8988,2539,14126
10-06-2020,17 - 18,1013,1515,9081,2542,14151
10-06-2020,18 - 19,970,1466,8976,2506,13918
10-06-2020,19 - 20,894,1669,8822,2464,13849
10-06-2020,20 - 21,910,1490,8737,2413,13550
10-06-2020,21 - 22,884,1449,8462,2304,13099
10-06-2020,22 - 23,766,1505,8156,2230,12657
10-06-2020,23 - 00,705,1400,7774,2112,11991
11-06-2020,00 - 01,777,1331,7253,1957,11318
11-06-2020,01 - 02,850,1437,7011,1893,11191
11-06-2020,02 - 03,744,1403,6874,1771,10792
11-06-2020,03 - 04,787,1391,6758,1754,10690
11-06-2020,04 - 05,895,1369,6742,1774,10780
11-06-2020,05 - 06,1001,1333,7048,1871,11253
11-06-2020,06 - 07,1035,1429,7928,2232,12624
11-06-2020,07 - 08,965,1844,8887,2627,14323
11-06-2020,08 - 09,973,1820,9155,2827,14775
11-06-2020,09 - 10,1008,1681,9121,2811,14621
11-06-2020,10 - 11,1004,1560,9033,2744,14341
11-06-2020,11 - 12,961,1499,9022,2663,14145
11-06-2020,12 - 13,989,1535,9054,2569,14147
11-06-2020,13 - 14,929,1618,9083,2680,14310
11-06-2020,14 - 15,968,1583,9058,2787,14396
11-06-2020,15 - 16,1002,1525,9050,2725,14302
11-06-2020,16 - 17,985,1494,9017,2654,14150
11-06-2020,17 - 18,981,1580,9163,2616,14340
11-06-2020,18 - 19,1017,1539,8909,2546,14011
11-06-2020,19 - 20,736,1553,8815,2550,13654
11-06-2020,20 - 21,894,1492,8659,2540,13585
11-06-2020,21 - 22,887,1573,8342,2400,13202
11-06-2020,22 - 23,849,1435,8040,2249,12573
11-06-2020,23 - 00,789,1375,7611,2070,11845
12-06-2020,00 - 01,775,1387,7151,2003,11316
12-06-2020,01 - 02,806,1252,6808,1959,10825
12-06-2020,02 - 03,822,1174,6637,1944,10577
12-06-2020,03 - 04,785,1189,6600,1949,10523
12-06-2020,04 - 05,857,1357,6510,1907,10631
12-06-2020,05 - 06,853,1375,6783,1991,11002
12-06-2020,06 - 07,940,1622,7673,2304,12539
12-06-2020,07 - 08,1098,2003,8556,2570,14227
12-06-2020,08 - 09,984,1866,8927,2639,14416
12-06-2020,09 - 10,940,1711,8924,2601,14176
12-06-2020,10 - 11,921,1606,8759,2661,13947
12-06-2020,11 - 12,966,1633,8722,2720,14041
12-06-2020,12 - 13,1080,1584,8765,2648,14077
12-06-2020,13 - 14,1017,1557,8725,2624,13923
12-06-2020,14 - 15,976,1487,8498,2548,13509
12-06-2020,15 - 16,932,1417,8278,2468,13095
12-06-2020,16 - 17,929,1445,8213,2416,13003
12-06-2020,17 - 18,925,1447,8279,2428,13079
12-06-2020,18 - 19,941,1449,8167,2369,12926
12-06-2020,19 - 20,911,1432,7905,2228,12476
12-06-2020,20 - 21,991,1545,7762,2139,12437
12-06-2020,21 - 22,977,1567,7547,2160,12251
12-06-2020,22 - 23,940,1461,7321,2187,11909
12-06-2020,23 - 00,892,1321,7032,2109,11354
13-06-2020,00 - 01,795,1256,6705,1987,10743
13-06-2020,01 - 02,806,1232,6464,1878,10380
13-06-2020,02 - 03,755,1287,6299,1857,10198
13-06-2020,03 - 04,772,1354,6048,1862,10036
13-06-2020,04 - 05,774,1345,5907,1784,9810
13-06-2020,05 - 06,737,1352,5982,1823,9894
13-06-2020,06 - 07,816,1419,6227,1957,10419
13-06-2020,07 - 08,845,1499,6606,2090,11040
13-06-2020,08 - 09,776,1528,7000,2247,11551
13-06-2020,09 - 10,785,1531,7331,2334,11981
13-06-2020,10 - 11,845,1482,7458,2270,12055
13-06-2020,11 - 12,897,1502,7510,2298,12207
13-06-2020,12 - 13,880,1464,7513,2289,12146
13-06-2020,13 - 14,869,1420,7448,2161,11898
13-06-2020,14 - 15,829,1380,7370,2057,11636
13-06-2020,15 - 16,843,1372,7257,2026,11498
13-06-2020,16 - 17,841,1432,7255,2047,11575
13-06-2020,17 - 18,941,1464,7283,2129,11817
13-06-2020,18 - 19,945,1530,7290,2191,11956
13-06-2020,19 - 20,927,1499,7194,2153,11773
13-06-2020,20 - 21,837,1557,7217,2144,11755
13-06-2020,21 - 22,798,1492,7008,2091,11389
13-06-2020,22 - 23,659,1353,6958,2092,11062
13-06-2020,23 - 00,707,1388,6824,2085,11004
14-06-2020,00 - 01,940,1409,6585,1993,10927
14-06-2020,01 - 02,942,1295,6278,1838,10353
14-06-2020,02 - 03,930,1248,6163,1803,10144
14-06-2020,03 - 04,973,1153,6008,1741,9875
14-06-2020,04 - 05,956,1191,5933,1734,9814
14-06-2020,05 - 06,788,1431,5824,1798,9841
14-06-2020,06 - 07,761,1501,6010,1891,10163
14-06-2020,07 - 08,824,1711,6422,1933,10890
14-06-2020,08 - 09,866,1803,6798,2080,11547
14-06-2020,09 - 10,789,1710,7070,2056,11625
14-06-2020,10 - 11,808,1446,7169,1881,11304
14-06-2020,11 - 12,885,1347,7307,1923,11462
14-06-2020,12 - 13,963,1425,7533,2019,11940
14-06-2020,13 - 14,957,1424,7539,2061,11981
14-06-2020,14 - 15,926,1499,7412,2014,11851
14-06-2020,15 - 16,911,1477,7352,2004,11744
14-06-2020,16 - 17,942,1420,7327,2032,11721
14-06-2020,17 - 18,986,1425,7592,2128,12131
14-06-2020,18 - 19,933,1522,7711,2189,12355
14-06-2020,19 - 20,923,1639,7778,2243,12583
14-06-2020,20 - 21,1079,1507,7752,2237,12575
14-06-2020,21 - 22,1081,1589,7488,2121,12279
14-06-2020,22 - 23,927,1586,7261,2067,11841
14-06-2020,23 - 00,877,1638,7005,1954,11474
15-06-2020,00 - 01,920,1284,6759,1892,10855
15-06-2020,01 - 02,754,1228,6622,1861,10465
15-06-2020,02 - 03,822,1378,6543,1819,10562
15-06-2020,03 - 04,997,1444,6478,1823,10742
15-06-2020,04 - 05,820,1303,6460,1795,10378
15-06-2020,05 - 06,912,1408,6811,1849,10980
15-06-2020,06 - 07,933,1478,7630,2125,12166
15-06-2020,07 - 08,920,1621,8608,2487,13636
15-06-2020,08 - 09,859,1636,9017,2622,14134
15-06-2020,09 - 10,1002,1778,9125,2637,14542
15-06-2020,10 - 11,986,1629,9216,2670,14501
15-06-2020,11 - 12,915,1611,9328,2756,14610
15-06-2020,12 - 13,913,1669,9293,2743,14618
15-06-2020,13 - 14,975,1678,9306,2726,14685
15-06-2020,14 - 15,959,1548,9283,2672,14462
15-06-2020,15 - 16,1013,1527,9210,2655,14405
15-06-2020,16 - 17,999,1576,9111,2609,14295
15-06-2020,17 - 18,1019,1581,9174,2579,14353
15-06-2020,18 - 19,930,1580,9020,2508,14038
15-06-2020,19 - 20,937,1510,8880,2461,13788
15-06-2020,20 - 21,960,1558,8692,2403,13613
15-06-2020,21 - 22,907,1548,8334,2377,13166
15-06-2020,22 - 23,902,1420,8000,2312,12634
15-06-2020,23 - 00,783,1265,7605,2113,11766
16-06-2020,00 - 01,639,1254,7112,1951,10956
16-06-2020,01 - 02,693,1257,6771,1871,10592
16-06-2020,02 - 03,796,1187,6569,1882,10434
16-06-2020,03 - 04,871,1020,6468,1865,10224
16-06-2020,04 - 05,843,1060,6256,1819,9978
16-06-2020,05 - 06,894,1243,6226,1891,10254
16-06-2020,06 - 07,1033,1538,7261,2178,12010
16-06-2020,07 - 08,982,1688,8393,2466,13529
16-06-2020,08 - 09,928,1676,8882,2582,14068
16-06-2020,09 - 10,944,1614,8981,2585,14124
16-06-2020,10 - 11,889,1642,9188,2681,14400
16-06-2020,11 - 12,868,1791,9407,2747,14813
16-06-2020,12 - 13,865,1689,9440,2688,14682
16-06-2020,13 - 14,993,1723,9444,2714,14874
16-06-2020,14 - 15,919,1642,9243,2732,14536
16-06-2020,15 - 16,980,1549,8987,2710,14226
16-06-2020,16 - 17,980,1551,8980,2648,14159
16-06-2020,17 - 18,973,1597,9175,2584,14329
16-06-2020,18 - 19,949,1582,9509,2569,14609
16-06-2020,19 - 20,958,1505,9406,2498,14367
16-06-2020,20 - 21,1016,1527,8539,2361,13443
16-06-2020,21 - 22,923,1573,8231,2288,13015
16-06-2020,22 - 23,870,1428,7935,2208,12441
16-06-2020,23 - 00,790,1132,7533,2040,11495
17-06-2020,00 - 01,861,1279,7164,1916,11220
17-06-2020,01 - 02,859,1265,6989,1869,10982
17-06-2020,02 - 03,881,1042,6732,1854,10509
17-06-2020,03 - 04,917,1019,6496,1839,10271
17-06-2020,04 - 05,833,1042,6444,1778,10097
17-06-2020,05 - 06,979,1242,6812,1900,10933
17-06-2020,06 - 07,886,1567,7913,2183,12549
17-06-2020,07 - 08,1011,1671,8679,2458,13819
17-06-2020,08 - 09,1038,1694,9147,2553,14432
17-06-2020,09 - 10,990,1642,9331,2626,14589
17-06-2020,10 - 11,919,1600,9459,2710,14688
17-06-2020,11 - 12,903,1584,9607,2725,14819
17-06-2020,12 - 13,1013,1614,9695,2709,15031
17-06-2020,13 - 14,1045,1626,9612,2686,14969
17-06-2020,14 - 15,1086,1569,9480,2643,14778
17-06-2020,15 - 16,949,1477,9429,2578,14433
17-06-2020,16 - 17,882,1343,9255,2534,14014
17-06-2020,17 - 18,850,1464,9249,2536,14099
17-06-2020,18 - 19,969,1474,9019,2443,13905
17-06-2020,19 - 20,911,1475,8792,2378,13556
17-06-2020,20 - 21,936,1278,8527,2280,13021
17-06-2020,21 - 22,942,1291,8161,2190,12584
17-06-2020,22 - 23,948,1447,7985,2179,12559
17-06-2020,23 - 00,898,1429,7726,1995,12048
18-06-2020,00 - 01,859,1335,7222,1894,11310
18-06-2020,01 - 02,785,1316,7078,1807,10986
18-06-2020,02 - 03,733,1395,6911,1780,10819
18-06-2020,03 - 04,835,1308,6771,1763,10677
18-06-2020,04 - 05,780,1310,6642,1719,10451
18-06-2020,05 - 06,735,1308,6937,1779,10759
18-06-2020,06 - 07,816,1453,7697,2043,12009
18-06-2020,07 - 08,716,1485,8436,2324,12961
18-06-2020,08 - 09,649,1485,8705,2440,13279
18-06-2020,09 - 10,915,1559,8880,2473,13827
18-06-2020,10 - 11,941,1536,8912,2513,13902
18-06-2020,11 - 12,788,1598,9013,2537,13936
18-06-2020,12 - 13,1042,1563,9038,2508,14151
18-06-2020,13 - 14,1255,1510,8902,2528,14195
18-06-2020,14 - 15,1015,1534,8722,2494,13765
18-06-2020,15 - 16,896,1451,8628,2441,13416
18-06-2020,16 - 17,954,1473,8535,2377,13339
18-06-2020,17 - 18,971,1657,8465,2333,13426
18-06-2020,18 - 19,926,1631,8296,2287,13140
18-06-2020,19 - 20,975,1543,8172,2248,12938
18-06-2020,20 - 21,1040,1443,7898,2158,12539
18-06-2020,21 - 22,1064,1399,7619,2078,12160
18-06-2020,22 - 23,1074,1331,7324,2012,11741
18-06-2020,23 - 00,1032,1386,7101,1860,11379
19-06-2020,00 - 01,636,1314,6616,1735,10301
19-06-2020,01 - 02,566,1265,6164,1646,9641
19-06-2020,02 - 03,550,1468,6006,1599,9623
19-06-2020,03 - 04,780,1418,5861,1557,9616
19-06-2020,04 - 05,727,1253,5582,1446,9008
19-06-2020,05 - 06,725,1113,5567,1448,8853
19-06-2020,06 - 07,929,1205,5859,1558,9551
19-06-2020,07 - 08,855,1422,6375,1715,10367
19-06-2020,08 - 09,902,1478,6818,1889,11087
19-06-2020,09 - 10,931,1535,7173,1997,11636
19-06-2020,10 - 11,993,1499,7329,2100,11921
19-06-2020,11 - 12,960,1481,7493,2185,12119
19-06-2020,12 - 13,1006,1546,7477,2180,12209
19-06-2020,13 - 14,1017,1432,7179,2120,11748
19-06-2020,14 - 15,897,1358,7019,2017,11291
19-06-2020,15 - 16,870,1310,6915,1977,11072
19-06-2020,16 - 17,937,1312,6904,1970,11123
19-06-2020,17 - 18,945,1385,7006,1971,11307
19-06-2020,18 - 19,934,1420,6949,1909,11212
19-06-2020,19 - 20,912,1351,6752,1849,10864
19-06-2020,20 - 21,897,1258,6491,1824,10470
19-06-2020,21 - 22,864,1200,6606,1821,10491
19-06-2020,22 - 23,816,1048,6755,1845,10464
19-06-2020,23 - 00,760,886,6633,1714,9993
20-06-2020,00 - 01,772,616,6070,1653,9111
20-06-2020,01 - 02,780,584,5813,1641,8818
20-06-2020,02 - 03,722,625,5578,1603,8528
20-06-2020,03 - 04,803,636,5307,1553,8299
20-06-2020,04 - 05,875,749,5158,1460,8242
20-06-2020,05 - 06,803,781,5357,1442,8383
20-06-2020,06 - 07,860,871,5488,1490,8709
20-06-2020,07 - 08,801,1185,5803,1606,9395
20-06-2020,08 - 09,897,1383,6178,1712,10170
20-06-2020,09 - 10,922,1492,6682,1835,10931
20-06-2020,10 - 11,970,1549,6691,1950,11160
20-06-2020,11 - 12,1017,1374,6791,1990,11172
20-06-2020,12 - 13,969,1282,6854,2012,11117
20-06-2020,13 - 14,824,1187,6884,2019,10914
20-06-2020,14 - 15,884,1215,6918,1948,10965
20-06-2020,15 - 16,840,1185,6842,1902,10769
20-06-2020,16 - 17,854,1201,6794,1898,10747
20-06-2020,17 - 18,890,1274,6921,1948,11033
20-06-2020,18 - 19,882,1279,7019,1943,11123
20-06-2020,19 - 20,878,1306,6970,1882,11036
20-06-2020,20 - 21,859,1336,6809,1840,10844
20-06-2020,21 - 22,900,1286,6608,1792,10586
20-06-2020,22 - 23,901,1185,6422,1783,10291
20-06-2020,23 - 00,820,1079,6258,1693,9850
21-06-2020,00 - 01,638,965,5918,1612,9133
21-06-2020,01 - 02,728,939,5702,1527,8896
21-06-2020,02 - 03,737,934,5638,1532,8841
21-06-2020,03 - 04,818,931,5484,1511,8744
21-06-2020,04 - 05,826,1020,5321,1453,8620
21-06-2020,05 - 06,772,1117,5378,1434,8701
21-06-2020,06 - 07,871,1181,5446,1492,8990
21-06-2020,07 - 08,899,1225,5761,1608,9493
21-06-2020,08 - 09,1121,1381,6091,1743,10336
21-06-2020,09 - 10,946,1386,6520,1867,10719
21-06-2020,10 - 11,988,1361,6897,1995,11241
21-06-2020,11 - 12,953,1337,7096,2091,11477
21-06-2020,12 - 13,958,1345,7205,2111,11619
21-06-2020,13 - 14,948,1295,7165,2103,11511
21-06-2020,14 - 15,922,1263,7071,2046,11302
21-06-2020,15 - 16,943,1329,7246,2044,11562
21-06-2020,16 - 17,999,1434,7189,2080,11702
21-06-2020,17 - 18,948,1548,7430,2142,12068
21-06-2020,18 - 19,982,1577,7525,2162,12246
21-06-2020,19 - 20,1002,1492,7471,2133,12098
21-06-2020,20 - 21,925,1578,7333,2081,11917
21-06-2020,21 - 22,946,1506,7081,2011,11544
21-06-2020,22 - 23,786,1401,6800,2006,10993
21-06-2020,23 - 00,688,1384,6619,1888,10579
22-06-2020,00 - 01,761,1301,6252,1773,10087
22-06-2020,01 - 02,856,1315,6068,1697,9936
22-06-2020,02 - 03,889,1278,6132,1667,9966
22-06-2020,03 - 04,884,1117,6071,1682,9754
22-06-2020,04 - 05,876,1192,5992,1667,9727
22-06-2020,05 - 06,961,1201,6274,1728,10164
22-06-2020,06 - 07,1154,1431,7021,1960,11566
22-06-2020,07 - 08,1127,1583,8019,2278,13007
22-06-2020,08 - 09,1098,1557,8436,2360,13451
22-06-2020,09 - 10,1047,1613,8705,2436,13801
22-06-2020,10 - 11,1052,1580,8819,2586,14037
22-06-2020,11 - 12,1091,1663,8948,2574,14276
22-06-2020,12 - 13,1102,1660,9006,2530,14298
22-06-2020,13 - 14,1167,1488,8959,2554,14168
22-06-2020,14 - 15,1141,1530,8852,2532,14055
22-06-2020,15 - 16,1091,1507,8913,2499,14010
22-06-2020,16 - 17,1172,1629,8822,2385,14008
22-06-2020,17 - 18,1130,1537,8868,2375,13910
22-06-2020,18 - 19,1004,1549,8687,2337,13577
22-06-2020,19 - 20,1015,1609,8510,2307,13441
22-06-2020,20 - 21,1085,1576,8313,2311,13285
22-06-2020,21 - 22,1075,1455,7981,2234,12745
22-06-2020,22 - 23,1038,1417,7731,2197,12383
22-06-2020,23 - 00,889,1301,7344,1976,11510
23-06-2020,00 - 01,961,1154,6987,1841,10943
23-06-2020,01 - 02,1032,1104,6804,1790,10730
23-06-2020,02 - 03,883,1174,6647,1722,10426
23-06-2020,03 - 04,799,1232,6504,1692,10227
23-06-2020,04 - 05,837,1305,6453,1668,10263
23-06-2020,05 - 06,821,1431,6733,1768,10753
23-06-2020,06 - 07,848,1605,7555,2088,12096
23-06-2020,07 - 08,1090,1607,8277,2342,13316
23-06-2020,08 - 09,1001,1595,8634,2511,13741
23-06-2020,09 - 10,1013,1683,8791,2562,14049
23-06-2020,10 - 11,965,1615,8990,2569,14139
23-06-2020,11 - 12,1045,1745,8999,2569,14358
23-06-2020,12 - 13,1055,1750,9063,2559,14427
23-06-2020,13 - 14,1002,1694,8946,2522,14164
23-06-2020,14 - 15,922,1646,8935,2502,14005
23-06-2020,15 - 16,984,1588,8945,2553,14070
23-06-2020,16 - 17,934,1673,8866,2494,13967
23-06-2020,17 - 18,938,1639,8827,2476,13880
23-06-2020,18 - 19,938,1722,8639,2400,13699
23-06-2020,19 - 20,1022,1613,8494,2320,13449
23-06-2020,20 - 21,1047,1556,8329,2249,13181
23-06-2020,21 - 22,982,1440,8289,2164,12875
23-06-2020,22 - 23,1009,1374,8013,2108,12504
23-06-2020,23 - 00,856,1287,7648,1993,11784
24-06-2020,00 - 01,855,1190,7116,1848,11009
24-06-2020,01 - 02,806,1316,6983,1767,10872
24-06-2020,02 - 03,688,1269,6855,1730,10542
24-06-2020,03 - 04,840,1247,6680,1738,10505
24-06-2020,04 - 05,999,1416,6576,1693,10684
24-06-2020,05 - 06,1009,1492,6876,1781,11158
24-06-2020,06 - 07,1078,1500,7740,1994,12312
24-06-2020,07 - 08,1041,1560,8490,2297,13388
24-06-2020,08 - 09,953,1695,8859,2434,13941
24-06-2020,09 - 10,1042,1757,9032,2467,14298
24-06-2020,10 - 11,1038,1672,9209,2543,14462
24-06-2020,11 - 12,958,1780,9324,2557,14619
24-06-2020,12 - 13,948,1789,9409,2559,14705
24-06-2020,13 - 14,1060,1544,9221,2530,14355
24-06-2020,14 - 15,1078,1523,9134,2533,14268
24-06-2020,15 - 16,1030,1420,9170,2451,14071
24-06-2020,16 - 17,924,1430,9069,2357,13780
24-06-2020,17 - 18,909,1478,9353,2352,14092
24-06-2020,18 - 19,985,1554,8940,2313,13792
24-06-2020,19 - 20,1082,1574,8704,2305,13665
24-06-2020,20 - 21,1055,1542,8407,2233,13237
24-06-2020,21 - 22,1042,1551,8058,2146,12797
24-06-2020,22 - 23,1047,1525,7901,2104,12577
24-06-2020,23 - 00,1120,1412,7714,1978,12224
25-06-2020,00 - 01,922,1244,7259,1838,11263
25-06-2020,01 - 02,924,1132,6829,1747,10632
25-06-2020,02 - 03,993,1215,6724,1714,10646
25-06-2020,03 - 04,870,1213,6676,1705,10464
25-06-2020,04 - 05,918,1258,6558,1671,10405
25-06-2020,05 - 06,844,1160,6888,1732,10624
25-06-2020,06 - 07,916,1159,7526,1976,11577
25-06-2020,07 - 08,1011,1444,8272,2245,12972
25-06-2020,08 - 09,1104,1704,8799,2446,14053
25-06-2020,09 - 10,1146,1632,8876,2537,14191
25-06-2020,10 - 11,1148,1599,8980,2599,14326
25-06-2020,11 - 12,966,1563,9020,2615,14164
25-06-2020,12 - 13,898,1477,9004,2578,13957
25-06-2020,13 - 14,942,1508,8909,2562,13921
25-06-2020,14 - 15,935,1482,8804,2550,13771
25-06-2020,15 - 16,916,1496,8912,2447,13771
25-06-2020,16 - 17,916,1364,8940,2416,13636
25-06-2020,17 - 18,881,1393,8878,2328,13480
25-06-2020,18 - 19,1006,1449,8576,2335,13366
25-06-2020,19 - 20,1015,1371,8457,2303,13146
25-06-2020,20 - 21,1061,1314,8316,2251,12942
25-06-2020,21 - 22,1041,1384,8032,2177,12634
25-06-2020,22 - 23,976,1433,7768,2089,12266
25-06-2020,23 - 00,892,1247,7356,1930,11425
26-06-2020,00 - 01,782,882,6949,1753,10366
26-06-2020,01 - 02,823,925,6665,1688,10101
26-06-2020,02 - 03,800,1045,6611,1701,10157
26-06-2020,03 - 04,722,1035,6418,1712,9887
26-06-2020,04 - 05,652,1164,6347,1667,9830
26-06-2020,05 - 06,759,1307,6695,1689,10450
26-06-2020,06 - 07,1074,1476,7453,1944,11947
26-06-2020,07 - 08,1107,1581,8262,2272,13222
26-06-2020,08 - 09,959,1592,8581,2466,13598
26-06-2020,09 - 10,1069,1599,8689,2508,13865
26-06-2020,10 - 11,977,1512,8909,2543,13941
26-06-2020,11 - 12,995,1587,8935,2511,14028
26-06-2020,12 - 13,949,1510,9024,2560,14043
26-06-2020,13 - 14,954,1507,8937,2503,13901
26-06-2020,14 - 15,1063,1620,8684,2475,13842
26-06-2020,15 - 16,1080,1521,8682,2354,13637
26-06-2020,16 - 17,1088,1550,8561,2285,13484
26-06-2020,17 - 18,1072,1551,8408,2244,13275
26-06-2020,18 - 19,1124,1632,8206,2180,13142
26-06-2020,19 - 20,1070,1693,8063,2084,12910
26-06-2020,20 - 21,949,1769,7803,1995,12516
26-06-2020,21 - 22,965,1657,7506,1962,12090
26-06-2020,22 - 23,900,1773,7272,1974,11919
26-06-2020,23 - 00,865,1748,6981,1897,11491
27-06-2020,00 - 01,792,1507,6814,1792,10905
27-06-2020,01 - 02,916,1511,6428,1686,10541
27-06-2020,02 - 03,824,1307,6297,1608,10036
27-06-2020,03 - 04,763,1046,6180,1574,9563
27-06-2020,04 - 05,887,1085,6025,1504,9501
27-06-2020,05 - 06,878,1049,6008,1475,9410
27-06-2020,06 - 07,884,974,6074,1584,9516
27-06-2020,07 - 08,864,1015,6366,1771,10016
27-06-2020,08 - 09,889,1185,7091,1886,11051
27-06-2020,09 - 10,955,1296,7574,2011,11836
27-06-2020,10 - 11,961,1345,7636,2059,12001
27-06-2020,11 - 12,976,1349,7629,2021,11975
27-06-2020,12 - 13,1004,1245,7403,2051,11703
27-06-2020,13 - 14,957,1304,7389,2000,11650
27-06-2020,14 - 15,978,1301,7280,1933,11492
27-06-2020,15 - 16,972,1312,7225,1935,11444
27-06-2020,16 - 17,984,1524,7310,1944,11762
27-06-2020,17 - 18,1018,1677,7583,2067,12345
27-06-2020,18 - 19,949,1552,7664,2101,12266
27-06-2020,19 - 20,946,1382,7546,2092,11966
27-06-2020,20 - 21,937,1389,7229,2032,11587
27-06-2020,21 - 22,899,1363,6954,1940,11156
27-06-2020,22 - 23,904,1243,7099,1939,11185
27-06-2020,23 - 00,901,1182,7044,1876,11003
28-06-2020,00 - 01,803,1088,6797,1783,10471
28-06-2020,01 - 02,766,910,6423,1682,9781
28-06-2020,02 - 03,865,1032,6221,1615,9733
28-06-2020,03 - 04,892,1104,5851,1563,9410
28-06-2020,04 - 05,865,1133,5487,1476,8961
28-06-2020,05 - 06,943,1294,5582,1466,9285
28-06-2020,06 - 07,878,1540,5915,1536,9869
28-06-2020,07 - 08,829,1587,6346,1669,10431
28-06-2020,08 - 09,936,1595,6894,1831,11256
28-06-2020,09 - 10,942,1461,7248,1927,11578
28-06-2020,10 - 11,981,1359,7475,2000,11815
28-06-2020,11 - 12,938,1397,7606,2065,12006
28-06-2020,12 - 13,950,1431,7679,2082,12142
28-06-2020,13 - 14,1001,1526,7639,2119,12285
28-06-2020,14 - 15,1035,1482,7422,2043,11982
28-06-2020,15 - 16,1038,1359,7491,2029,11917
28-06-2020,16 - 17,1013,1289,7391,2094,11787
28-06-2020,17 - 18,1011,1312,7437,2128,11888
28-06-2020,18 - 19,1020,1426,7555,2083,12084
28-06-2020,19 - 20,967,1357,7733,2057,12114
28-06-2020,20 - 21,974,1440,7615,1996,12025
28-06-2020,21 - 22,975,1460,7530,1955,11920
28-06-2020,22 - 23,945,1435,7517,2027,11924
28-06-2020,23 - 00,912,1223,7091,1914,11140
29-06-2020,00 - 01,785,1104,6753,1804,10446
29-06-2020,01 - 02,905,1132,6589,1716,10342
29-06-2020,02 - 03,827,1099,6532,1668,10126
29-06-2020,03 - 04,792,1085,6407,1642,9926
29-06-2020,04 - 05,848,1230,6198,1562,9838
29-06-2020,05 - 06,931,1237,6278,1650,10096
29-06-2020,06 - 07,932,1485,7164,1978,11559
29-06-2020,07 - 08,1048,1673,8089,2308,13118
29-06-2020,08 - 09,1046,1776,8559,2483,13864
29-06-2020,09 - 10,1050,1650,8774,2552,14026
29-06-2020,10 - 11,983,1701,8733,2663,14080
29-06-2020,11 - 12,1080,1815,8920,2705,14520
29-06-2020,12 - 13,1095,1536,9048,2648,14327
29-06-2020,13 - 14,1121,1671,9003,2651,14446
29-06-2020,14 - 15,1073,1932,8924,2580,14509
29-06-2020,15 - 16,1125,1838,8912,2531,14406
29-06-2020,16 - 17,1050,1797,8840,2480,14167
29-06-2020,17 - 18,867,1785,8732,2523,13907
29-06-2020,18 - 19,867,1697,8593,2460,13617
29-06-2020,19 - 20,971,1651,8261,2377,13260
29-06-2020,20 - 21,1092,1653,8177,2316,13238
29-06-2020,21 - 22,1039,1689,7988,2241,12957
29-06-2020,22 - 23,939,1522,7785,2179,12425
29-06-2020,23 - 00,980,1482,7427,2014,11903
30-06-2020,00 - 01,895,1354,6836,1835,10920
30-06-2020,01 - 02,985,1502,6579,1760,10826
30-06-2020,02 - 03,837,1500,6501,1709,10547
30-06-2020,03 - 04,937,1547,6447,1691,10622
30-06-2020,04 - 05,1024,1527,6291,1694,10536
30-06-2020,05 - 06,899,1227,6512,1802,10440
30-06-2020,06 - 07,916,1510,7329,2224,11979
30-06-2020,07 - 08,946,1713,8234,2499,13392
30-06-2020,08 - 09,1158,1854,8555,2594,14161
30-06-2020,09 - 10,983,1764,8621,2617,13985
30-06-2020,10 - 11,1016,1846,8922,2598,14382
30-06-2020,11 - 12,1042,1675,8946,2645,14308
30-06-2020,12 - 13,1116,1847,8787,2728,14478
30-06-2020,13 - 14,1092,1637,8656,2730,14115
30-06-2020,14 - 15,1202,1765,8684,2720,14371
30-06-2020,15 - 16,999,1487,8738,2726,13950
30-06-2020,16 - 17,922,1435,8407,2595,13359
30-06-2020,17 - 18,1239,1561,8668,2668,14136
30-06-2020,18 - 19,1059,1254,8660,2664,13637
30-06-2020,19 - 20,741,1085,8519,2612,12957
30-06-2020,20 - 21,813,1290,8216,2487,12806
30-06-2020,21 - 22,1033,1439,7924,2375,12771
30-06-2020,22 - 23,1077,1295,7584,2269,12225
30-06-2020,23 - 00,822,1213,7317,2100,11452
01-07-2020,00 - 01,818,1215,6844,1973,10850
01-07-2020,01 - 02,862,1160,6699,1860,10581
01-07-2020,02 - 03,900,1039,6597,1817,10353
01-07-2020,03 - 04,871,1013,6437,1817,10138
01-07-2020,04 - 05,900,1171,6370,1822,10263
01-07-2020,05 - 06,681,1254,6671,1949,10555
01-07-2020,06 - 07,745,1463,7480,2271,11959
01-07-2020,07 - 08,1091,1471,8340,2530,13432
01-07-2020,08 - 09,1050,1353,8768,2648,13819
01-07-2020,09 - 10,963,1573,8945,2663,14144
01-07-2020,10 - 11,1201,1782,9223,2752,14958
01-07-2020,11 - 12,1181,1692,9303,2731,14907
01-07-2020,12 - 13,1087,1711,9207,2707,14712
01-07-2020,13 - 14,1035,1717,9250,2703,14705
01-07-2020,14 - 15,888,1518,9040,2638,14084
01-07-2020,15 - 16,983,1594,8937,2625,14139
01-07-2020,16 - 17,1156,1600,8744,2563,14063
01-07-2020,17 - 18,1069,1619,8821,2512,14021
01-07-2020,18 - 19,996,1639,8658,2452,13745
01-07-2020,19 - 20,928,1567,8494,2432,13421
01-07-2020,20 - 21,1096,1480,8229,2307,13112
01-07-2020,21 - 22,1123,1644,7991,2180,12938
01-07-2020,22 - 23,857,1533,7751,2128,12269
01-07-2020,23 - 00,794,1283,7478,2020,11575
02-07-2020,00 - 01,763,1342,7005,1848,10958
02-07-2020,01 - 02,804,1421,6813,1784,10822
02-07-2020,02 - 03,839,1377,6797,1724,10737
02-07-2020,03 - 04,819,1381,6586,1703,10489
02-07-2020,04 - 05,982,1246,6381,1690,10299
02-07-2020,05 - 06,1049,1370,6533,1760,10712
02-07-2020,06 - 07,952,1577,7273,2002,11804
02-07-2020,07 - 08,997,1618,7990,2330,12935
02-07-2020,08 - 09,1051,1548,8295,2480,13374
02-07-2020,09 - 10,844,1650,8412,2536,13442
02-07-2020,10 - 11,974,1733,8479,2586,13772
02-07-2020,11 - 12,886,1754,8493,2569,13702
02-07-2020,12 - 13,1080,1812,8434,2504,13830
02-07-2020,13 - 14,1088,1725,8504,2470,13787
02-07-2020,14 - 15,964,1756,8330,2463,13513
02-07-2020,15 - 16,1029,1725,8263,2424,13441
02-07-2020,16 - 17,939,1616,8267,2358,13180
02-07-2020,17 - 18,1037,1652,8366,2345,13400
02-07-2020,18 - 19,1022,1799,8189,2331,13341
02-07-2020,19 - 20,976,1674,7984,2295,12929
02-07-2020,20 - 21,989,1633,7783,2315,12720
02-07-2020,21 - 22,913,1504,7608,2212,12237
02-07-2020,22 - 23,847,1531,7391,2111,11880
02-07-2020,23 - 00,819,1573,7045,1956,11393
03-07-2020,00 - 01,683,1320,6666,1858,10527
03-07-2020,01 - 02,684,1288,6448,1784,10204
03-07-2020,02 - 03,830,1341,6264,1725,10160
03-07-2020,03 - 04,800,1296,6258,1689,10043
03-07-2020,04 - 05,896,1210,6143,1615,9864
03-07-2020,05 - 06,867,1336,6459,1726,10388
03-07-2020,06 - 07,941,1451,7200,2047,11639
03-07-2020,07 - 08,907,1525,7921,2304,12657
03-07-2020,08 - 09,883,1716,8188,2391,13178
03-07-2020,09 - 10,960,1717,8305,2494,13476
03-07-2020,10 - 11,993,1626,8395,2506,13520
03-07-2020,11 - 12,1125,1637,8422,2474,13658
03-07-2020,12 - 13,1025,1592,8309,2464,13390
03-07-2020,13 - 14,839,1387,8281,2403,12910
03-07-2020,14 - 15,851,1450,8115,2391,12807
03-07-2020,15 - 16,1037,1330,7913,2401,12681
03-07-2020,16 - 17,1028,1418,7866,2330,12642
03-07-2020,17 - 18,933,1377,7856,2350,12516
03-07-2020,18 - 19,924,1256,7822,2354,12356
03-07-2020,19 - 20,832,1362,7639,2268,12101
03-07-2020,20 - 21,778,1456,7430,2168,11832
03-07-2020,21 - 22,787,1384,7133,2037,11341
03-07-2020,22 - 23,894,1306,6962,1908,11070
03-07-2020,23 - 00,851,1261,6589,1833,10534
04-07-2020,00 - 01,709,1064,6364,1804,9941
04-07-2020,01 - 02,837,1159,6110,1692,9798
04-07-2020,02 - 03,1012,1198,5919,1652,9781
04-07-2020,03 - 04,977,1163,5901,1654,9695
04-07-2020,04 - 05,826,1110,5799,1699,9434
04-07-2020,05 - 06,938,1142,5810,1632,9522
04-07-2020,06 - 07,961,1169,6019,1637,9786
04-07-2020,07 - 08,936,1301,6202,1776,10215
04-07-2020,08 - 09,962,1327,6594,1934,10817
04-07-2020,09 - 10,954,1365,7015,2094,11428
04-07-2020,10 - 11,917,1418,7360,2195,11890
04-07-2020,11 - 12,867,1459,7605,2259,12190
04-07-2020,12 - 13,953,1345,7629,2305,12232
04-07-2020,13 - 14,1132,1313,7545,2309,12299
04-07-2020,14 - 15,1131,1310,7440,2229,12110
04-07-2020,15 - 16,1084,1171,7358,2177,11790
04-07-2020,16 - 17,1019,1242,7425,2172,11858
04-07-2020,17 - 18,954,1360,7560,2158,12032
04-07-2020,18 - 19,1018,1253,7485,2205,11961
04-07-2020,19 - 20,1061,1293,7431,2212,11997
04-07-2020,20 - 21,1063,1302,7234,2139,11738
04-07-2020,21 - 22,942,1352,7004,2059,11357
04-07-2020,22 - 23,896,1227,6835,1979,10937
04-07-2020,23 - 00,955,1214,6511,1887,10567
05-07-2020,00 - 01,929,1054,6240,1925,10148
05-07-2020,01 - 02,933,1115,6068,1804,9920
05-07-2020,02 - 03,895,1141,6041,1734,9811
05-07-2020,03 - 04,956,1199,5912,1755,9822
05-07-2020,04 - 05,965,1289,5769,1692,9715
05-07-2020,05 - 06,828,1164,5699,1633,9324
05-07-2020,06 - 07,746,1169,5729,1630,9274
05-07-2020,07 - 08,652,1223,5974,1743,9592
05-07-2020,08 - 09,880,1230,6288,1816,10214
05-07-2020,09 - 10,1027,1258,6610,1887,10782
05-07-2020,10 - 11,1043,1275,7030,1985,11333
05-07-2020,11 - 12,1079,1282,7311,2033,11705
05-07-2020,12 - 13,1083,1115,7300,2056,11554
05-07-2020,13 - 14,985,1006,7322,2069,11382
05-07-2020,14 - 15,1021,1042,7235,2083,11381
05-07-2020,15 - 16,1024,1023,7153,2048,11248
05-07-2020,16 - 17,1058,1064,7397,2023,11542
05-07-2020,17 - 18,1031,1153,7614,2048,11846
05-07-2020,18 - 19,879,1204,7628,2050,11761
05-07-2020,19 - 20,927,1102,7501,2011,11541
05-07-2020,20 - 21,925,1137,7236,2018,11316
05-07-2020,21 - 22,1008,1038,6987,1970,11003
05-07-2020,22 - 23,966,979,6893,1977,10815
05-07-2020,23 - 00,950,1080,6622,1896,10548
06-07-2020,00 - 01,959,1173,6525,1797,10454
06-07-2020,01 - 02,955,1422,6320,1716,10413
06-07-2020,02 - 03,923,1447,6106,1721,10197
06-07-2020,03 - 04,860,1199,6039,1740,9838
06-07-2020,04 - 05,840,1357,6007,1691,9895
06-07-2020,05 - 06,963,1382,6231,1796,10372
06-07-2020,06 - 07,1158,1602,6851,2023,11634
06-07-2020,07 - 08,1230,1732,7520,2281,12763
06-07-2020,08 - 09,1142,1811,7961,2434,13348
06-07-2020,09 - 10,1069,1910,8110,2496,13585
06-07-2020,10 - 11,1114,1858,8293,2552,13817
06-07-2020,11 - 12,1173,1836,8391,2502,13902
06-07-2020,12 - 13,1144,2008,8369,2545,14066
06-07-2020,13 - 14,1194,1950,8399,2527,14070
06-07-2020,14 - 15,1219,1893,8422,2422,13956
06-07-2020,15 - 16,1213,1955,8366,2460,13994
06-07-2020,16 - 17,1114,1800,8257,2463,13634
06-07-2020,17 - 18,1091,1813,8284,2517,13705
06-07-2020,18 - 19,1071,1718,8272,2533,13594
06-07-2020,19 - 20,1083,1719,8075,2476,13353
06-07-2020,20 - 21,1092,1721,7790,2350,12953
06-07-2020,21 - 22,945,1737,7405,2227,12314
06-07-2020,22 - 23,860,1794,7249,2178,12081
06-07-2020,23 - 00,913,1734,6901,2057,11605
07-07-2020,00 - 01,879,1525,6510,1912,10826
07-07-2020,01 - 02,934,1424,6280,1853,10491
07-07-2020,02 - 03,925,1375,6269,1825,10394
07-07-2020,03 - 04,864,1349,6112,1811,10136
07-07-2020,04 - 05,888,1294,5987,1804,9973
07-07-2020,05 - 06,975,1442,6149,1914,10480
07-07-2020,06 - 07,1114,1578,6772,2144,11608
07-07-2020,07 - 08,1083,1634,7567,2349,12633
07-07-2020,08 - 09,1061,1637,7822,2466,12986
07-07-2020,09 - 10,1056,1700,7993,2521,13270
07-07-2020,10 - 11,1066,1703,8083,2544,13396
07-07-2020,11 - 12,1102,1735,8195,2557,13589
07-07-2020,12 - 13,1074,1715,8253,2598,13640
07-07-2020,13 - 14,1058,1688,8236,2620,13602
07-07-2020,14 - 15,967,1670,8096,2564,13297
07-07-2020,15 - 16,1081,1671,8034,2540,13326
07-07-2020,16 - 17,1078,1633,7975,2444,13130
07-07-2020,17 - 18,1130,1802,7986,2542,13460
07-07-2020,18 - 19,1033,1719,8124,2524,13400
07-07-2020,19 - 20,1025,1700,7983,2401,13109
07-07-2020,20 - 21,1082,1649,7889,2321,12941
07-07-2020,21 - 22,1048,1553,7739,2198,12538
07-07-2020,22 - 23,1091,1475,7573,2116,12255
07-07-2020,23 - 00,1007,1392,7244,1979,11622
08-07-2020,00 - 01,967,1385,6915,1903,11170
08-07-2020,01 - 02,934,1394,6732,1815,10875
08-07-2020,02 - 03,1010,1520,6617,1800,10947
08-07-2020,03 - 04,1030,1487,6530,1779,10826
08-07-2020,04 - 05,1002,1426,6480,1734,10642
08-07-2020,05 - 06,977,1470,6684,1828,10959
08-07-2020,06 - 07,986,1555,7253,2063,11857
08-07-2020,07 - 08,970,1607,7899,2256,12732
08-07-2020,08 - 09,947,1697,8219,2349,13212
08-07-2020,09 - 10,1210,1705,8382,2443,13740
08-07-2020,10 - 11,1284,1715,8605,2470,14074
08-07-2020,11 - 12,1154,1800,8746,2547,14247
08-07-2020,12 - 13,1274,1634,8720,2512,14140
08-07-2020,13 - 14,1086,1655,8604,2464,13809
08-07-2020,14 - 15,987,1668,8474,2464,13593
08-07-2020,15 - 16,1042,1698,8447,2395,13582
08-07-2020,16 - 17,920,1681,8129,2332,13062
08-07-2020,17 - 18,1057,1642,8258,2302,13259
08-07-2020,18 - 19,1051,1694,8237,2324,13306
08-07-2020,19 - 20,1036,1635,8106,2278,13055
08-07-2020,20 - 21,778,1674,7821,2258,12531
08-07-2020,21 - 22,1005,1600,7547,2161,12313
08-07-2020,22 - 23,1033,1528,7406,2105,12072
08-07-2020,23 - 00,912,1343,7031,1995,11281
09-07-2020,00 - 01,960,1038,6698,1841,10537
09-07-2020,01 - 02,926,1166,6585,1688,10365
09-07-2020,02 - 03,927,1086,6517,1666,10196
09-07-2020,03 - 04,928,1024,6298,1719,9969
09-07-2020,04 - 05,945,1106,6158,1720,9929
09-07-2020,05 - 06,939,1090,6464,1825,10318
09-07-2020,06 - 07,1012,1417,7051,2062,11542
09-07-2020,07 - 08,923,1628,7689,2272,12512
09-07-2020,08 - 09,908,1598,8083,2355,12944
09-07-2020,09 - 10,920,1584,8263,2396,13163
09-07-2020,10 - 11,984,1645,8360,2431,13420
09-07-2020,11 - 12,928,1625,8334,2433,13320
09-07-2020,12 - 13,892,1727,8276,2397,13292
09-07-2020,13 - 14,880,1672,8237,2390,13179
09-07-2020,14 - 15,816,1724,8187,2355,13082
09-07-2020,15 - 16,948,1642,8072,2330,12992
09-07-2020,16 - 17,928,1682,7943,2284,12837
09-07-2020,17 - 18,965,1595,8055,2313,12928
09-07-2020,18 - 19,1100,1682,7990,2292,13064
09-07-2020,19 - 20,1014,1595,7809,2232,12650
09-07-2020,20 - 21,967,1591,7620,2175,12353
09-07-2020,21 - 22,869,1556,7469,2132,12026
09-07-2020,22 - 23,810,1537,7459,2080,11886
09-07-2020,23 - 00,798,1408,7149,1926,11281
10-07-2020,00 - 01,822,1286,6736,1815,10659
10-07-2020,01 - 02,787,1281,6546,1750,10364
10-07-2020,02 - 03,851,1322,6482,1759,10414
10-07-2020,03 - 04,829,1362,6399,1805,10395
10-07-2020,04 - 05,824,1253,6273,1781,10131
10-07-2020,05 - 06,844,1116,6456,1829,10245
10-07-2020,06 - 07,914,1496,6928,2010,11348
10-07-2020,07 - 08,1004,1711,7483,2200,12398
10-07-2020,08 - 09,1075,1672,7842,2332,12921
10-07-2020,09 - 10,1031,1668,8090,2401,13190
10-07-2020,10 - 11,1031,1585,8244,2442,13302
10-07-2020,11 - 12,1005,1558,8262,2470,13295
10-07-2020,12 - 13,994,1510,8194,2477,13175
10-07-2020,13 - 14,1093,1564,8125,2466,13248
10-07-2020,14 - 15,1064,1617,7955,2448,13084
10-07-2020,15 - 16,1000,1590,7791,2408,12789
10-07-2020,16 - 17,1023,1636,7677,2392,12728
10-07-2020,17 - 18,991,1524,7739,2404,12658
10-07-2020,18 - 19,1028,1555,7674,2352,12609
10-07-2020,19 - 20,1007,1639,7429,2222,12297
10-07-2020,20 - 21,1008,1504,7055,2041,11608
10-07-2020,21 - 22,1055,1445,6852,1877,11229
10-07-2020,22 - 23,1013,1492,6781,1797,11083
10-07-2020,23 - 00,973,1422,6622,1662,10679
11-07-2020,00 - 01,953,1379,6350,1625,10307
11-07-2020,01 - 02,932,1398,6051,1582,9963
11-07-2020,02 - 03,931,1445,5925,1588,9889
11-07-2020,03 - 04,878,1496,5867,1597,9838
11-07-2020,04 - 05,868,1396,5693,1603,9560
11-07-2020,05 - 06,867,1318,5669,1578,9432
11-07-2020,06 - 07,871,1305,5861,1621,9658
11-07-2020,07 - 08,872,1481,6243,1698,10294
11-07-2020,08 - 09,884,1467,6627,1804,10782
11-07-2020,09 - 10,913,1610,7068,1896,11487
11-07-2020,10 - 11,1003,1556,7271,1994,11824
11-07-2020,11 - 12,954,1551,7209,2066,11780
11-07-2020,12 - 13,922,1475,7099,2087,11583
11-07-2020,13 - 14,955,1509,6969,2098,11531
11-07-2020,14 - 15,957,1574,6803,2051,11385
11-07-2020,15 - 16,934,1480,6851,2024,11289
11-07-2020,16 - 17,900,1418,6869,2081,11268
11-07-2020,17 - 18,932,1630,6949,2091,11602
11-07-2020,18 - 19,1155,1704,7090,2155,12104
11-07-2020,19 - 20,1045,1575,7125,2106,11851
11-07-2020,20 - 21,1031,1444,6906,2046,11427
11-07-2020,21 - 22,977,1439,6593,2027,11036
11-07-2020,22 - 23,970,1377,6703,1996,11046
11-07-2020,23 - 00,939,1671,6596,1813,11019
12-07-2020,00 - 01,876,1355,6292,1698,10221
12-07-2020,01 - 02,924,1230,6007,1624,9785
12-07-2020,02 - 03,937,1269,5894,1603,9703
12-07-2020,03 - 04,979,1283,5826,1599,9687
12-07-2020,04 - 05,931,1103,5703,1553,9290
12-07-2020,05 - 06,844,1184,5737,1581,9346
12-07-2020,06 - 07,902,1328,5860,1657,9747
12-07-2020,07 - 08,933,1483,6024,1701,10141
12-07-2020,08 - 09,871,1577,6254,1791,10493
12-07-2020,09 - 10,896,1497,6431,1885,10709
12-07-2020,10 - 11,958,1437,6660,1942,10997
12-07-2020,11 - 12,908,1477,6764,2015,11164
12-07-2020,12 - 13,858,1410,6796,2048,11112
12-07-2020,13 - 14,934,1456,6828,1987,11205
12-07-2020,14 - 15,933,1463,6833,1997,11226
12-07-2020,15 - 16,898,1475,6862,1959,11194
12-07-2020,16 - 17,895,1502,6877,1949,11223
12-07-2020,17 - 18,1021,1540,7021,2025,11607
12-07-2020,18 - 19,979,1599,6991,2037,11606
12-07-2020,19 - 20,944,1529,7039,2029,11541
12-07-2020,20 - 21,949,1456,6938,2029,11372
12-07-2020,21 - 22,944,1551,6764,2009,11268
12-07-2020,22 - 23,982,1477,6650,1940,11049
12-07-2020,23 - 00,938,1426,6309,1812,10485
13-07-2020,00 - 01,889,1322,5985,1707,9903
13-07-2020,01 - 02,893,1289,5943,1632,9757
13-07-2020,02 - 03,886,1165,5940,1632,9623
13-07-2020,03 - 04,848,1060,5830,1633,9371
13-07-2020,04 - 05,847,1182,5665,1648,9342
13-07-2020,05 - 06,910,1389,5823,1690,9812
13-07-2020,06 - 07,934,1182,6345,1909,10370
13-07-2020,07 - 08,966,1366,6958,2157,11447
13-07-2020,08 - 09,1103,1372,7394,2287,12156
13-07-2020,09 - 10,1218,1426,7622,2337,12603
13-07-2020,10 - 11,980,1404,7708,2388,12480
13-07-2020,11 - 12,962,1462,7729,2436,12589
13-07-2020,12 - 13,950,1465,7752,2431,12598
13-07-2020,13 - 14,947,1425,7670,2399,12441
13-07-2020,14 - 15,951,1401,7567,2351,12270
13-07-2020,15 - 16,1889,1293,7499,2337,13018
13-07-2020,16 - 17,918,1339,7421,2291,11969
13-07-2020,17 - 18,973,1436,7434,2280,12123
13-07-2020,18 - 19,944,1429,7389,2237,11999
13-07-2020,19 - 20,875,1443,7334,2166,11818
13-07-2020,20 - 21,888,1443,7134,2120,11585
13-07-2020,21 - 22,951,1437,6958,2024,11370
13-07-2020,22 - 23,893,1520,6872,1967,11252
13-07-2020,23 - 00,903,1527,6598,1851,10879
14-07-2020,00 - 01,1102,1171,6248,1761,10282
14-07-2020,01 - 02,876,1354,5973,1672,9875
14-07-2020,02 - 03,784,1292,5869,1586,9531
14-07-2020,03 - 04,894,1302,5837,1579,9612
14-07-2020,04 - 05,891,1316,5684,1582,9473
14-07-2020,05 - 06,915,1377,5792,1647,9731
14-07-2020,06 - 07,952,1526,6300,1814,10592
14-07-2020,07 - 08,969,1506,6810,2015,11300
14-07-2020,08 - 09,978,1583,7278,2169,12008
14-07-2020,09 - 10,1000,1568,7550,2205,12323
14-07-2020,10 - 11,983,1469,7728,2239,12419
14-07-2020,11 - 12,980,1494,7818,2283,12575
14-07-2020,12 - 13,1059,1533,7899,2283,12774
14-07-2020,13 - 14,962,1479,7882,2236,12559
14-07-2020,14 - 15,939,1434,7872,2204,12449
14-07-2020,15 - 16,917,1513,7764,2206,12400
14-07-2020,16 - 17,980,1489,7598,2182,12249
14-07-2020,17 - 18,937,1396,7739,2250,12322
14-07-2020,18 - 19,1015,1406,7678,2274,12373
14-07-2020,19 - 20,995,1446,7515,2279,12235
14-07-2020,20 - 21,944,1484,7316,2215,11959
14-07-2020,21 - 22,1009,1552,7072,2132,11765
14-07-2020,22 - 23,998,1440,6951,2075,11464
14-07-2020,23 - 00,998,1453,6554,1874,10879
15-07-2020,00 - 01,940,1361,6177,1752,10230
15-07-2020,01 - 02,925,1349,5973,1645,9892
15-07-2020,02 - 03,901,1408,5880,1566,9755
15-07-2020,03 - 04,821,1451,5819,1611,9702
15-07-2020,04 - 05,844,1385,5672,1586,9487
15-07-2020,05 - 06,862,1194,5734,1562,9352
15-07-2020,06 - 07,865,1268,6161,1731,10025
15-07-2020,07 - 08,787,1396,6732,1960,10875
15-07-2020,08 - 09,815,1531,7253,2173,11772
15-07-2020,09 - 10,817,1523,7504,2304,12148
15-07-2020,10 - 11,845,1582,7720,2416,12563
15-07-2020,11 - 12,862,1687,7853,2453,12855
15-07-2020,12 - 13,787,1701,7891,2417,12796
15-07-2020,13 - 14,882,1689,7839,2413,12823
15-07-2020,14 - 15,839,1669,7721,2381,12610
15-07-2020,15 - 16,860,1670,7569,2332,12431
15-07-2020,16 - 17,857,1658,7512,2283,12310
15-07-2020,17 - 18,918,1694,7568,2287,12467
15-07-2020,18 - 19,932,1626,7460,2245,12263
15-07-2020,19 - 20,965,1614,7295,2196,12070
15-07-2020,20 - 21,893,1595,7101,2127,11716
15-07-2020,21 - 22,907,1516,6896,2080,11399
15-07-2020,22 - 23,909,1535,6783,2042,11269
15-07-2020,23 - 00,889,1456,6480,1880,10705
16-07-2020,00 - 01,914,1385,6104,1787,10190
16-07-2020,01 - 02,904,1392,5901,1730,9927
16-07-2020,02 - 03,843,1389,5779,1699,9710
16-07-2020,03 - 04,841,1339,5654,1701,9535
16-07-2020,04 - 05,885,1296,5527,1722,9430
16-07-2020,05 - 06,965,1370,5667,1745,9747
16-07-2020,06 - 07,1020,1338,6179,1943,10480
16-07-2020,07 - 08,1008,1451,6787,2127,11373
16-07-2020,08 - 09,1000,1517,7273,2289,12079
16-07-2020,09 - 10,986,1577,7516,2402,12481
16-07-2020,10 - 11,1025,1528,7650,2432,12635
16-07-2020,11 - 12,1034,1513,7713,2424,12684
16-07-2020,12 - 13,1021,1512,7676,2381,12590
16-07-2020,13 - 14,996,1467,7591,2370,12424
16-07-2020,14 - 15,949,1436,7530,2347,12262
16-07-2020,15 - 16,970,1467,7462,2308,12207
16-07-2020,16 - 17,950,1443,7388,2224,12005
16-07-2020,17 - 18,969,1444,7435,2268,12116
16-07-2020,18 - 19,942,1418,7384,2285,12029
16-07-2020,19 - 20,925,1387,7193,2204,11709
16-07-2020,20 - 21,967,1376,7011,2132,11486
16-07-2020,21 - 22,905,1286,6777,2004,10972
16-07-2020,22 - 23,903,1237,6690,2009,10839
16-07-2020,23 - 00,889,1301,6352,1871,10413
17-07-2020,00 - 01,859,1393,5984,1735,9971
17-07-2020,01 - 02,927,1145,5794,1657,9523
17-07-2020,02 - 03,884,1097,5726,1604,9311
17-07-2020,03 - 04,895,957,5591,1562,9005
17-07-2020,04 - 05,859,1058,5425,1555,8897
17-07-2020,05 - 06,881,860,5550,1588,8879
17-07-2020,06 - 07,833,1012,6031,1778,9654
17-07-2020,07 - 08,845,1281,6583,1982,10691
17-07-2020,08 - 09,870,1318,7053,2120,11361
17-07-2020,09 - 10,944,1293,7317,2189,11743
17-07-2020,10 - 11,884,1214,7466,2211,11775
17-07-2020,11 - 12,932,1039,7427,2209,11607
17-07-2020,12 - 13,761,1069,7375,2199,11404
17-07-2020,13 - 14,714,1063,7191,2181,11149
17-07-2020,14 - 15,714,981,7129,2145,10969
17-07-2020,15 - 16,776,1065,7059,2126,11026
17-07-2020,16 - 17,811,1098,7030,2110,11049
17-07-2020,17 - 18,841,1195,7090,2116,11242
17-07-2020,18 - 19,840,970,6985,2118,10913
17-07-2020,19 - 20,836,865,6802,2067,10570
17-07-2020,20 - 21,865,1102,6733,2032,10732
17-07-2020,21 - 22,859,1114,6547,1997,10517
17-07-2020,22 - 23,838,1062,6428,1969,10297
17-07-2020,23 - 00,790,1073,6198,1837,9898
18-07-2020,00 - 01,798,1285,5940,1748,9771
18-07-2020,01 - 02,874,1181,5658,1679,9392
18-07-2020,02 - 03,928,1301,5528,1650,9407
18-07-2020,03 - 04,877,1401,5448,1642,9368
18-07-2020,04 - 05,814,1278,5276,1581,8949
18-07-2020,05 - 06,846,1291,5264,1549,8950
18-07-2020,06 - 07,805,1372,5361,1583,9121
18-07-2020,07 - 08,900,1404,5638,1674,9616
18-07-2020,08 - 09,960,1545,6154,1802,10461
18-07-2020,09 - 10,838,1490,6488,1893,10709
18-07-2020,10 - 11,853,1569,6678,1933,11033
18-07-2020,11 - 12,860,1592,6854,1959,11265
18-07-2020,12 - 13,935,1569,6910,1954,11368
18-07-2020,13 - 14,897,1552,6851,1952,11252
18-07-2020,14 - 15,892,1584,6768,1901,11145
18-07-2020,15 - 16,944,1530,6687,1869,11030
18-07-2020,16 - 17,898,1393,6653,1889,10833
18-07-2020,17 - 18,939,1425,6742,1923,11029
18-07-2020,18 - 19,883,1283,6807,1971,10944
18-07-2020,19 - 20,856,1345,6713,1947,10861
18-07-2020,20 - 21,888,1399,6546,1903,10736
18-07-2020,21 - 22,944,1257,6356,1888,10445
18-07-2020,22 - 23,955,1146,6268,1860,10229
18-07-2020,23 - 00,922,1119,5882,1742,9665
19-07-2020,00 - 01,852,1003,5525,1618,8998
19-07-2020,01 - 02,805,1124,5391,1524,8844
19-07-2020,02 - 03,812,1089,5253,1492,8646
19-07-2020,03 - 04,805,967,5008,1483,8263
19-07-2020,04 - 05,810,1077,4797,1490,8174
19-07-2020,05 - 06,758,1069,4778,1490,8095
19-07-2020,06 - 07,816,1196,5049,1495,8556
19-07-2020,07 - 08,836,1305,5469,1613,9223
19-07-2020,08 - 09,956,1306,5828,1770,9860
19-07-2020,09 - 10,1037,1324,6175,1879,10415
19-07-2020,10 - 11,1043,1487,6495,1969,10994
19-07-2020,11 - 12,1021,1517,6619,1990,11147
19-07-2020,12 - 13,1044,1440,6711,2004,11199
19-07-2020,13 - 14,960,1293,6731,1992,10976
19-07-2020,14 - 15,944,1395,6605,1957,10901
19-07-2020,15 - 16,924,1352,6525,1917,10718
19-07-2020,16 - 17,980,1434,6629,1952,10995
19-07-2020,17 - 18,1032,1484,6853,2009,11378
19-07-2020,18 - 19,912,1386,6957,2028,11283
19-07-2020,19 - 20,914,1429,6962,1958,11263
19-07-2020,20 - 21,949,1433,6825,1907,11114
19-07-2020,21 - 22,1013,1459,6590,1870,10932
19-07-2020,22 - 23,931,1389,6552,1869,10741
19-07-2020,23 - 00,682,1208,6136,1762,9788
20-07-2020,00 - 01,926,1006,5821,1672,9425
20-07-2020,01 - 02,695,1037,5552,1587,8871
20-07-2020,02 - 03,870,1058,5491,1567,8986
20-07-2020,03 - 04,872,1187,5527,1544,9130
20-07-2020,04 - 05,870,1238,5490,1534,9132
20-07-2020,05 - 06,822,1234,5599,1536,9191
20-07-2020,06 - 07,784,1456,6022,1705,9967
20-07-2020,07 - 08,858,1500,6568,1927,10853
20-07-2020,08 - 09,993,1578,7118,2031,11720
20-07-2020,09 - 10,970,1580,7412,2158,12120
20-07-2020,10 - 11,954,1577,7672,2290,12493
20-07-2020,11 - 12,1013,1563,7738,2394,12708
20-07-2020,12 - 13,946,1631,7733,2339,12649
20-07-2020,13 - 14,914,1629,7588,2259,12390
20-07-2020,14 - 15,804,1480,7428,2172,11884
20-07-2020,15 - 16,920,1460,7353,2144,11877
20-07-2020,16 - 17,863,1479,7130,2073,11545
20-07-2020,17 - 18,922,1376,7110,2108,11516
20-07-2020,18 - 19,968,1299,7080,2141,11488
20-07-2020,19 - 20,995,1298,7002,2150,11445
20-07-2020,20 - 21,1020,1292,6834,2157,11303
20-07-2020,21 - 22,952,1264,6535,2116,10867
20-07-2020,22 - 23,913,1229,6335,2086,10563
20-07-2020,23 - 00,857,1145,5974,1868,9844
21-07-2020,00 - 01,596,1337,5742,1764,9439
21-07-2020,01 - 02,857,1387,5551,1690,9485
21-07-2020,02 - 03,795,1371,5480,1663,9309
21-07-2020,03 - 04,811,1163,5429,1669,9072
21-07-2020,04 - 05,823,1074,5172,1646,8715
21-07-2020,05 - 06,868,1124,5173,1664,8829
21-07-2020,06 - 07,943,1185,5582,1884,9594
21-07-2020,07 - 08,968,1297,6222,2039,10526
21-07-2020,08 - 09,980,1396,6719,2090,11185
21-07-2020,09 - 10,932,1416,6986,2263,11597
21-07-2020,10 - 11,963,1465,7118,2311,11857
21-07-2020,11 - 12,918,1495,7203,2258,11874
21-07-2020,12 - 13,899,1493,7273,2296,11961
21-07-2020,13 - 14,952,1533,7263,2227,11975
21-07-2020,14 - 15,906,1564,7230,2240,11940
21-07-2020,15 - 16,948,1478,7156,2226,11808
21-07-2020,16 - 17,969,1333,7037,2184,11523
21-07-2020,17 - 18,1112,1523,7187,2155,11977
21-07-2020,18 - 19,988,1510,7140,2192,11830
21-07-2020,19 - 20,878,1548,7045,2196,11667
21-07-2020,20 - 21,880,1359,6861,2232,11332
21-07-2020,21 - 22,911,1348,6724,2161,11144
21-07-2020,22 - 23,1014,1162,6445,2108,10729
21-07-2020,23 - 00,1061,1100,6054,1955,10170
22-07-2020,00 - 01,936,1178,5683,1847,9644
22-07-2020,01 - 02,873,1160,5543,1781,9357
22-07-2020,02 - 03,843,1273,5484,1705,9305
22-07-2020,03 - 04,892,1176,5443,1709,9220
22-07-2020,04 - 05,898,1112,5317,1664,8991
22-07-2020,05 - 06,839,1294,5434,1698,9265
22-07-2020,06 - 07,791,1301,5974,1948,10014
22-07-2020,07 - 08,818,1516,6620,2149,11103
22-07-2020,08 - 09,853,1451,7040,2206,11550
22-07-2020,09 - 10,942,1405,7217,2271,11835
22-07-2020,10 - 11,959,1497,7366,2285,12107
22-07-2020,11 - 12,887,1521,7331,2324,12063
22-07-2020,12 - 13,859,1389,7230,2291,11769
22-07-2020,13 - 14,832,1577,7245,2268,11922
22-07-2020,14 - 15,734,1494,7260,2249,11737
22-07-2020,15 - 16,785,1538,7214,2231,11768
22-07-2020,16 - 17,934,1569,7172,2275,11950
22-07-2020,17 - 18,950,1443,7232,2346,11971
22-07-2020,18 - 19,949,1354,7163,2284,11750
22-07-2020,19 - 20,1010,1339,7040,2251,11640
22-07-2020,20 - 21,962,1560,6889,2214,11625
22-07-2020,21 - 22,952,1565,6794,2150,11461
22-07-2020,22 - 23,932,1414,6608,2066,11020
22-07-2020,23 - 00,938,1319,6225,1956,10438
23-07-2020,00 - 01,875,1166,5922,1814,9777
23-07-2020,01 - 02,861,1197,5741,1685,9484
23-07-2020,02 - 03,826,1170,5637,1646,9279
23-07-2020,03 - 04,835,1237,5675,1666,9413
23-07-2020,04 - 05,826,1224,5693,1678,9421
23-07-2020,05 - 06,745,1141,5825,1743,9454
23-07-2020,06 - 07,788,1295,6299,1907,10289
23-07-2020,07 - 08,839,1472,6773,2122,11206
23-07-2020,08 - 09,895,1499,7075,2177,11646
23-07-2020,09 - 10,932,1584,7220,2210,11946
23-07-2020,10 - 11,948,1564,7354,2252,12118
23-07-2020,11 - 12,931,1735,7474,2312,12452
23-07-2020,12 - 13,935,1666,7449,2304,12354
23-07-2020,13 - 14,996,1648,7435,2252,12331
23-07-2020,14 - 15,1023,1625,7344,2190,12182
23-07-2020,15 - 16,1017,1560,7162,2191,11930
23-07-2020,16 - 17,895,1547,7071,2242,11755
23-07-2020,17 - 18,776,1438,7188,2326,11728
23-07-2020,18 - 19,986,1535,7099,2299,11919
23-07-2020,19 - 20,969,1446,6992,2192,11599
23-07-2020,20 - 21,1034,1458,6949,2161,11602
23-07-2020,21 - 22,1042,1451,6758,2162,11413
23-07-2020,22 - 23,896,1483,6485,2024,10888
23-07-2020,23 - 00,765,1398,6132,1862,10157
24-07-2020,00 - 01,801,1261,5817,1712,9591
24-07-2020,01 - 02,852,1130,5628,1699,9309
24-07-2020,02 - 03,927,1102,5631,1703,9363
24-07-2020,03 - 04,980,1163,5609,1711,9463
24-07-2020,04 - 05,901,1206,5548,1737,9392
24-07-2020,05 - 06,871,1275,5604,1685,9435
24-07-2020,06 - 07,950,1195,5953,1813,9911
24-07-2020,07 - 08,994,1325,6607,2100,11026
24-07-2020,08 - 09,1039,1460,7101,2360,11960
24-07-2020,09 - 10,1068,1503,7367,2407,12345
24-07-2020,10 - 11,953,1612,7587,2492,12644
24-07-2020,11 - 12,1090,1670,7682,2534,12976
24-07-2020,12 - 13,988,1524,7684,2369,12565
24-07-2020,13 - 14,989,1497,7677,2339,12502
24-07-2020,14 - 15,1038,1579,7612,2332,12561
24-07-2020,15 - 16,943,1631,7501,2246,12321
24-07-2020,16 - 17,993,1625,7393,2108,12119
24-07-2020,17 - 18,1007,1564,7384,2085,12040
24-07-2020,18 - 19,1081,1641,7281,2115,12118
24-07-2020,19 - 20,943,1609,7047,2052,11651
24-07-2020,20 - 21,934,1604,6855,2020,11413
24-07-2020,21 - 22,964,1466,6685,2016,11131
24-07-2020,22 - 23,1004,1483,6522,2002,11011
24-07-2020,23 - 00,810,1513,6137,1868,10328
25-07-2020,00 - 01,892,1427,5834,1721,9874
25-07-2020,01 - 02,969,1367,5642,1619,9597
25-07-2020,02 - 03,980,1263,5571,1579,9393
25-07-2020,03 - 04,853,1334,5581,1571,9339
25-07-2020,04 - 05,867,1303,5452,1548,9170
25-07-2020,05 - 06,885,1313,5331,1485,9014
25-07-2020,06 - 07,906,1291,5386,1572,9155
25-07-2020,07 - 08,800,1410,5638,1718,9566
25-07-2020,08 - 09,814,1516,6067,1885,10282
25-07-2020,09 - 10,913,1586,6414,1974,10887
25-07-2020,10 - 11,961,1477,6590,1989,11017
25-07-2020,11 - 12,914,1460,6563,1970,10907
25-07-2020,12 - 13,901,1469,6491,1976,10837
25-07-2020,13 - 14,869,1500,6446,1958,10773
25-07-2020,14 - 15,802,1481,6432,1949,10664
25-07-2020,15 - 16,820,1448,6344,1917,10529
25-07-2020,16 - 17,1006,1402,6493,1962,10863
25-07-2020,17 - 18,1043,1442,6663,2035,11183
25-07-2020,18 - 19,1091,1430,6689,2034,11244
25-07-2020,19 - 20,1030,1441,6671,1992,11134
25-07-2020,20 - 21,1051,1454,6555,1985,11045
25-07-2020,21 - 22,985,1425,6413,1974,10797
25-07-2020,22 - 23,961,1386,6401,1903,10651
25-07-2020,23 - 00,954,1386,6108,1776,10224
26-07-2020,00 - 01,899,1260,5797,1701,9657
26-07-2020,01 - 02,950,1231,5616,1623,9420
26-07-2020,02 - 03,942,1116,5497,1624,9179
26-07-2020,03 - 04,941,1012,5440,1628,9021
26-07-2020,04 - 05,912,1110,5238,1554,8814
26-07-2020,05 - 06,858,1116,5064,1432,8470
26-07-2020,06 - 07,1075,1035,5099,1431,8640
26-07-2020,07 - 08,1102,1183,5325,1529,9139
26-07-2020,08 - 09,994,1433,5734,1786,9947
26-07-2020,09 - 10,1073,1405,6084,1974,10536
26-07-2020,10 - 11,1004,1297,6355,2122,10778
26-07-2020,11 - 12,1005,1374,6526,2158,11063
26-07-2020,12 - 13,1025,1518,6666,2178,11387
26-07-2020,13 - 14,1037,1409,6634,2165,11245
26-07-2020,14 - 15,983,1269,6522,2156,10930
26-07-2020,15 - 16,1026,1312,6537,2083,10958
26-07-2020,16 - 17,1048,1531,6665,2148,11392
26-07-2020,17 - 18,919,1500,6830,2236,11485
26-07-2020,18 - 19,940,1478,6965,2185,11568
26-07-2020,19 - 20,1033,1368,6949,2149,11499
26-07-2020,20 - 21,866,1365,6958,2082,11271
26-07-2020,21 - 22,861,1187,6845,2088,10981
26-07-2020,22 - 23,762,1144,6696,2024,10626
26-07-2020,23 - 00,728,1264,6147,1880,10019
27-07-2020,00 - 01,707,1117,5697,1741,9262
27-07-2020,01 - 02,767,937,5503,1654,8861
27-07-2020,02 - 03,954,1077,5371,1612,9014
27-07-2020,03 - 04,1009,1039,5403,1606,9057
27-07-2020,04 - 05,880,980,5245,1607,8712
27-07-2020,05 - 06,899,993,5343,1606,8841
27-07-2020,06 - 07,962,1110,5945,1803,9820
27-07-2020,07 - 08,1153,1115,6678,2086,11032
27-07-2020,08 - 09,1140,1399,7119,2245,11903
27-07-2020,09 - 10,940,1467,7429,2294,12130
27-07-2020,10 - 11,812,1513,7662,2343,12330
27-07-2020,11 - 12,849,1657,7764,2366,12636
27-07-2020,12 - 13,988,1414,7875,2335,12612
27-07-2020,13 - 14,965,1327,7802,2288,12382
27-07-2020,14 - 15,935,1410,7681,2254,12280
27-07-2020,15 - 16,1077,1475,7674,2256,12482
27-07-2020,16 - 17,984,1535,7670,2204,12393
27-07-2020,17 - 18,976,1474,7769,2235,12454
27-07-2020,18 - 19,932,1504,7605,2218,12259
27-07-2020,19 - 20,884,1431,7441,2193,11949
27-07-2020,20 - 21,774,1450,7324,2160,11708
27-07-2020,21 - 22,795,1394,7138,2065,11392
27-07-2020,22 - 23,976,1281,6915,1845,11017
27-07-2020,23 - 00,890,1247,6443,1674,10254
28-07-2020,00 - 01,695,1212,6006,1670,9583
28-07-2020,01 - 02,971,1341,5732,1619,9663
28-07-2020,02 - 03,1034,1333,5717,1636,9720
28-07-2020,03 - 04,983,1305,5749,1626,9663
28-07-2020,04 - 05,952,1279,5681,1659,9571
28-07-2020,05 - 06,903,1142,5728,1686,9459
28-07-2020,06 - 07,886,1249,6219,1874,10228
28-07-2020,07 - 08,968,1424,6827,2188,11407
28-07-2020,08 - 09,940,1461,7346,2258,12005
28-07-2020,09 - 10,963,1527,7735,2352,12577
28-07-2020,10 - 11,903,1588,7889,2472,12852
28-07-2020,11 - 12,1083,1490,8004,2451,13028
28-07-2020,12 - 13,1160,1453,8071,2360,13044
28-07-2020,13 - 14,1090,1320,7972,2193,12575
28-07-2020,14 - 15,1008,970,7892,2169,12039
28-07-2020,15 - 16,1111,1321,7771,2185,12388
28-07-2020,16 - 17,1141,1471,7694,2178,12484
28-07-2020,17 - 18,1196,1515,7717,2199,12627
28-07-2020,18 - 19,1133,1372,7620,2151,12276
28-07-2020,19 - 20,1005,1280,7530,2168,11983
28-07-2020,20 - 21,969,1275,7396,2089,11729
28-07-2020,21 - 22,1112,1287,7241,2072,11712
28-07-2020,22 - 23,1238,1377,6894,1987,11496
28-07-2020,23 - 00,952,1319,6525,1838,10634
29-07-2020,00 - 01,865,1189,6220,1784,10058
29-07-2020,01 - 02,986,1218,6006,1712,9922
29-07-2020,02 - 03,1057,1193,5911,1663,9824
29-07-2020,03 - 04,1054,1121,5780,1652,9607
29-07-2020,04 - 05,978,972,5700,1629,9279
29-07-2020,05 - 06,1001,843,5763,1634,9241
29-07-2020,06 - 07,979,1094,6289,1860,10222
29-07-2020,07 - 08,1042,1455,6996,2151,11644
29-07-2020,08 - 09,939,1706,7396,2287,12328
29-07-2020,09 - 10,976,1626,7647,2320,12569
29-07-2020,10 - 11,921,1564,7837,2414,12736
29-07-2020,11 - 12,967,1704,8025,2471,13167
29-07-2020,12 - 13,928,1650,8032,2458,13068
29-07-2020,13 - 14,761,1658,7940,2441,12800
29-07-2020,14 - 15,991,1692,7860,2404,12947
29-07-2020,15 - 16,1120,1483,7773,2382,12758
29-07-2020,16 - 17,842,1583,7637,2285,12347
29-07-2020,17 - 18,1078,1708,7591,2358,12735
29-07-2020,18 - 19,1154,1556,7614,2356,12680
29-07-2020,19 - 20,1166,1600,7455,2274,12495
29-07-2020,20 - 21,1142,1594,7205,2227,12168
29-07-2020,21 - 22,1167,1485,6986,2239,11877
29-07-2020,22 - 23,1119,1429,6811,2147,11506
29-07-2020,23 - 00,1025,1451,6583,1984,11043
30-07-2020,00 - 01,969,1453,6361,1829,10612
30-07-2020,01 - 02,770,1459,6259,1754,10242
30-07-2020,02 - 03,839,1337,6091,1736,10003
30-07-2020,03 - 04,896,1219,6108,1731,9954
30-07-2020,04 - 05,986,1116,5996,1718,9816
30-07-2020,05 - 06,1032,1087,6088,1755,9962
30-07-2020,06 - 07,1105,994,6605,1931,10635
30-07-2020,07 - 08,1020,1139,7304,2160,11623
30-07-2020,08 - 09,971,1238,7795,2353,12357
30-07-2020,09 - 10,1033,1282,8073,2443,12831
30-07-2020,10 - 11,993,1401,8113,2520,13027
30-07-2020,11 - 12,1009,1331,8130,2526,12996
30-07-2020,12 - 13,998,1222,8067,2534,12821
30-07-2020,13 - 14,1085,1346,7938,2525,12894
30-07-2020,14 - 15,1078,1444,7813,2503,12838
30-07-2020,15 - 16,1155,1481,7886,2494,13016
30-07-2020,16 - 17,1268,1598,7886,2499,13251
30-07-2020,17 - 18,1253,1627,7904,2499,13283
30-07-2020,18 - 19,1151,1658,7798,2462,13069
30-07-2020,19 - 20,1020,1795,7726,2351,12892
30-07-2020,20 - 21,779,1781,7645,2295,12500
30-07-2020,21 - 22,970,1767,7517,2238,12492
30-07-2020,22 - 23,1085,1649,7186,2136,12056
30-07-2020,23 - 00,1026,1617,6803,1976,11422
31-07-2020,00 - 01,1048,1384,6665,1875,10972
31-07-2020,01 - 02,1018,1453,6290,1800,10561
31-07-2020,02 - 03,996,1472,6078,1817,10363
31-07-2020,03 - 04,879,1514,6141,1823,10357
31-07-2020,04 - 05,834,1356,6075,1840,10105
31-07-2020,05 - 06,834,1291,6061,1833,10019
31-07-2020,06 - 07,905,1241,6907,1939,10992
31-07-2020,07 - 08,966,1382,7271,2198,11817
31-07-2020,08 - 09,967,1754,7911,2319,12951
31-07-2020,09 - 10,874,1726,8138,2395,13133
31-07-2020,10 - 11,881,1704,8230,2429,13244
31-07-2020,11 - 12,934,1620,8276,2431,13261
31-07-2020,12 - 13,976,1517,8243,2391,13127
31-07-2020,13 - 14,978,1584,8035,2321,12918
31-07-2020,14 - 15,1021,1493,7828,2274,12616
31-07-2020,15 - 16,1019,1368,7759,2235,12381
31-07-2020,16 - 17,922,1407,7747,2200,12276
31-07-2020,17 - 18,959,1581,7789,2228,12557
31-07-2020,18 - 19,1050,1562,7703,2236,12551
31-07-2020,19 - 20,1034,1430,7505,2161,12130
31-07-2020,20 - 21,999,1617,7320,2090,12026
31-07-2020,21 - 22,991,1611,7232,2046,11880
31-07-2020,22 - 23,947,1584,7169,1966,11666
31-07-2020,23 - 00,936,1403,6792,1846,10977
01-08-2020,00 - 01,921,1319,6466,1724,10430
01-08-2020,01 - 02,962,1332,6217,1641,10152
01-08-2020,02 - 03,949,1309,6130,1599,9987
01-08-2020,03 - 04,855,1356,6124,1611,9946
01-08-2020,04 - 05,850,1331,5988,1608,9777
01-08-2020,05 - 06,826,1289,5868,1567,9550
01-08-2020,06 - 07,930,1221,5979,1602,9732
01-08-2020,07 - 08,893,1326,6188,1725,10132
01-08-2020,08 - 09,931,1378,6647,1879,10835
01-08-2020,09 - 10,961,1389,6963,1948,11261
01-08-2020,10 - 11,935,1451,7114,1992,11492
01-08-2020,11 - 12,926,1433,7115,2010,11484
01-08-2020,12 - 13,949,1377,7243,1974,11543
01-08-2020,13 - 14,906,1367,7245,1938,11456
01-08-2020,14 - 15,936,1398,7056,1886,11276
01-08-2020,15 - 16,898,1400,7217,1861,11376
01-08-2020,16 - 17,929,1453,6898,1908,11188
01-08-2020,17 - 18,878,1469,6890,1955,11192
01-08-2020,18 - 19,903,1500,7010,1968,11381
01-08-2020,19 - 20,800,1432,6908,1968,11108
01-08-2020,20 - 21,880,1355,6934,1941,11110
01-08-2020,21 - 22,818,1267,6947,1895,10927
01-08-2020,22 - 23,948,1224,6906,1840,10918
01-08-2020,23 - 00,883,1274,6599,1729,10485
02-08-2020,00 - 01,771,1183,6341,1665,9960
02-08-2020,01 - 02,839,1222,6134,1586,9781
02-08-2020,02 - 03,872,1226,6031,1551,9680
02-08-2020,03 - 04,840,1273,5920,1496,9529
02-08-2020,04 - 05,829,1321,5772,1456,9378
02-08-2020,05 - 06,821,1227,5618,1372,9038
02-08-2020,06 - 07,809,1233,5684,1394,9120
02-08-2020,07 - 08,853,1263,6013,1617,9746
02-08-2020,08 - 09,938,1481,6560,1755,10734
02-08-2020,09 - 10,977,1431,6951,1871,11230
02-08-2020,10 - 11,994,1444,7323,1940,11701
02-08-2020,11 - 12,939,1293,7495,2003,11730
02-08-2020,12 - 13,879,1350,7592,2045,11866
02-08-2020,13 - 14,881,1483,7551,2052,11967
02-08-2020,14 - 15,979,1517,7592,2062,12150
02-08-2020,15 - 16,923,1417,7487,2039,11866
02-08-2020,16 - 17,964,1371,7384,2067,11786
02-08-2020,17 - 18,951,1455,7512,2076,11994
02-08-2020,18 - 19,911,1464,7463,2114,11952
02-08-2020,19 - 20,964,1612,7515,2062,12153
02-08-2020,20 - 21,1045,1573,7353,2019,11990
02-08-2020,21 - 22,805,1541,7254,2023,11623
02-08-2020,22 - 23,973,1634,7133,1996,11736
02-08-2020,23 - 00,933,1387,6799,1858,10977
03-08-2020,00 - 01,909,1388,6367,1661,10325
03-08-2020,01 - 02,872,1426,6146,1600,10044
03-08-2020,02 - 03,843,1349,6099,1560,9851
03-08-2020,03 - 04,821,1337,6153,1570,9881
03-08-2020,04 - 05,815,1271,6242,1601,9929
03-08-2020,05 - 06,773,1269,6344,1614,10000
03-08-2020,06 - 07,855,1233,6956,1869,10913
03-08-2020,07 - 08,925,1493,7690,2220,12328
03-08-2020,08 - 09,942,1516,8234,2406,13098
03-08-2020,09 - 10,953,1711,8380,2477,13521
03-08-2020,10 - 11,943,1954,8515,2555,13967
03-08-2020,11 - 12,950,2023,8609,2579,14161
03-08-2020,12 - 13,992,1888,8564,2544,13988
03-08-2020,13 - 14,974,1600,8472,2537,13583
03-08-2020,14 - 15,993,1734,8341,2500,13568
03-08-2020,15 - 16,1024,1572,8165,2467,13228
03-08-2020,16 - 17,969,1389,8061,2397,12816
03-08-2020,17 - 18,948,1316,8003,2420,12687
03-08-2020,18 - 19,924,1351,8023,2372,12670
03-08-2020,19 - 20,939,1368,7913,2317,12537
03-08-2020,20 - 21,935,1372,7840,2245,12392
03-08-2020,21 - 22,965,1538,7629,2189,12321
03-08-2020,22 - 23,950,1545,7365,2075,11935
03-08-2020,23 - 00,1000,1556,6984,1845,11385
04-08-2020,00 - 01,1057,1224,6665,1723,10669
04-08-2020,01 - 02,1071,1266,6433,1705,10475
04-08-2020,02 - 03,925,1152,6358,1598,10033
04-08-2020,03 - 04,944,1112,6252,1588,9896
04-08-2020,04 - 05,925,1201,6250,1648,10024
04-08-2020,05 - 06,917,1400,6304,1691,10312
04-08-2020,06 - 07,956,1548,6962,1889,11355
04-08-2020,07 - 08,978,1617,7725,2250,12570
04-08-2020,08 - 09,966,1758,8121,2405,13250
04-08-2020,09 - 10,962,1748,8249,2426,13385
04-08-2020,10 - 11,1013,1705,8332,2437,13487
04-08-2020,11 - 12,1046,1683,8354,2459,13542
04-08-2020,12 - 13,1030,1714,8297,2428,13469
04-08-2020,13 - 14,1110,1708,8201,2408,13427
04-08-2020,14 - 15,1068,1638,8109,2382,13197
04-08-2020,15 - 16,1022,1626,7993,2372,13013
04-08-2020,16 - 17,1039,1565,7968,2293,12865
04-08-2020,17 - 18,1023,1548,7973,2296,12840
04-08-2020,18 - 19,1026,1632,7820,2291,12769
04-08-2020,19 - 20,1132,1594,7840,2271,12837
04-08-2020,20 - 21,1195,1618,7838,2194,12845
04-08-2020,21 - 22,1107,1593,7748,2139,12587
04-08-2020,22 - 23,1031,1588,7465,2015,12099
04-08-2020,23 - 00,967,1521,6986,1852,11326
05-08-2020,00 - 01,1100,1362,6655,1708,10825
05-08-2020,01 - 02,1046,1337,6513,1624,10520
05-08-2020,02 - 03,1115,1310,6466,1642,10533
05-08-2020,03 - 04,1095,1441,6522,1692,10750
05-08-2020,04 - 05,1042,1478,6545,1755,10820
05-08-2020,05 - 06,1025,1436,6664,1777,10902
05-08-2020,06 - 07,1185,1440,7303,1959,11887
05-08-2020,07 - 08,1171,1465,7949,2259,12844
05-08-2020,08 - 09,1142,1603,8392,2462,13599
05-08-2020,09 - 10,1020,1649,8613,2534,13816
05-08-2020,10 - 11,1002,1702,8702,2575,13981
05-08-2020,11 - 12,1031,1456,8800,2618,13905
05-08-2020,12 - 13,1138,1456,8745,2653,13992
05-08-2020,13 - 14,1079,1565,8753,2686,14083
05-08-2020,14 - 15,985,1415,8752,2624,13776
05-08-2020,15 - 16,1163,1434,8713,2638,13948
05-08-2020,16 - 17,1300,1317,8617,2594,13828
05-08-2020,17 - 18,1086,1378,8707,2547,13718
05-08-2020,18 - 19,1052,1279,8569,2530,13430
05-08-2020,19 - 20,879,1253,8263,2434,12829
05-08-2020,20 - 21,1044,1236,8007,2365,12652
05-08-2020,21 - 22,955,1379,7979,2314,12627
05-08-2020,22 - 23,964,1443,7536,2168,12111
05-08-2020,23 - 00,988,1418,7084,1960,11450
06-08-2020,00 - 01,984,1250,6750,1865,10849
06-08-2020,01 - 02,1035,1269,6397,1757,10458
06-08-2020,02 - 03,1029,1248,6304,1701,10282
06-08-2020,03 - 04,1060,1271,6267,1724,10322
06-08-2020,04 - 05,1055,1420,6432,1731,10638
06-08-2020,05 - 06,1056,1393,6591,1737,10777
06-08-2020,06 - 07,1079,1378,7172,1991,11620
06-08-2020,07 - 08,1024,1600,7951,2311,12886
06-08-2020,08 - 09,1041,1776,8501,2539,13857
06-08-2020,09 - 10,1115,1763,8743,2605,14226
06-08-2020,10 - 11,1074,1727,8994,2644,14439
06-08-2020,11 - 12,1065,1745,9023,2629,14462
06-08-2020,12 - 13,1050,1692,8971,2588,14301
06-08-2020,13 - 14,1054,1594,8860,2533,14041
06-08-2020,14 - 15,1038,1687,8973,2518,14216
06-08-2020,15 - 16,1009,1718,8908,2511,14146
06-08-2020,16 - 17,1009,1679,8698,2443,13829
06-08-2020,17 - 18,1083,1610,8606,2440,13739
06-08-2020,18 - 19,1012,1654,8406,2408,13480
06-08-2020,19 - 20,1008,1708,8262,2352,13330
06-08-2020,20 - 21,1054,1681,8146,2260,13141
06-08-2020,21 - 22,1071,1593,8006,2252,12922
06-08-2020,22 - 23,1038,1411,7680,2179,12308
06-08-2020,23 - 00,959,1372,7173,1971,11475
07-08-2020,00 - 01,986,1314,6646,1844,10790
07-08-2020,01 - 02,958,1369,6449,1782,10558
07-08-2020,02 - 03,1067,1401,6297,1744,10509
07-08-2020,03 - 04,1048,1349,6253,1779,10429
07-08-2020,04 - 05,1010,1362,6263,1766,10401
07-08-2020,05 - 06,979,1349,6324,1759,10411
07-08-2020,06 - 07,995,1433,6971,1957,11356
07-08-2020,07 - 08,982,1540,7752,2250,12524
07-08-2020,08 - 09,989,1638,8321,2452,13400
07-08-2020,09 - 10,1014,1673,8760,2524,13971
07-08-2020,10 - 11,1012,1619,8969,2601,14201
07-08-2020,11 - 12,968,1580,8932,2584,14064
07-08-2020,12 - 13,1057,1478,8809,2505,13849
07-08-2020,13 - 14,1052,1401,8662,2441,13556
07-08-2020,14 - 15,998,1372,8517,2381,13268
07-08-2020,15 - 16,1047,1367,8336,2315,13065
07-08-2020,16 - 17,1116,1332,8221,2285,12954
07-08-2020,17 - 18,1151,1438,8330,2302,13221
07-08-2020,18 - 19,1074,1353,8228,2276,12931
07-08-2020,19 - 20,1053,1347,8022,2185,12607
07-08-2020,20 - 21,1055,1334,7746,2100,12235
07-08-2020,21 - 22,1042,1323,7551,2050,11966
07-08-2020,22 - 23,1086,1203,7168,1950,11407
07-08-2020,23 - 00,944,1108,6757,1828,10637
08-08-2020,00 - 01,918,1159,6446,1720,10243
08-08-2020,01 - 02,1007,1114,6186,1643,9950
08-08-2020,02 - 03,999,1164,6102,1619,9884
08-08-2020,03 - 04,1016,1140,6032,1591,9779
08-08-2020,04 - 05,994,1170,5960,1570,9694
08-08-2020,05 - 06,933,1112,5846,1509,9400
08-08-2020,06 - 07,932,1084,6011,1538,9565
08-08-2020,07 - 08,975,1160,6356,1698,10189
08-08-2020,08 - 09,1087,1314,7028,1898,11327
08-08-2020,09 - 10,1099,1323,7428,2047,11897
08-08-2020,10 - 11,1050,1191,7648,2110,11999
08-08-2020,11 - 12,1020,1222,7745,2141,12128
08-08-2020,12 - 13,1006,1266,7668,2135,12075
08-08-2020,13 - 14,1012,1287,7617,2109,12025
08-08-2020,14 - 15,982,1454,7564,2085,12085
08-08-2020,15 - 16,946,1553,7495,2061,12055
08-08-2020,16 - 17,1027,1543,7615,2100,12285
08-08-2020,17 - 18,1002,1638,7783,2102,12525
08-08-2020,18 - 19,1041,1600,7792,2106,12539
08-08-2020,19 - 20,1026,1539,7670,2082,12317
08-08-2020,20 - 21,946,1262,7509,2016,11733
08-08-2020,21 - 22,790,1120,7447,2027,11384
08-08-2020,22 - 23,789,1205,7234,1941,11169
08-08-2020,23 - 00,820,1199,6870,1860,10749
09-08-2020,00 - 01,926,1062,6517,1745,10250
09-08-2020,01 - 02,929,1084,6289,1661,9963
09-08-2020,02 - 03,939,1032,6186,1627,9784
09-08-2020,03 - 04,945,912,6159,1610,9626
09-08-2020,04 - 05,817,998,6131,1566,9512
09-08-2020,05 - 06,829,947,5954,1510,9240
09-08-2020,06 - 07,927,1054,5956,1522,9459
09-08-2020,07 - 08,923,1350,6293,1637,10203
09-08-2020,08 - 09,999,1324,6817,1829,10969
09-08-2020,09 - 10,981,1452,7146,1974,11553
09-08-2020,10 - 11,940,1458,7454,2056,11908
09-08-2020,11 - 12,923,1285,7620,2097,11925
09-08-2020,12 - 13,963,1294,7634,2116,12007
09-08-2020,13 - 14,961,1174,7567,2083,11785
09-08-2020,14 - 15,1000,1302,7487,2041,11830
09-08-2020,15 - 16,976,1277,7462,2011,11726
09-08-2020,16 - 17,1014,1259,7547,2038,11858
09-08-2020,17 - 18,1005,1443,7753,2111,12312
09-08-2020,18 - 19,1055,1455,7896,2123,12529
09-08-2020,19 - 20,1012,1479,7838,2139,12468
09-08-2020,20 - 21,876,1458,7741,2151,12226
09-08-2020,21 - 22,813,1315,7713,2153,11994
09-08-2020,22 - 23,876,1252,7487,2078,11693
09-08-2020,23 - 00,910,1314,6946,1937,11107
10-08-2020,00 - 01,865,1309,6686,1786,10646
10-08-2020,01 - 02,777,1337,6380,1726,10220
10-08-2020,02 - 03,869,1283,6329,1678,10159
10-08-2020,03 - 04,883,1196,6270,1647,9996
10-08-2020,04 - 05,902,1216,6267,1656,10041
10-08-2020,05 - 06,1000,1201,6458,1695,10354
10-08-2020,06 - 07,1069,1378,7296,1946,11689
10-08-2020,07 - 08,1078,1594,8109,2286,13067
10-08-2020,08 - 09,1162,1693,8574,2426,13855
10-08-2020,09 - 10,1087,1594,8750,2517,13948
10-08-2020,10 - 11,1116,1590,8884,2584,14174
10-08-2020,11 - 12,1095,1620,8919,2635,14269
10-08-2020,12 - 13,1096,1574,9050,2641,14361
10-08-2020,13 - 14,1103,1652,9072,2722,14549
10-08-2020,14 - 15,1122,1625,9100,2706,14553
10-08-2020,15 - 16,1097,1584,9133,2611,14425
10-08-2020,16 - 17,1145,1599,8914,2553,14211
10-08-2020,17 - 18,1107,1611,8995,2554,14267
10-08-2020,18 - 19,1136,1627,8811,2533,14107
10-08-2020,19 - 20,1002,1589,8572,2469,13632
10-08-2020,20 - 21,1131,1524,8420,2388,13463
10-08-2020,21 - 22,1102,1404,8219,2392,13117
10-08-2020,22 - 23,1127,1343,7736,2283,12489
10-08-2020,23 - 00,1097,1245,7251,2112,11705
11-08-2020,00 - 01,1107,1273,6856,1940,11176
11-08-2020,01 - 02,1078,1232,6620,1843,10773
11-08-2020,02 - 03,1091,1116,6544,1815,10566
11-08-2020,03 - 04,1019,1059,6589,1796,10463
11-08-2020,04 - 05,990,1048,6644,1824,10506
11-08-2020,05 - 06,990,1022,6815,1891,10718
11-08-2020,06 - 07,1085,1151,7594,2120,11950
11-08-2020,07 - 08,1138,1355,8381,2402,13276
11-08-2020,08 - 09,1104,1586,8803,2533,14026
11-08-2020,09 - 10,1026,1614,8953,2585,14178
11-08-2020,10 - 11,999,1617,9075,2658,14349
11-08-2020,11 - 12,1014,1596,9214,2672,14496
11-08-2020,12 - 13,1024,1651,9170,2640,14485
11-08-2020,13 - 14,1015,1648,9135,2629,14427
11-08-2020,14 - 15,1011,1680,9104,2595,14390
11-08-2020,15 - 16,1026,1586,9136,2570,14318
11-08-2020,16 - 17,984,1569,8984,2520,14057
11-08-2020,17 - 18,1070,1567,9001,2535,14173
11-08-2020,18 - 19,944,1626,8778,2498,13846
11-08-2020,19 - 20,983,1611,8596,2470,13660
11-08-2020,20 - 21,998,1579,8509,2387,13473
11-08-2020,21 - 22,885,1439,8369,2354,13047
11-08-2020,22 - 23,857,1441,7893,2218,12409
11-08-2020,23 - 00,977,1337,7304,2016,11634
12-08-2020,00 - 01,1017,1331,6991,1876,11215
12-08-2020,01 - 02,1012,1322,6813,1819,10966
12-08-2020,02 - 03,1015,1299,6681,1802,10797
12-08-2020,03 - 04,1029,1448,6663,1793,10933
12-08-2020,04 - 05,998,1475,6725,1795,10993
12-08-2020,05 - 06,879,1421,6768,1824,10892
12-08-2020,06 - 07,872,1314,7453,2024,11663
12-08-2020,07 - 08,982,1404,8289,2348,13023
12-08-2020,08 - 09,1001,1676,8893,2546,14116
12-08-2020,09 - 10,1055,1850,8961,2605,14471
12-08-2020,10 - 11,1106,1796,9125,2674,14701
12-08-2020,11 - 12,1024,1790,9277,2671,14762
12-08-2020,12 - 13,949,1790,9256,2629,14624
12-08-2020,13 - 14,960,1716,9247,2661,14584
12-08-2020,14 - 15,945,1640,9119,2648,14352
12-08-2020,15 - 16,1071,1638,9024,2623,14356
12-08-2020,16 - 17,1085,1712,8976,2550,14323
12-08-2020,17 - 18,1044,1770,8971,2542,14327
12-08-2020,18 - 19,946,1789,8865,2501,14101
12-08-2020,19 - 20,1075,1824,8661,2451,14011
12-08-2020,20 - 21,1100,1893,8460,2390,13843
12-08-2020,21 - 22,1151,1688,8433,2366,13638
12-08-2020,22 - 23,1160,1610,7915,2200,12885
12-08-2020,23 - 00,1111,1482,7331,2012,11936
13-08-2020,00 - 01,1078,1601,6874,1879,11432
13-08-2020,01 - 02,1019,1570,6687,1828,11104
13-08-2020,02 - 03,996,1594,6619,1803,11012
13-08-2020,03 - 04,984,1550,6532,1813,10879
13-08-2020,04 - 05,1025,1512,6506,1857,10900
13-08-2020,05 - 06,1045,1507,6617,1905,11074
13-08-2020,06 - 07,1109,1541,7408,2114,12172
13-08-2020,07 - 08,1109,1661,8378,2408,13556
13-08-2020,08 - 09,1053,1688,8821,2555,14117
13-08-2020,09 - 10,1143,1842,9046,2631,14662
13-08-2020,10 - 11,1131,1739,9132,2671,14673
13-08-2020,11 - 12,1147,1685,9251,2689,14772
13-08-2020,12 - 13,1150,1718,9228,2658,14754
13-08-2020,13 - 14,1180,1678,9278,2677,14813
13-08-2020,14 - 15,1173,1740,9186,2665,14764
13-08-2020,15 - 16,1149,1652,9210,2608,14619
13-08-2020,16 - 17,1134,1567,9154,2569,14424
13-08-2020,17 - 18,1186,1666,9065,2553,14470
13-08-2020,18 - 19,1135,1651,9162,2514,14462
13-08-2020,19 - 20,1069,1639,9523,2448,14679
13-08-2020,20 - 21,931,1693,8647,2400,13671
13-08-2020,21 - 22,1117,1672,8390,2381,13560
13-08-2020,22 - 23,1069,1566,7789,2232,12656
13-08-2020,23 - 00,922,1423,7201,2033,11579
14-08-2020,00 - 01,961,1303,6937,1889,11090
14-08-2020,01 - 02,1048,1236,6642,1832,10758
14-08-2020,02 - 03,1040,1242,6544,1806,10632
14-08-2020,03 - 04,1079,1479,6609,1807,10974
14-08-2020,04 - 05,934,1378,6635,1853,10800
14-08-2020,05 - 06,962,1346,6706,1898,10912
14-08-2020,06 - 07,1087,1507,7397,2099,12090
14-08-2020,07 - 08,1064,1621,8193,2377,13255
14-08-2020,08 - 09,1025,1709,8740,2551,14025
14-08-2020,09 - 10,1107,1798,9026,2595,14526
14-08-2020,10 - 11,1102,1738,9128,2605,14573
14-08-2020,11 - 12,1030,1749,9135,2610,14524
14-08-2020,12 - 13,1012,1721,9099,2585,14417
14-08-2020,13 - 14,1047,1656,8818,2497,14018
14-08-2020,14 - 15,1058,1608,8686,2429,13781
14-08-2020,15 - 16,1069,1530,8633,2373,13605
14-08-2020,16 - 17,996,1523,8550,2351,13420
14-08-2020,17 - 18,895,1554,8545,2355,13349
14-08-2020,18 - 19,822,1563,8360,2303,13048
14-08-2020,19 - 20,921,1592,8082,2224,12819
14-08-2020,20 - 21,996,1623,7842,2109,12570
14-08-2020,21 - 22,1058,1475,7627,2112,12272
14-08-2020,22 - 23,1019,1379,7462,1980,11840
14-08-2020,23 - 00,1035,1337,7074,1905,11351
15-08-2020,00 - 01,949,1251,6574,1786,10560
15-08-2020,01 - 02,909,1127,6387,1696,10119
15-08-2020,02 - 03,894,1036,6301,1653,9884
15-08-2020,03 - 04,938,1063,6192,1655,9848
15-08-2020,04 - 05,939,1032,6094,1683,9748
15-08-2020,05 - 06,1092,1016,6022,1680,9810
15-08-2020,06 - 07,1068,1206,6128,1652,10054
15-08-2020,07 - 08,988,1290,6423,1762,10463
15-08-2020,08 - 09,981,1444,7014,1922,11361
15-08-2020,09 - 10,1081,1580,7364,2030,12055
15-08-2020,10 - 11,1055,1519,7529,2106,12209
15-08-2020,11 - 12,1008,1425,7591,2125,12149
15-08-2020,12 - 13,1012,1553,7548,2097,12210
15-08-2020,13 - 14,975,1505,7495,2047,12022
15-08-2020,14 - 15,972,1596,7389,2011,11968
15-08-2020,15 - 16,1002,1546,7321,1978,11847
15-08-2020,16 - 17,976,1495,7271,2004,11746
15-08-2020,17 - 18,887,1599,7461,2059,12006
15-08-2020,18 - 19,936,1580,7507,2062,12085
15-08-2020,19 - 20,1095,1483,7455,2022,12055
15-08-2020,20 - 21,1088,1342,7290,1972,11692
15-08-2020,21 - 22,1194,1346,7255,1993,11788
15-08-2020,22 - 23,1106,1383,7095,1884,11468
15-08-2020,23 - 00,1003,1192,6693,1764,10652
16-08-2020,00 - 01,842,1142,6167,1677,9828
16-08-2020,01 - 02,829,1131,6110,1673,9743
16-08-2020,02 - 03,912,1199,5917,1622,9650
16-08-2020,03 - 04,1029,1260,5891,1563,9743
16-08-2020,04 - 05,937,1226,5830,1588,9581
16-08-2020,05 - 06,945,1155,5705,1564,9369
16-08-2020,06 - 07,967,1121,5757,1579,9424
16-08-2020,07 - 08,933,1337,6032,1696,9998
16-08-2020,08 - 09,866,1446,6587,1841,10740
16-08-2020,09 - 10,967,1383,6969,1978,11297
16-08-2020,10 - 11,918,1316,7224,2038,11496
16-08-2020,11 - 12,983,1378,7313,2062,11736
16-08-2020,12 - 13,867,1384,7289,2073,11613
16-08-2020,13 - 14,874,1254,7330,2058,11516
16-08-2020,14 - 15,996,1359,7289,2028,11672
16-08-2020,15 - 16,985,1254,7335,2011,11585
16-08-2020,16 - 17,959,1360,7531,2060,11910
16-08-2020,17 - 18,1021,1451,7741,2141,12354
16-08-2020,18 - 19,1003,1503,7829,2176,12511
16-08-2020,19 - 20,1050,1556,7809,2167,12582
16-08-2020,20 - 21,1053,1457,7834,2164,12508
16-08-2020,21 - 22,974,1358,7804,2180,12316
16-08-2020,22 - 23,907,1339,7457,2068,11771
16-08-2020,23 - 00,862,1157,6960,1953,10932
17-08-2020,00 - 01,926,1172,6622,1831,10551
17-08-2020,01 - 02,858,1173,6391,1755,10177
17-08-2020,02 - 03,885,1042,6277,1716,9920
17-08-2020,03 - 04,842,1071,6243,1709,9865
17-08-2020,04 - 05,796,1329,6288,1734,10147
17-08-2020,05 - 06,872,1488,6540,1786,10686
17-08-2020,06 - 07,1062,1606,7462,2028,12158
17-08-2020,07 - 08,1162,1712,8323,2380,13577
17-08-2020,08 - 09,1190,1769,8741,2556,14256
17-08-2020,09 - 10,1310,1808,8942,2621,14681
17-08-2020,10 - 11,1195,1839,9239,2707,14980
17-08-2020,11 - 12,1201,1845,9248,2730,15024
17-08-2020,12 - 13,1243,1803,9289,2701,15036
17-08-2020,13 - 14,1076,1806,9215,2691,14788
17-08-2020,14 - 15,1255,1827,9250,2675,15007
17-08-2020,15 - 16,1140,1812,9188,2637,14777
17-08-2020,16 - 17,1115,1727,9110,2585,14537
17-08-2020,17 - 18,1053,1694,9091,2588,14426
17-08-2020,18 - 19,1076,1628,8902,2532,14138
17-08-2020,19 - 20,1096,1678,8735,2491,14000
17-08-2020,20 - 21,1052,1635,8540,2434,13661
17-08-2020,21 - 22,1006,1637,8367,2372,13382
17-08-2020,22 - 23,947,1635,7830,2195,12607
17-08-2020,23 - 00,1105,1522,7186,2000,11813
18-08-2020,00 - 01,1066,1575,6772,1869,11282
18-08-2020,01 - 02,1015,1500,6536,1766,10817
18-08-2020,02 - 03,1049,1394,6434,1761,10638
18-08-2020,03 - 04,1090,1399,6442,1769,10700
18-08-2020,04 - 05,1028,1477,6561,1813,10879
18-08-2020,05 - 06,1012,1493,6774,1878,11157
18-08-2020,06 - 07,1131,1471,7496,2074,12172
18-08-2020,07 - 08,1138,1623,8336,2431,13528
18-08-2020,08 - 09,1156,1676,8690,2661,14183
18-08-2020,09 - 10,1097,1705,8803,2702,14307
18-08-2020,10 - 11,1109,1632,8968,2736,14445
18-08-2020,11 - 12,1092,1632,8992,2710,14426
18-08-2020,12 - 13,1083,1595,9090,2718,14486
18-08-2020,13 - 14,1090,1633,9061,2702,14486
18-08-2020,14 - 15,1103,1621,9080,2636,14440
18-08-2020,15 - 16,1079,1650,9029,2599,14357
18-08-2020,16 - 17,1098,1884,8931,2514,14427
18-08-2020,17 - 18,1064,1717,8899,2572,14252
18-08-2020,18 - 19,1098,1637,8672,2501,13908
18-08-2020,19 - 20,1115,1744,8574,2418,13851
18-08-2020,20 - 21,1002,1677,8520,2334,13533
18-08-2020,21 - 22,899,1650,8453,2270,13272
18-08-2020,22 - 23,829,1603,7795,2106,12333
18-08-2020,23 - 00,918,1592,7165,1925,11600
19-08-2020,00 - 01,898,1462,6692,1828,10880
19-08-2020,01 - 02,905,1303,6479,1787,10474
19-08-2020,02 - 03,945,1420,6359,1796,10520
19-08-2020,03 - 04,898,1454,6368,1787,10507
19-08-2020,04 - 05,939,1453,6513,1797,10702
19-08-2020,05 - 06,994,1514,6823,1881,11212
19-08-2020,06 - 07,977,1534,7502,2107,12120
19-08-2020,07 - 08,1007,1608,8490,2421,13526
19-08-2020,08 - 09,1091,1676,8892,2563,14222
19-08-2020,09 - 10,1057,1710,9037,2635,14439
19-08-2020,10 - 11,1056,1682,9120,2683,14541
19-08-2020,11 - 12,1045,1668,9165,2681,14559
19-08-2020,12 - 13,1074,1681,9222,2666,14643
19-08-2020,13 - 14,1045,1685,9303,2636,14669
19-08-2020,14 - 15,1054,1637,9254,2620,14565
19-08-2020,15 - 16,1090,1734,9258,2647,14729
19-08-2020,16 - 17,1072,1706,9188,2604,14570
19-08-2020,17 - 18,1052,1716,9213,2598,14579
19-08-2020,18 - 19,1014,1729,8951,2483,14177
19-08-2020,19 - 20,1044,1571,8771,2460,13846
19-08-2020,20 - 21,1023,1440,8413,2400,13276
19-08-2020,21 - 22,1077,1567,8282,2380,13306
19-08-2020,22 - 23,994,1555,7739,2201,12489
19-08-2020,23 - 00,963,1535,7164,2019,11681
20-08-2020,00 - 01,1006,1776,6784,1925,11491
20-08-2020,01 - 02,1003,1599,6552,1866,11020
20-08-2020,02 - 03,870,1407,6400,1819,10496
20-08-2020,03 - 04,795,1317,6370,1812,10294
20-08-2020,04 - 05,831,1303,6476,1797,10407
20-08-2020,05 - 06,996,1295,6680,1894,10865
20-08-2020,06 - 07,1075,1391,7511,2121,12098
20-08-2020,07 - 08,1012,1458,8443,2427,13340
20-08-2020,08 - 09,989,1468,8881,2558,13896
20-08-2020,09 - 10,1008,1674,9089,2623,14394
20-08-2020,10 - 11,1074,1604,9196,2703,14577
20-08-2020,11 - 12,1080,1610,9232,2723,14645
20-08-2020,12 - 13,1059,1599,9196,2702,14556
20-08-2020,13 - 14,1045,1601,9125,2683,14454
20-08-2020,14 - 15,1118,1597,9177,2678,14570
20-08-2020,15 - 16,1028,1524,9077,2623,14252
20-08-2020,16 - 17,1245,1626,8913,2557,14341
20-08-2020,17 - 18,1223,1656,8973,2617,14469
20-08-2020,18 - 19,1132,1507,8767,2587,13993
20-08-2020,19 - 20,1099,1652,8614,2491,13856
20-08-2020,20 - 21,1112,1580,8442,2382,13516
20-08-2020,21 - 22,1250,1403,8206,2239,13098
20-08-2020,22 - 23,1207,1300,7660,2132,12299
20-08-2020,23 - 00,1244,1424,7110,1978,11756
21-08-2020,00 - 01,1038,1446,6770,1896,11150
21-08-2020,01 - 02,917,1351,6653,1823,10744
21-08-2020,02 - 03,830,1289,6606,1806,10531
21-08-2020,03 - 04,752,1330,6615,1793,10490
21-08-2020,04 - 05,877,1502,6723,1787,10889
21-08-2020,05 - 06,998,1655,6956,1865,11474
21-08-2020,06 - 07,1037,1578,7630,2088,12333
21-08-2020,07 - 08,1107,1548,8436,2472,13563
21-08-2020,08 - 09,1084,1595,8900,2624,14203
21-08-2020,09 - 10,1131,1633,9199,2603,14566
21-08-2020,10 - 11,1106,1620,9350,2666,14742
21-08-2020,11 - 12,1059,1518,9295,2794,14666
21-08-2020,12 - 13,1023,1700,9208,2739,14670
21-08-2020,13 - 14,1060,1736,8966,2618,14380
21-08-2020,14 - 15,1035,1440,8959,2576,14010
21-08-2020,15 - 16,999,1404,8699,2539,13641
21-08-2020,16 - 17,1060,1475,8386,2462,13383
21-08-2020,17 - 18,977,1565,8512,2472,13526
21-08-2020,18 - 19,919,1469,8342,2426,13156
21-08-2020,19 - 20,954,1317,8248,2336,12855
21-08-2020,20 - 21,1029,1248,7885,2242,12404
21-08-2020,21 - 22,977,1277,7679,2135,12068
21-08-2020,22 - 23,913,1199,7156,1987,11255
21-08-2020,23 - 00,980,1114,6808,1926,10828
22-08-2020,00 - 01,1112,1148,6462,1847,10569
22-08-2020,01 - 02,906,1251,6133,1770,10060
22-08-2020,02 - 03,827,1145,5945,1665,9582
22-08-2020,03 - 04,895,1104,5837,1637,9473
22-08-2020,04 - 05,992,1167,5900,1663,9722
22-08-2020,05 - 06,983,1183,5867,1630,9663
22-08-2020,06 - 07,859,1184,6040,1670,9753
22-08-2020,07 - 08,903,1181,6494,1819,10397
22-08-2020,08 - 09,1056,1223,7066,1973,11318
22-08-2020,09 - 10,1017,1297,7341,2133,11788
22-08-2020,10 - 11,1042,1316,7640,2239,12237
22-08-2020,11 - 12,1090,1287,7848,2298,12523
22-08-2020,12 - 13,1155,1351,7895,2324,12725
22-08-2020,13 - 14,1122,1543,7777,2290,12732
22-08-2020,14 - 15,1039,1466,7623,2105,12233
22-08-2020,15 - 16,1009,1392,7541,2079,12021
22-08-2020,16 - 17,932,1415,7584,2027,11958
22-08-2020,17 - 18,1113,1203,7706,2013,12035
22-08-2020,18 - 19,1240,1358,7561,1997,12156
22-08-2020,19 - 20,1122,1435,7527,1986,12070
22-08-2020,20 - 21,1087,1258,7437,2029,11811
22-08-2020,21 - 22,1189,1213,7311,2109,11822
22-08-2020,22 - 23,1023,1212,6913,1959,11107
22-08-2020,23 - 00,841,1234,6538,1808,10421
23-08-2020,00 - 01,1081,1397,6332,1749,10559
23-08-2020,01 - 02,1092,1294,6065,1753,10204
23-08-2020,02 - 03,1035,1116,6005,1690,9846
23-08-2020,03 - 04,1033,1135,5956,1639,9763
23-08-2020,04 - 05,977,1007,5763,1660,9407
23-08-2020,05 - 06,888,1012,5679,1634,9213
23-08-2020,06 - 07,991,1203,6009,1633,9836
23-08-2020,07 - 08,1003,1253,6388,1797,10441
23-08-2020,08 - 09,1083,1227,6861,1942,11113
23-08-2020,09 - 10,971,1410,7111,2010,11502
23-08-2020,10 - 11,969,1487,7330,2053,11839
23-08-2020,11 - 12,869,1473,7485,2078,11905
23-08-2020,12 - 13,847,1400,7472,2042,11761
23-08-2020,13 - 14,925,1383,7520,2042,11870
23-08-2020,14 - 15,937,1382,7612,1988,11919
23-08-2020,15 - 16,912,1441,7624,2012,11989
23-08-2020,16 - 17,980,1624,7739,2138,12481
23-08-2020,17 - 18,926,1713,7894,2207,12740
23-08-2020,18 - 19,982,1642,7856,2242,12722
23-08-2020,19 - 20,1035,1556,7781,2222,12594
23-08-2020,20 - 21,974,1541,7913,2239,12667
23-08-2020,21 - 22,765,1243,7538,2163,11709
23-08-2020,22 - 23,761,1046,7086,1944,10837
23-08-2020,23 - 00,906,1024,6892,1774,10596
24-08-2020,00 - 01,979,1091,6790,1737,10597
24-08-2020,01 - 02,950,1006,6571,1717,10244
24-08-2020,02 - 03,950,1065,6526,1781,10322
24-08-2020,03 - 04,944,1258,6596,1757,10555
24-08-2020,04 - 05,957,1385,6667,1850,10859
24-08-2020,05 - 06,914,1449,6818,1878,11059
24-08-2020,06 - 07,999,1395,7722,2176,12292
24-08-2020,07 - 08,1174,1601,8780,2496,14051
24-08-2020,08 - 09,1273,1658,9140,2642,14713
24-08-2020,09 - 10,1238,1675,9118,2620,14651
24-08-2020,10 - 11,1136,1540,9075,2592,14343
24-08-2020,11 - 12,1021,1737,9078,2625,14461
24-08-2020,12 - 13,980,1810,9098,2630,14518
24-08-2020,13 - 14,1002,1790,9027,2592,14411
24-08-2020,14 - 15,932,1715,8939,2586,14172
24-08-2020,15 - 16,955,1696,8890,2606,14147
24-08-2020,16 - 17,981,1789,8898,2625,14293
24-08-2020,17 - 18,1021,1858,8879,2615,14373
24-08-2020,18 - 19,1066,1726,8683,2531,14006
24-08-2020,19 - 20,1042,1559,8692,2482,13775
24-08-2020,20 - 21,1005,1573,8523,2487,13588
24-08-2020,21 - 22,883,1526,8211,2376,12996
24-08-2020,22 - 23,862,1633,7759,2175,12429
24-08-2020,23 - 00,836,1539,7177,1996,11548
25-08-2020,00 - 01,847,1498,6880,1922,11147
25-08-2020,01 - 02,965,1563,6875,1864,11267
25-08-2020,02 - 03,1128,1511,6829,1882,11350
25-08-2020,03 - 04,1033,1409,6840,1879,11161
25-08-2020,04 - 05,896,1339,6883,1908,11026
25-08-2020,05 - 06,773,1349,7334,2040,11496
25-08-2020,06 - 07,805,1424,7889,2251,12369
25-08-2020,07 - 08,886,1578,8736,2468,13668
25-08-2020,08 - 09,1097,1768,9144,2619,14628
25-08-2020,09 - 10,1046,1781,9058,2568,14453
25-08-2020,10 - 11,991,1704,9072,2564,14331
25-08-2020,11 - 12,1027,1670,9001,2545,14243
25-08-2020,12 - 13,1074,1785,9060,2530,14449
25-08-2020,13 - 14,954,1733,8941,2552,14180
25-08-2020,14 - 15,866,1838,8886,2549,14139
25-08-2020,15 - 16,1088,1840,8698,2563,14189
25-08-2020,16 - 17,1147,1714,8549,2490,13900
25-08-2020,17 - 18,969,1671,8534,2495,13669
25-08-2020,18 - 19,898,1697,8552,2489,13636
25-08-2020,19 - 20,892,1678,8611,2404,13585
25-08-2020,20 - 21,1022,1439,8720,2405,13586
25-08-2020,21 - 22,949,1473,8488,2317,13227
25-08-2020,22 - 23,1023,1499,8028,2104,12654
25-08-2020,23 - 00,1088,1354,7628,1995,12065
26-08-2020,00 - 01,759,1334,7315,1904,11312
26-08-2020,01 - 02,963,1347,7045,1801,11156
26-08-2020,02 - 03,936,1276,7036,1799,11047
26-08-2020,03 - 04,889,1133,7041,1788,10851
26-08-2020,04 - 05,829,1141,7015,1866,10851
26-08-2020,05 - 06,761,1365,7265,1949,11340
26-08-2020,06 - 07,927,1546,8197,2158,12828
26-08-2020,07 - 08,1021,1748,9057,2555,14381
26-08-2020,08 - 09,1166,1826,9378,2702,15072
26-08-2020,09 - 10,1017,1816,9490,2769,15092
26-08-2020,10 - 11,1096,1732,9536,2842,15206
26-08-2020,11 - 12,1077,1745,9619,2800,15241
26-08-2020,12 - 13,1102,1779,9621,2681,15183
26-08-2020,13 - 14,1019,1725,9419,2606,14769
26-08-2020,14 - 15,1024,1576,9289,2512,14401
26-08-2020,15 - 16,1045,1827,9347,2510,14729
26-08-2020,16 - 17,1003,1878,9426,2476,14783
26-08-2020,17 - 18,1040,1765,9594,2512,14911
26-08-2020,18 - 19,1037,1805,9443,2481,14766
26-08-2020,19 - 20,918,1752,9208,2419,14297
26-08-2020,20 - 21,895,1605,9223,2412,14135
26-08-2020,21 - 22,820,1545,8840,2260,13465
26-08-2020,22 - 23,878,1491,8174,2097,12640
26-08-2020,23 - 00,807,1371,7432,1968,11578
27-08-2020,00 - 01,950,1523,7064,1869,11406
27-08-2020,01 - 02,867,1475,6843,1780,10965
27-08-2020,02 - 03,900,1463,6991,1722,11076
27-08-2020,03 - 04,1024,1493,7012,1733,11262
27-08-2020,04 - 05,1069,1394,6834,1751,11048
27-08-2020,05 - 06,971,1181,7144,1865,11161
27-08-2020,06 - 07,1037,1180,8207,2118,12542
27-08-2020,07 - 08,1016,1586,9268,2490,14360
27-08-2020,08 - 09,1079,1753,9246,2657,14735
27-08-2020,09 - 10,1100,1827,9390,2776,15093
27-08-2020,10 - 11,1061,1806,9443,2799,15109
27-08-2020,11 - 12,1114,1772,9361,2736,14983
27-08-2020,12 - 13,1171,1812,9431,2629,15043
27-08-2020,13 - 14,1139,1703,9270,2673,14785
27-08-2020,14 - 15,922,1660,9282,2615,14479
27-08-2020,15 - 16,1076,1715,9278,2610,14679
27-08-2020,16 - 17,1109,1676,9117,2549,14451
27-08-2020,17 - 18,1121,1675,9179,2563,14538
27-08-2020,18 - 19,1073,1689,9092,2595,14449
27-08-2020,19 - 20,1074,1696,8995,2540,14305
27-08-2020,20 - 21,1077,1691,8914,2534,14216
27-08-2020,21 - 22,1187,1661,8596,2421,13865
27-08-2020,22 - 23,1052,1795,8058,2193,13098
27-08-2020,23 - 00,1006,1742,7645,2019,12412
28-08-2020,00 - 01,978,1638,7397,1910,11923
28-08-2020,01 - 02,993,1593,7111,1851,11548
28-08-2020,02 - 03,1012,1567,7094,1798,11471
28-08-2020,03 - 04,974,1555,6946,1768,11243
28-08-2020,04 - 05,1009,1615,7069,1797,11490
28-08-2020,05 - 06,985,1663,7621,1982,12251
28-08-2020,06 - 07,1061,1747,8275,2267,13350
28-08-2020,07 - 08,1058,1680,9097,2606,14441
28-08-2020,08 - 09,1105,1787,9294,2692,14878
28-08-2020,09 - 10,1118,1793,9300,2719,14930
28-08-2020,10 - 11,1126,1816,9378,2761,15081
28-08-2020,11 - 12,1099,1843,9283,2745,14970
28-08-2020,12 - 13,1126,1813,9134,2687,14760
28-08-2020,13 - 14,1141,1759,8875,2614,14389
28-08-2020,14 - 15,1087,1722,8664,2549,14022
28-08-2020,15 - 16,1051,1660,8679,2508,13898
28-08-2020,16 - 17,999,1710,8705,2481,13895
28-08-2020,17 - 18,1190,1738,8794,2508,14230
28-08-2020,18 - 19,1058,1772,8682,2449,13961
28-08-2020,19 - 20,1017,1695,8458,2362,13532
28-08-2020,20 - 21,1042,1659,8366,2314,13381
28-08-2020,21 - 22,910,1546,8071,2169,12696
28-08-2020,22 - 23,897,1516,7713,2044,12170
28-08-2020,23 - 00,912,1302,7460,1942,11616
29-08-2020,00 - 01,1026,1217,7218,1780,11241
29-08-2020,01 - 02,1029,1199,7040,1741,11009
29-08-2020,02 - 03,1061,1200,6991,1763,11015
29-08-2020,03 - 04,976,1220,6927,1764,10887
29-08-2020,04 - 05,968,1252,6845,1781,10846
29-08-2020,05 - 06,925,1273,6829,1850,10877
29-08-2020,06 - 07,1016,1374,6780,1801,10971
29-08-2020,07 - 08,1149,1439,7157,1903,11648
29-08-2020,08 - 09,1150,1496,7626,2066,12338
29-08-2020,09 - 10,1163,1648,8135,2222,13168
29-08-2020,10 - 11,1173,1741,8393,2297,13604
29-08-2020,11 - 12,1123,1629,8456,2294,13502
29-08-2020,12 - 13,1104,1706,8468,2274,13552
29-08-2020,13 - 14,1168,1704,8437,2230,13539
29-08-2020,14 - 15,1140,1707,8432,2151,13430
29-08-2020,15 - 16,1120,1658,8263,2132,13173
29-08-2020,16 - 17,1128,1587,8343,2119,13177
29-08-2020,17 - 18,1067,1804,8544,2149,13564
29-08-2020,18 - 19,1114,1671,8524,2095,13404
29-08-2020,19 - 20,973,1595,8400,2051,13019
29-08-2020,20 - 21,908,1670,8300,2025,12903
29-08-2020,21 - 22,964,1680,8065,1953,12662
29-08-2020,22 - 23,1104,1614,7782,1842,12342
29-08-2020,23 - 00,1163,1552,7462,1779,11956
30-08-2020,00 - 01,1027,1589,7184,1720,11520
30-08-2020,01 - 02,894,1397,7001,1656,10948
30-08-2020,02 - 03,1001,1435,6931,1621,10988
30-08-2020,03 - 04,1036,1366,6876,1620,10898
30-08-2020,04 - 05,1059,1337,6847,1625,10868
30-08-2020,05 - 06,1050,1279,6844,1660,10833
30-08-2020,06 - 07,1020,1370,6825,1699,10914
30-08-2020,07 - 08,1100,1343,7045,1765,11253
30-08-2020,08 - 09,1145,1433,7360,1885,11823
30-08-2020,09 - 10,1181,1581,7615,2027,12404
30-08-2020,10 - 11,1103,1613,7897,2050,12663
30-08-2020,11 - 12,1087,1809,8033,2074,13003
30-08-2020,12 - 13,1150,1783,8039,2092,13064
30-08-2020,13 - 14,1073,1744,7996,2098,12911
30-08-2020,14 - 15,1154,1688,7927,2083,12852
30-08-2020,15 - 16,1175,1607,7988,2057,12827
30-08-2020,16 - 17,1213,1536,7947,2099,12795
30-08-2020,17 - 18,1192,1651,8176,2197,13216
30-08-2020,18 - 19,1170,1671,8498,2234,13573
30-08-2020,19 - 20,1196,1656,8356,2223,13431
30-08-2020,20 - 21,1191,1685,8368,2243,13487
30-08-2020,21 - 22,1178,1513,7939,2137,12767
30-08-2020,22 - 23,1100,1427,7476,1963,11966
30-08-2020,23 - 00,1094,1481,7139,1818,11532
31-08-2020,00 - 01,1028,1062,6988,1701,10779
31-08-2020,01 - 02,880,793,6879,1626,10178
31-08-2020,02 - 03,794,1018,6861,1621,10294
31-08-2020,03 - 04,900,747,6842,1659,10148
31-08-2020,04 - 05,930,859,7017,1733,10539
31-08-2020,05 - 06,902,1113,7345,1867,11227
31-08-2020,06 - 07,999,1304,8214,2167,12684
31-08-2020,07 - 08,1156,1564,9254,2496,14470
31-08-2020,08 - 09,1195,1575,9682,2654,15106
31-08-2020,09 - 10,1201,1659,9672,2656,15188
31-08-2020,10 - 11,1116,1662,9715,2608,15101
31-08-2020,11 - 12,1228,1747,9681,2575,15231
31-08-2020,12 - 13,1259,1915,9606,2596,15376
31-08-2020,13 - 14,1190,1896,9495,2637,15218
31-08-2020,14 - 15,1145,1843,9475,2590,15053
31-08-2020,15 - 16,973,1793,9429,2568,14763
31-08-2020,16 - 17,1141,1714,9267,2525,14647
31-08-2020,17 - 18,1173,1718,9364,2532,14787
31-08-2020,18 - 19,1116,1861,9286,2459,14722
31-08-2020,19 - 20,1172,1783,9231,2424,14610
31-08-2020,20 - 21,1162,1738,9208,2420,14528
31-08-2020,21 - 22,1143,1613,8875,2292,13923
31-08-2020,22 - 23,1144,1486,8298,2115,13043
31-08-2020,23 - 00,1169,1456,7625,1959,12209
01-09-2020,00 - 01,867,1638,7439,1884,11828
01-09-2020,01 - 02,1005,1776,7281,1853,11915
01-09-2020,02 - 03,1061,1578,7190,1855,11684
01-09-2020,03 - 04,902,1811,7250,1831,11794
01-09-2020,04 - 05,943,1774,7378,1900,11995
01-09-2020,05 - 06,1059,1870,7738,2046,12713
01-09-2020,06 - 07,1174,1889,8577,2237,13877
01-09-2020,07 - 08,1196,1975,9420,2582,15173
01-09-2020,08 - 09,1242,1884,9559,2753,15438
01-09-2020,09 - 10,1169,1769,9509,2762,15209
01-09-2020,10 - 11,1127,1711,9513,2731,15082
01-09-2020,11 - 12,1100,1724,9465,2680,14969
01-09-2020,12 - 13,1197,1703,9382,2606,14888
01-09-2020,13 - 14,1190,1670,9254,2544,14658
01-09-2020,14 - 15,1181,1663,9198,2530,14572
01-09-2020,15 - 16,1207,1650,9139,2529,14525
01-09-2020,16 - 17,1189,1689,9097,2507,14482
01-09-2020,17 - 18,1199,1691,9205,2501,14596
01-09-2020,18 - 19,1155,1757,9102,2475,14489
01-09-2020,19 - 20,985,1779,9046,2450,14260
01-09-2020,20 - 21,1206,1632,9092,2433,14363
01-09-2020,21 - 22,1307,1534,8658,2276,13775
01-09-2020,22 - 23,1133,1569,8127,2010,12839
01-09-2020,23 - 00,938,1552,7415,1870,11775
02-09-2020,00 - 01,1119,1480,7152,1829,11580
02-09-2020,01 - 02,1121,1350,6920,1731,11122
02-09-2020,02 - 03,1054,1282,7064,1734,11134
02-09-2020,03 - 04,995,1251,7176,1773,11195
02-09-2020,04 - 05,1009,1416,7312,1800,11537
02-09-2020,05 - 06,919,1552,7857,1907,12235
02-09-2020,06 - 07,939,1549,8561,2194,13243
02-09-2020,07 - 08,1011,1560,9424,2548,14543
02-09-2020,08 - 09,1099,1573,9580,2692,14944
02-09-2020,09 - 10,1149,1662,9613,2675,15099
02-09-2020,10 - 11,979,1700,9580,2762,15021
02-09-2020,11 - 12,950,1731,9570,2801,15052
02-09-2020,12 - 13,1094,1558,9611,2762,15025
02-09-2020,13 - 14,1060,1625,9512,2739,14936
02-09-2020,14 - 15,974,1737,9354,2699,14764
02-09-2020,15 - 16,991,1714,9390,2680,14775
02-09-2020,16 - 17,965,1733,9379,2616,14693
02-09-2020,17 - 18,1074,1661,9537,2602,14874
02-09-2020,18 - 19,1105,1638,9391,2593,14727
02-09-2020,19 - 20,963,1688,9278,2539,14468
02-09-2020,20 - 21,834,1470,9301,2498,14103
02-09-2020,21 - 22,828,1308,8672,2311,13119
02-09-2020,22 - 23,911,1232,7968,2165,12276
02-09-2020,23 - 00,838,1149,7387,2009,11383
03-09-2020,00 - 01,721,991,7091,1885,10688
03-09-2020,01 - 02,549,1250,6820,1834,10453
03-09-2020,02 - 03,806,1297,6778,1857,10738
03-09-2020,03 - 04,868,1476,6803,1882,11029
03-09-2020,04 - 05,781,1424,6941,1925,11071
03-09-2020,05 - 06,979,1567,7296,2036,11878
03-09-2020,06 - 07,1030,1601,8246,2280,13157
03-09-2020,07 - 08,1072,1653,9135,2593,14453
03-09-2020,08 - 09,1102,1719,9437,2708,14966
03-09-2020,09 - 10,1050,1920,9565,2714,15249
03-09-2020,10 - 11,1077,1974,9520,2730,15301
03-09-2020,11 - 12,1061,1916,9617,2699,15293
03-09-2020,12 - 13,1023,1917,9608,2677,15225
03-09-2020,13 - 14,1044,1916,9484,2664,15108
03-09-2020,14 - 15,1019,2057,9364,2600,15040
03-09-2020,15 - 16,985,1890,9356,2568,14799
03-09-2020,16 - 17,973,1807,9288,2512,14580
03-09-2020,17 - 18,996,1703,9282,2573,14554
03-09-2020,18 - 19,1000,1738,9087,2558,14383
03-09-2020,19 - 20,973,1689,8982,2487,14131
03-09-2020,20 - 21,1022,1699,8979,2410,14110
03-09-2020,21 - 22,1045,1626,8359,2212,13242
03-09-2020,22 - 23,1012,1511,7663,1979,12165
03-09-2020,23 - 00,952,1491,7144,1902,11489
04-09-2020,00 - 01,960,1358,6769,1843,10930
04-09-2020,01 - 02,921,1295,6640,1829,10685
04-09-2020,02 - 03,973,1346,6599,1856,10774
04-09-2020,03 - 04,1000,1316,6591,1791,10698
04-09-2020,04 - 05,896,1325,6629,1876,10726
04-09-2020,05 - 06,943,1372,6962,1984,11261
04-09-2020,06 - 07,1102,1549,7825,2219,12695
04-09-2020,07 - 08,1157,1715,8851,2491,14214
04-09-2020,08 - 09,1200,1859,9311,2632,15002
04-09-2020,09 - 10,1015,1745,9346,2665,14771
04-09-2020,10 - 11,921,1758,9430,2628,14737
04-09-2020,11 - 12,1134,1864,9553,2610,15161
04-09-2020,12 - 13,1080,1853,9511,2563,15007
04-09-2020,13 - 14,1018,1785,9230,2520,14553
04-09-2020,14 - 15,1037,1770,8921,2463,14191
04-09-2020,15 - 16,816,1752,8745,2387,13700
04-09-2020,16 - 17,999,1667,8733,2413,13812
04-09-2020,17 - 18,1038,1714,8737,2501,13990
04-09-2020,18 - 19,1032,1608,8625,2486,13751
04-09-2020,19 - 20,1002,1455,8462,2335,13254
04-09-2020,20 - 21,895,1462,8353,2253,12963
04-09-2020,21 - 22,984,1402,7912,2051,12349
04-09-2020,22 - 23,797,1212,7525,1900,11434
04-09-2020,23 - 00,809,1406,7093,1776,11084
05-09-2020,00 - 01,875,1583,6853,1755,11066
05-09-2020,01 - 02,912,1411,6594,1676,10593
05-09-2020,02 - 03,915,1363,6511,1654,10443
05-09-2020,03 - 04,933,1322,6397,1681,10333
05-09-2020,04 - 05,868,1081,6466,1701,10116
05-09-2020,05 - 06,819,1157,6816,1714,10506
05-09-2020,06 - 07,819,1274,6814,1781,10688
05-09-2020,07 - 08,845,1369,7106,1885,11205
05-09-2020,08 - 09,889,1322,7524,2089,11824
05-09-2020,09 - 10,846,1460,7863,2191,12360
05-09-2020,10 - 11,979,1444,7995,2257,12675
05-09-2020,11 - 12,967,1651,7977,2225,12820
05-09-2020,12 - 13,943,1566,8044,2199,12752
05-09-2020,13 - 14,722,1561,7984,2128,12395
05-09-2020,14 - 15,942,1516,8045,2069,12572
05-09-2020,15 - 16,1059,1623,7957,2193,12832
05-09-2020,16 - 17,1012,1643,7988,2252,12895
05-09-2020,17 - 18,914,1635,8204,2263,13016
05-09-2020,18 - 19,944,1597,8174,2302,13017
05-09-2020,19 - 20,883,1532,8210,2233,12858
05-09-2020,20 - 21,657,1570,8132,2209,12568
05-09-2020,21 - 22,872,1643,7425,2141,12081
05-09-2020,22 - 23,927,1660,7212,1969,11768
05-09-2020,23 - 00,918,1502,7101,1897,11418
06-09-2020,00 - 01,942,1498,6878,1794,11112
06-09-2020,01 - 02,857,1557,6614,1690,10718
06-09-2020,02 - 03,785,1501,6471,1646,10403
06-09-2020,03 - 04,701,1487,6536,1658,10382
06-09-2020,04 - 05,741,1527,6594,1672,10534
06-09-2020,05 - 06,750,1481,6550,1701,10482
06-09-2020,06 - 07,764,1432,6515,1669,10380
06-09-2020,07 - 08,772,1370,6827,1790,10759
06-09-2020,08 - 09,1005,1530,7311,1977,11823
06-09-2020,09 - 10,1139,1604,7667,2066,12476
06-09-2020,10 - 11,1138,1646,7707,2055,12546
06-09-2020,11 - 12,1188,1627,7730,2127,12672
06-09-2020,12 - 13,1074,1554,7697,2123,12448
06-09-2020,13 - 14,1069,1496,7591,2071,12227
06-09-2020,14 - 15,936,1434,7501,2037,11908
06-09-2020,15 - 16,1066,1432,7683,2064,12245
06-09-2020,16 - 17,1095,1689,7811,2143,12738
06-09-2020,17 - 18,1235,1640,8053,2286,13214
06-09-2020,18 - 19,1178,1600,8131,2270,13179
06-09-2020,19 - 20,1129,1628,8205,2216,13178
06-09-2020,20 - 21,1062,1614,8273,2146,13095
06-09-2020,21 - 22,969,1652,7892,2058,12571
06-09-2020,22 - 23,928,1583,7551,1866,11928
06-09-2020,23 - 00,945,1438,7237,1814,11434
07-09-2020,00 - 01,917,1456,7082,1840,11295
07-09-2020,01 - 02,971,1477,6980,1816,11244
07-09-2020,02 - 03,948,1386,6960,1702,10996
07-09-2020,03 - 04,936,1415,6932,1721,11004
07-09-2020,04 - 05,873,1450,7058,1743,11124
07-09-2020,05 - 06,968,1545,7495,1964,11972
07-09-2020,06 - 07,1001,1626,8406,2242,13275
07-09-2020,07 - 08,1056,1775,9253,2581,14665
07-09-2020,08 - 09,1098,1874,9511,2721,15204
07-09-2020,09 - 10,1138,1913,9606,2722,15379
07-09-2020,10 - 11,1092,1849,9494,2689,15124
07-09-2020,11 - 12,877,1838,9474,2659,14848
07-09-2020,12 - 13,974,1653,9370,2652,14649
07-09-2020,13 - 14,1100,1724,9263,2672,14759
07-09-2020,14 - 15,1059,1617,9228,2639,14543
07-09-2020,15 - 16,1112,1539,9241,2586,14478
07-09-2020,16 - 17,1084,1534,9105,2579,14302
07-09-2020,17 - 18,1084,1500,9095,2618,14297
07-09-2020,18 - 19,955,1493,9007,2558,14013
07-09-2020,19 - 20,956,1252,8920,2545,13673
07-09-2020,20 - 21,888,1305,9036,2538,13767
07-09-2020,21 - 22,574,1413,8580,2383,12950
07-09-2020,22 - 23,456,1359,7975,2134,11924
07-09-2020,23 - 00,702,1302,7545,1979,11528
08-09-2020,00 - 01,680,1159,7156,1932,10927
08-09-2020,01 - 02,678,1255,6878,1871,10682
08-09-2020,02 - 03,728,1341,6884,1876,10829
08-09-2020,03 - 04,784,1238,6960,1900,10882
08-09-2020,04 - 05,770,1148,7007,1925,10850
08-09-2020,05 - 06,821,1269,7380,2119,11589
08-09-2020,06 - 07,1033,1532,8235,2396,13196
08-09-2020,07 - 08,827,1839,9181,2629,14476
08-09-2020,08 - 09,1015,1779,9609,2783,15186
08-09-2020,09 - 10,1155,1812,9708,2821,15496
08-09-2020,10 - 11,1188,1870,9653,2834,15545
08-09-2020,11 - 12,1136,1746,9473,2793,15148
08-09-2020,12 - 13,1104,1712,9347,2743,14906
08-09-2020,13 - 14,1150,1753,9182,2695,14780
08-09-2020,14 - 15,1114,1623,9029,2586,14352
08-09-2020,15 - 16,1035,1564,9007,2571,14177
08-09-2020,16 - 17,1050,1738,8997,2571,14356
08-09-2020,17 - 18,963,1769,9164,2647,14543
08-09-2020,18 - 19,936,1689,9047,2627,14299
08-09-2020,19 - 20,967,1713,9007,2633,14320
08-09-2020,20 - 21,965,1611,9093,2663,14332
08-09-2020,21 - 22,749,1559,8562,2474,13344
08-09-2020,22 - 23,645,1573,7888,2247,12353
08-09-2020,23 - 00,562,1485,7346,2040,11433
09-09-2020,00 - 01,669,1740,7103,1895,11407
09-09-2020,01 - 02,674,1519,6803,1818,10814
09-09-2020,02 - 03,859,1425,6728,1916,10928
09-09-2020,03 - 04,822,1275,6768,1923,10788
09-09-2020,04 - 05,727,1320,6833,1900,10780
09-09-2020,05 - 06,717,1409,7314,2016,11456
09-09-2020,06 - 07,1050,1708,8140,2278,13176
09-09-2020,07 - 08,1045,1738,9086,2574,14443
09-09-2020,08 - 09,894,1713,9620,2678,14905
09-09-2020,09 - 10,932,1778,10161,2673,15544
09-09-2020,10 - 11,994,1905,9960,2777,15636
09-09-2020,11 - 12,1049,1803,9756,2822,15430
09-09-2020,12 - 13,1067,1836,9737,2797,15437
09-09-2020,13 - 14,1045,1820,9438,2814,15117
09-09-2020,14 - 15,966,1757,9354,2803,14880
09-09-2020,15 - 16,930,1811,9312,2755,14808
09-09-2020,16 - 17,920,1744,9155,2666,14485
09-09-2020,17 - 18,1031,1806,9295,2677,14809
09-09-2020,18 - 19,1114,1726,9108,2697,14645
09-09-2020,19 - 20,1075,1636,9152,2656,14519
09-09-2020,20 - 21,1231,1450,9128,2602,14411
09-09-2020,21 - 22,1094,1317,8438,2432,13281
09-09-2020,22 - 23,982,1447,7888,2210,12527
09-09-2020,23 - 00,900,1241,7385,2100,11626
10-09-2020,00 - 01,907,1140,7079,2021,11147
10-09-2020,01 - 02,832,1139,6961,1952,10884
10-09-2020,02 - 03,680,1194,7002,1938,10814
10-09-2020,03 - 04,726,1314,6996,1964,11000
10-09-2020,04 - 05,864,1224,7040,1992,11120
10-09-2020,05 - 06,844,1217,7416,2097,11574
10-09-2020,06 - 07,953,1635,8260,2428,13276
10-09-2020,07 - 08,961,1767,9262,2755,14745
10-09-2020,08 - 09,1007,1778,9522,2800,15107
10-09-2020,09 - 10,1042,1915,9583,2818,15358
10-09-2020,10 - 11,1027,1942,9559,2781,15309
10-09-2020,11 - 12,994,1915,9543,2746,15198
10-09-2020,12 - 13,992,1763,9467,2696,14918
10-09-2020,13 - 14,952,1730,9334,2601,14617
10-09-2020,14 - 15,961,1743,9165,2503,14372
10-09-2020,15 - 16,991,1732,9123,2511,14357
10-09-2020,16 - 17,861,1818,9042,2544,14265
10-09-2020,17 - 18,874,1809,9371,2564,14618
10-09-2020,18 - 19,921,1785,9406,2648,14760
10-09-2020,19 - 20,844,1883,9539,2690,14956
10-09-2020,20 - 21,805,1978,9521,2659,14963
10-09-2020,21 - 22,814,1972,9006,2449,14241
10-09-2020,22 - 23,893,1868,8383,2311,13455
10-09-2020,23 - 00,870,1839,7930,2158,12797
11-09-2020,00 - 01,835,1670,7584,2030,12119
11-09-2020,01 - 02,741,1646,7306,1992,11685
11-09-2020,02 - 03,688,1540,7302,1950,11480
11-09-2020,03 - 04,714,1530,7318,1927,11489
11-09-2020,04 - 05,775,1658,7401,1982,11816
11-09-2020,05 - 06,806,1757,7695,2128,12386
11-09-2020,06 - 07,906,1857,8587,2345,13695
11-09-2020,07 - 08,1029,1682,9400,2611,14722
11-09-2020,08 - 09,1076,1771,9776,2758,15381
11-09-2020,09 - 10,1249,1979,9830,2852,15910
11-09-2020,10 - 11,1238,2055,9728,2800,15821
11-09-2020,11 - 12,1114,1938,9548,2765,15365
11-09-2020,12 - 13,1034,1732,9411,2674,14851
11-09-2020,13 - 14,1044,1656,9195,2569,14464
11-09-2020,14 - 15,1077,1529,8979,2559,14144
11-09-2020,15 - 16,1056,1613,8928,2547,14144
11-09-2020,16 - 17,1055,1695,9076,2460,14286
11-09-2020,17 - 18,1053,1670,9305,2433,14461
11-09-2020,18 - 19,984,1382,9087,2396,13849
11-09-2020,19 - 20,764,1425,9013,2331,13533
11-09-2020,20 - 21,533,1668,8690,2184,13075
11-09-2020,21 - 22,743,1584,8310,2074,12711
11-09-2020,22 - 23,1058,1506,7801,1965,12330
11-09-2020,23 - 00,834,1141,7366,1860,11201
12-09-2020,00 - 01,819,1452,7052,1826,11149
12-09-2020,01 - 02,752,1368,6796,1779,10695
12-09-2020,02 - 03,694,1426,6714,1793,10627
12-09-2020,03 - 04,1016,1566,6692,1757,11031
12-09-2020,04 - 05,990,1425,6666,1763,10844
12-09-2020,05 - 06,952,1479,6757,1765,10953
12-09-2020,06 - 07,937,1272,6912,1798,10919
12-09-2020,07 - 08,1143,1348,7221,1898,11610
12-09-2020,08 - 09,1096,1534,7706,2128,12464
12-09-2020,09 - 10,1071,1587,8112,2288,13058
12-09-2020,10 - 11,1033,1654,8519,2280,13486
12-09-2020,11 - 12,1004,1589,8639,2263,13495
12-09-2020,12 - 13,932,1503,8680,2266,13381
12-09-2020,13 - 14,994,1566,8757,2201,13518
12-09-2020,14 - 15,1041,1598,8618,2209,13466
12-09-2020,15 - 16,1091,1732,8408,2309,13540
12-09-2020,16 - 17,1102,1757,8226,2385,13470
12-09-2020,17 - 18,1081,1774,8448,2490,13793
12-09-2020,18 - 19,1070,1530,8449,2512,13561
12-09-2020,19 - 20,1068,1344,8435,2375,13222
12-09-2020,20 - 21,998,1553,8378,2223,13152
12-09-2020,21 - 22,1020,1583,8057,2054,12714
12-09-2020,22 - 23,1033,1438,7559,1946,11976
12-09-2020,23 - 00,1003,1365,7221,1815,11404
13-09-2020,00 - 01,719,1407,7028,1747,10901
13-09-2020,01 - 02,900,1497,6813,1721,10931
13-09-2020,02 - 03,1150,1431,6704,1693,10978
13-09-2020,03 - 04,999,1101,6757,1661,10518
13-09-2020,04 - 05,926,1097,6761,1721,10505
13-09-2020,05 - 06,875,962,6891,1720,10448
13-09-2020,06 - 07,763,950,6883,1691,10287
13-09-2020,07 - 08,805,1078,7158,1812,10853
13-09-2020,08 - 09,1011,1370,7454,1956,11791
13-09-2020,09 - 10,947,1538,7768,2061,12314
13-09-2020,10 - 11,941,1603,8054,2171,12769
13-09-2020,11 - 12,870,1531,8168,2245,12814
13-09-2020,12 - 13,849,1569,8247,2272,12937
13-09-2020,13 - 14,1066,1419,8238,2279,13002
13-09-2020,14 - 15,1042,1394,8284,2140,12860
13-09-2020,15 - 16,952,1535,8427,2183,13097
13-09-2020,16 - 17,1024,1526,8434,2359,13343
13-09-2020,17 - 18,1163,1524,8338,2425,13450
13-09-2020,18 - 19,931,1846,8617,2425,13819
13-09-2020,19 - 20,882,1940,8592,2416,13830
13-09-2020,20 - 21,994,1704,8260,2369,13327
13-09-2020,21 - 22,990,1724,8018,2244,12976
13-09-2020,22 - 23,991,1553,7503,2062,12109
13-09-2020,23 - 00,994,1456,7005,1871,11326
14-09-2020,00 - 01,804,1644,6763,1727,10938
14-09-2020,01 - 02,871,1529,6463,1702,10565
14-09-2020,02 - 03,810,1457,6365,1726,10358
14-09-2020,03 - 04,784,1611,6394,1811,10600
14-09-2020,04 - 05,886,1726,6457,1798,10867
14-09-2020,05 - 06,827,1606,6712,1905,11050
14-09-2020,06 - 07,1091,1834,8049,2251,13225
14-09-2020,07 - 08,959,1680,9154,2519,14312
14-09-2020,08 - 09,979,1740,9486,2691,14896
14-09-2020,09 - 10,1098,1840,9642,2728,15308
14-09-2020,10 - 11,1139,1945,9770,2753,15607
14-09-2020,11 - 12,1167,1759,9828,2743,15497
14-09-2020,12 - 13,1131,1647,10091,2683,15552
14-09-2020,13 - 14,1089,1802,9622,2699,15212
14-09-2020,14 - 15,1121,1803,9426,2626,14976
14-09-2020,15 - 16,1057,1750,9459,2603,14869
14-09-2020,16 - 17,951,1823,9472,2563,14809
14-09-2020,17 - 18,1004,1856,9497,2653,15010
14-09-2020,18 - 19,1009,1916,9410,2674,15009
14-09-2020,19 - 20,941,1856,9276,2642,14715
14-09-2020,20 - 21,957,1725,9172,2531,14385
14-09-2020,21 - 22,934,1732,8579,2309,13554
14-09-2020,22 - 23,915,1520,7912,2130,12477
14-09-2020,23 - 00,992,1373,7260,1962,11587
15-09-2020,00 - 01,961,1218,6991,1761,10931
15-09-2020,01 - 02,1006,1367,6863,1733,10969
15-09-2020,02 - 03,895,1386,6846,1789,10916
15-09-2020,03 - 04,864,1424,7077,1783,11148
15-09-2020,04 - 05,987,1495,7390,1878,11750
15-09-2020,05 - 06,988,1693,7722,1990,12393
15-09-2020,06 - 07,1084,1690,8585,2298,13657
15-09-2020,07 - 08,1108,1751,9329,2594,14782
15-09-2020,08 - 09,1238,1806,9610,2687,15341
15-09-2020,09 - 10,1324,2026,9706,2681,15737
15-09-2020,10 - 11,1241,1941,9739,2693,15614
15-09-2020,11 - 12,1227,1961,9662,2765,15615
15-09-2020,12 - 13,1122,1883,9452,2815,15272
15-09-2020,13 - 14,1139,1852,9276,2798,15065
15-09-2020,14 - 15,1171,1893,9324,2769,15157
15-09-2020,15 - 16,1178,1867,9295,2783,15123
15-09-2020,16 - 17,1158,1852,9208,2754,14972
15-09-2020,17 - 18,1162,1820,9433,2687,15102
15-09-2020,18 - 19,1216,1892,9348,2578,15034
15-09-2020,19 - 20,1234,1881,9337,2579,15031
15-09-2020,20 - 21,1202,1674,9227,2539,14642
15-09-2020,21 - 22,1136,1619,8714,2365,13834
15-09-2020,22 - 23,1025,1593,8141,2146,12905
15-09-2020,23 - 00,1007,1594,7619,1953,12173
16-09-2020,00 - 01,1041,1429,7175,1835,11480
16-09-2020,01 - 02,961,1160,6839,1772,10732
16-09-2020,02 - 03,907,1213,6827,1765,10712
16-09-2020,03 - 04,858,1067,6867,1774,10566
16-09-2020,04 - 05,1048,1135,6942,1793,10918
16-09-2020,05 - 06,942,1401,7512,1888,11743
16-09-2020,06 - 07,916,1534,8533,2181,13164
16-09-2020,07 - 08,835,1511,9309,2397,14052
16-09-2020,08 - 09,713,1560,9551,2519,14343
16-09-2020,09 - 10,898,1493,9744,2632,14767
16-09-2020,10 - 11,934,1624,9888,2691,15137
16-09-2020,11 - 12,827,1648,9805,2693,14973
16-09-2020,12 - 13,993,1769,9757,2643,15162
16-09-2020,13 - 14,1037,1741,9407,2665,14850
16-09-2020,14 - 15,1093,1793,9302,2637,14825
16-09-2020,15 - 16,1158,1772,9237,2603,14770
16-09-2020,16 - 17,1228,1801,9232,2500,14761
16-09-2020,17 - 18,1028,1785,9408,2462,14683
16-09-2020,18 - 19,1029,1709,9466,2454,14658
16-09-2020,19 - 20,1035,1850,9630,2413,14928
16-09-2020,20 - 21,1000,1768,9498,2318,14584
16-09-2020,21 - 22,1115,1666,8955,2136,13872
16-09-2020,22 - 23,959,1397,8349,2034,12739
16-09-2020,23 - 00,968,1417,7840,1913,12138
17-09-2020,00 - 01,736,1219,7499,1775,11229
17-09-2020,01 - 02,826,1302,7369,1731,11228
17-09-2020,02 - 03,814,1221,7335,1757,11127
17-09-2020,03 - 04,802,1342,7371,1763,11278
17-09-2020,04 - 05,700,1480,7485,1817,11482
17-09-2020,05 - 06,989,1421,7890,1981,12281
17-09-2020,06 - 07,877,1512,8889,2338,13616
17-09-2020,07 - 08,896,1423,9821,2662,14802
17-09-2020,08 - 09,887,1660,10050,2848,15445
17-09-2020,09 - 10,831,1768,10002,2819,15420
17-09-2020,10 - 11,993,1846,9914,2798,15551
17-09-2020,11 - 12,1116,1599,9823,2676,15214
17-09-2020,12 - 13,1101,1708,9643,2577,15029
17-09-2020,13 - 14,1006,1876,9428,2555,14865
17-09-2020,14 - 15,1124,1849,9388,2514,14875
17-09-2020,15 - 16,1102,1581,9361,2499,14543
17-09-2020,16 - 17,1274,1636,9497,2484,14891
17-09-2020,17 - 18,1090,1589,9626,2583,14888
17-09-2020,18 - 19,1109,1675,9606,2588,14978
17-09-2020,19 - 20,1183,1497,9663,2560,14903
17-09-2020,20 - 21,1157,1505,9681,2510,14853
17-09-2020,21 - 22,1105,1609,9093,2305,14112
17-09-2020,22 - 23,991,1385,8427,2138,12941
17-09-2020,23 - 00,982,1333,7909,1975,12199
18-09-2020,00 - 01,852,1613,7676,1966,12107
18-09-2020,01 - 02,913,1366,7454,1947,11680
18-09-2020,02 - 03,936,1454,7383,1997,11770
18-09-2020,03 - 04,939,1425,7393,2020,11777
18-09-2020,04 - 05,975,1364,7479,2039,11857
18-09-2020,05 - 06,1044,1284,7841,2200,12369
18-09-2020,06 - 07,1026,1501,8945,2499,13971
18-09-2020,07 - 08,1012,1462,9699,2730,14903
18-09-2020,08 - 09,1060,1724,9893,2842,15519
18-09-2020,09 - 10,1009,1606,9759,2865,15239
18-09-2020,10 - 11,970,1710,9747,2707,15134
18-09-2020,11 - 12,1113,1806,9642,2619,15180
18-09-2020,12 - 13,1002,1679,9424,2461,14566
18-09-2020,13 - 14,990,1595,9201,2505,14291
18-09-2020,14 - 15,930,1534,9025,2460,13949
18-09-2020,15 - 16,955,1499,8925,2429,13808
18-09-2020,16 - 17,1090,1627,8942,2369,14028
18-09-2020,17 - 18,1043,1630,9141,2412,14226
18-09-2020,18 - 19,947,1677,9158,2434,14216
18-09-2020,19 - 20,1103,1682,8873,2431,14089
18-09-2020,20 - 21,1005,1782,8538,2369,13694
18-09-2020,21 - 22,1047,1727,8146,2235,13155
18-09-2020,22 - 23,1058,1366,7748,2114,12286
18-09-2020,23 - 00,1000,1339,7316,1954,11609
19-09-2020,00 - 01,954,1284,6960,1880,11078
19-09-2020,01 - 02,946,1347,6989,1839,11121
19-09-2020,02 - 03,930,1376,6928,1822,11056
19-09-2020,03 - 04,936,1373,6866,1838,11013
19-09-2020,04 - 05,953,1293,6945,1857,11048
19-09-2020,05 - 06,915,1514,7006,1901,11336
19-09-2020,06 - 07,767,1555,7200,1976,11498
19-09-2020,07 - 08,936,1553,7466,2028,11983
19-09-2020,08 - 09,1051,1758,7839,2182,12830
19-09-2020,09 - 10,1172,2050,8201,2285,13708
19-09-2020,10 - 11,1073,1844,8378,2318,13613
19-09-2020,11 - 12,1049,1558,8265,2317,13189
19-09-2020,12 - 13,1066,1498,8068,2272,12904
19-09-2020,13 - 14,1115,1493,8061,2227,12896
19-09-2020,14 - 15,1075,1399,7926,2187,12587
19-09-2020,15 - 16,1063,1356,7876,2156,12451
19-09-2020,16 - 17,1145,1419,7989,2172,12725
19-09-2020,17 - 18,1229,1800,8227,2258,13514
19-09-2020,18 - 19,1204,1867,8419,2297,13787
19-09-2020,19 - 20,1213,1684,8746,2327,13970
19-09-2020,20 - 21,1063,1750,8473,2262,13548
19-09-2020,21 - 22,1024,1690,8156,2186,13056
19-09-2020,22 - 23,1131,1706,7756,2076,12669
19-09-2020,23 - 00,1085,1695,7342,1955,12077
20-09-2020,00 - 01,918,1453,7194,1906,11471
20-09-2020,01 - 02,942,1267,7037,1874,11120
20-09-2020,02 - 03,842,1141,6904,1794,10681
20-09-2020,03 - 04,904,1076,6889,1781,10650
20-09-2020,04 - 05,1028,1315,6879,1780,11002
20-09-2020,05 - 06,987,1389,7064,1798,11238
20-09-2020,06 - 07,1084,1291,7132,1866,11373
20-09-2020,07 - 08,1010,1338,7270,1925,11543
20-09-2020,08 - 09,945,1463,7573,2065,12046
20-09-2020,09 - 10,1063,1243,7939,2219,12464
20-09-2020,10 - 11,1004,1261,8195,2269,12729
20-09-2020,11 - 12,1094,1563,8335,2306,13298
20-09-2020,12 - 13,1094,1794,8309,2328,13525
20-09-2020,13 - 14,1009,1712,8218,2288,13227
20-09-2020,14 - 15,1019,1673,8097,2232,13021
20-09-2020,15 - 16,1247,1832,8088,2228,13395
20-09-2020,16 - 17,1080,1583,8344,2263,13270
20-09-2020,17 - 18,871,1399,8513,2379,13162
20-09-2020,18 - 19,1021,1297,8636,2444,13398
20-09-2020,19 - 20,1093,1654,8833,2519,14099
20-09-2020,20 - 21,1070,1511,8545,2454,13580
20-09-2020,21 - 22,1004,1479,8051,2330,12864
20-09-2020,22 - 23,882,1651,7562,2212,12307
20-09-2020,23 - 00,881,1519,7128,2075,11603
21-09-2020,00 - 01,902,1483,6970,2007,11362
21-09-2020,01 - 02,968,1586,6981,1992,11527
21-09-2020,02 - 03,902,1390,6942,1985,11219
21-09-2020,03 - 04,940,1355,6942,1985,11222
21-09-2020,04 - 05,958,1669,7020,2023,11670
21-09-2020,05 - 06,894,1748,7316,2148,12106
21-09-2020,06 - 07,959,1646,8148,2470,13223
21-09-2020,07 - 08,902,1467,9031,2784,14184
21-09-2020,08 - 09,1032,1449,9409,2883,14773
21-09-2020,09 - 10,1101,1556,9387,2933,14977
21-09-2020,10 - 11,1152,1836,9579,2943,15510
21-09-2020,11 - 12,1155,1769,9584,2919,15427
21-09-2020,12 - 13,1164,1745,9413,2890,15212
21-09-2020,13 - 14,1160,1698,9376,2864,15098
21-09-2020,14 - 15,1092,1711,9319,2804,14926
21-09-2020,15 - 16,1162,1874,9288,2751,15075
21-09-2020,16 - 17,1109,1783,9247,2661,14800
21-09-2020,17 - 18,1035,1729,9509,2709,14982
21-09-2020,18 - 19,1055,1730,9399,2669,14853
21-09-2020,19 - 20,1217,1885,9479,2684,15265
21-09-2020,20 - 21,1142,1719,9170,2622,14653
21-09-2020,21 - 22,1151,1775,8568,2496,13990
21-09-2020,22 - 23,996,1879,7858,2309,13042
21-09-2020,23 - 00,1044,2011,7407,2096,12558
22-09-2020,00 - 01,1009,1767,7042,2043,11861
22-09-2020,01 - 02,989,1675,6813,2003,11480
22-09-2020,02 - 03,971,1600,6772,1980,11323
22-09-2020,03 - 04,957,1523,6674,2001,11155
22-09-2020,04 - 05,1001,1513,6748,2035,11297
22-09-2020,05 - 06,1015,1616,7284,2189,12104
22-09-2020,06 - 07,1062,1905,8246,2544,13757
22-09-2020,07 - 08,1081,1850,9006,2761,14698
22-09-2020,08 - 09,1055,1914,9300,2844,15113
22-09-2020,09 - 10,1072,1938,9307,2867,15184
22-09-2020,10 - 11,1282,1855,9313,2853,15303
22-09-2020,11 - 12,1278,2127,9243,2828,15476
22-09-2020,12 - 13,1080,1992,9133,2777,14982
22-09-2020,13 - 14,1160,2021,9060,2699,14940
22-09-2020,14 - 15,1102,1956,8871,2645,14574
22-09-2020,15 - 16,1170,1932,8829,2654,14585
22-09-2020,16 - 17,1309,1938,8790,2621,14658
22-09-2020,17 - 18,1283,1756,8989,2662,14690
22-09-2020,18 - 19,1304,1639,8997,2611,14551
22-09-2020,19 - 20,1228,1506,9175,2628,14537
22-09-2020,20 - 21,1156,1421,8927,2529,14033
22-09-2020,21 - 22,1110,1482,8429,2386,13407
22-09-2020,22 - 23,994,1443,7853,2215,12505
22-09-2020,23 - 00,964,1414,7378,2042,11798
23-09-2020,00 - 01,999,1320,7167,2010,11496
23-09-2020,01 - 02,948,1224,7076,2001,11249
23-09-2020,02 - 03,875,1380,7016,1969,11240
23-09-2020,03 - 04,1000,1490,7068,1997,11555
23-09-2020,04 - 05,1157,1514,7187,2049,11907
23-09-2020,05 - 06,849,1490,7506,2215,12060
23-09-2020,06 - 07,943,1515,8495,2558,13511
23-09-2020,07 - 08,1256,1651,9393,2814,15114
23-09-2020,08 - 09,1402,1543,9685,2855,15485
23-09-2020,09 - 10,1248,1676,9679,2805,15408
23-09-2020,10 - 11,1150,1721,9705,2828,15404
23-09-2020,11 - 12,1148,1554,9726,2803,15231
23-09-2020,12 - 13,1213,1788,9627,2732,15360
23-09-2020,13 - 14,1219,2050,9451,2710,15430
23-09-2020,14 - 15,1105,1890,9440,2653,15088
23-09-2020,15 - 16,1089,1857,9355,2659,14960
23-09-2020,16 - 17,1051,1790,9386,2650,14877
23-09-2020,17 - 18,1015,1663,9622,2718,15018
23-09-2020,18 - 19,1175,1439,9480,2692,14786
23-09-2020,19 - 20,1276,1693,9607,2741,15317
23-09-2020,20 - 21,1237,1675,9155,2573,14640
23-09-2020,21 - 22,1153,1608,8466,2392,13619
23-09-2020,22 - 23,1047,1568,7754,2206,12575
23-09-2020,23 - 00,1023,1375,7268,2040,11706
24-09-2020,00 - 01,988,1153,6878,1954,10973
24-09-2020,01 - 02,993,1210,6727,1892,10822
24-09-2020,02 - 03,1005,1259,6765,1838,10867
24-09-2020,03 - 04,982,1282,6789,1830,10883
24-09-2020,04 - 05,974,1229,6895,1888,10986
24-09-2020,05 - 06,987,1247,7320,1950,11504
24-09-2020,06 - 07,1015,1433,8284,2248,12980
24-09-2020,07 - 08,1066,1393,9022,2532,14013
24-09-2020,08 - 09,1035,1441,9288,2662,14426
24-09-2020,09 - 10,1018,1278,9346,2711,14353
24-09-2020,10 - 11,1155,1550,9381,2940,15026
24-09-2020,11 - 12,1187,1634,9470,2969,15260
24-09-2020,12 - 13,1217,1610,9427,2813,15067
24-09-2020,13 - 14,1079,1610,9273,2722,14684
24-09-2020,14 - 15,964,1499,9123,2656,14242
24-09-2020,15 - 16,1085,1510,9054,2664,14313
24-09-2020,16 - 17,937,1492,8940,2647,14016
24-09-2020,17 - 18,1094,1625,9161,2693,14573
24-09-2020,18 - 19,1154,1484,9200,2702,14540
24-09-2020,19 - 20,1029,1635,9482,2759,14905
24-09-2020,20 - 21,960,1641,9035,2605,14241
24-09-2020,21 - 22,975,1482,8425,2454,13336
24-09-2020,22 - 23,875,1410,7934,2314,12533
24-09-2020,23 - 00,1079,1465,7468,2182,12194
25-09-2020,00 - 01,1134,1282,7092,2065,11573
25-09-2020,01 - 02,926,1262,6933,2029,11150
25-09-2020,02 - 03,934,1332,6953,1951,11170
25-09-2020,03 - 04,978,1242,7005,1936,11161
25-09-2020,04 - 05,995,1377,7185,1955,11512
25-09-2020,05 - 06,1013,1423,7554,2064,12054
25-09-2020,06 - 07,1009,1528,8590,2384,13511
25-09-2020,07 - 08,938,1535,9410,2635,14518
25-09-2020,08 - 09,883,1604,9765,2734,14986
25-09-2020,09 - 10,970,1703,9726,2788,15187
25-09-2020,10 - 11,981,1789,9788,2823,15381
25-09-2020,11 - 12,914,1740,9731,2740,15125
25-09-2020,12 - 13,1025,1608,9627,2650,14910
25-09-2020,13 - 14,1060,1611,9403,2620,14694
25-09-2020,14 - 15,1115,1631,8987,2713,14446
25-09-2020,15 - 16,982,1670,8726,2821,14199
25-09-2020,16 - 17,839,1724,8748,2808,14119
25-09-2020,17 - 18,964,1799,9113,2837,14713
25-09-2020,18 - 19,1198,1897,9084,2841,15020
25-09-2020,19 - 20,1047,1807,9045,2739,14638
25-09-2020,20 - 21,964,1572,8467,2518,13521
25-09-2020,21 - 22,1035,1474,8068,2290,12867
25-09-2020,22 - 23,999,1321,7673,2178,12171
25-09-2020,23 - 00,897,1211,7572,2091,11771
26-09-2020,00 - 01,812,1053,7107,2020,10992
26-09-2020,01 - 02,733,1129,6830,1966,10658
26-09-2020,02 - 03,780,1006,6810,1871,10467
26-09-2020,03 - 04,815,1138,6722,1857,10532
26-09-2020,04 - 05,921,1253,6702,1816,10692
26-09-2020,05 - 06,836,1154,6836,1861,10687
26-09-2020,06 - 07,928,1297,7131,1972,11328
26-09-2020,07 - 08,1005,1377,7421,2049,11852
26-09-2020,08 - 09,1039,1413,7913,2177,12542
26-09-2020,09 - 10,1054,1443,8315,2278,13090
26-09-2020,10 - 11,1063,1416,8646,2334,13459
26-09-2020,11 - 12,1106,1460,8781,2336,13683
26-09-2020,12 - 13,1081,1361,8726,2307,13475
26-09-2020,13 - 14,940,1371,8517,2235,13063
26-09-2020,14 - 15,924,1369,8364,2197,12854
26-09-2020,15 - 16,859,1324,8180,2169,12532
26-09-2020,16 - 17,886,1437,8089,2170,12582
26-09-2020,17 - 18,885,1431,8206,2143,12665
26-09-2020,18 - 19,1096,1391,8339,2137,12963
26-09-2020,19 - 20,834,1586,8346,2219,12985
26-09-2020,20 - 21,862,1601,8029,2151,12643
26-09-2020,21 - 22,948,1224,7685,2045,11902
26-09-2020,22 - 23,1016,1100,7321,1934,11371
26-09-2020,23 - 00,1016,1177,7044,1868,11105
27-09-2020,00 - 01,1116,1224,6833,1807,10980
27-09-2020,01 - 02,918,1349,6673,1727,10667
27-09-2020,02 - 03,881,1252,6680,1731,10544
27-09-2020,03 - 04,827,1164,6570,1684,10245
27-09-2020,04 - 05,842,1175,6619,1612,10248
27-09-2020,05 - 06,929,1166,6667,1657,10419
27-09-2020,06 - 07,947,1199,6837,1699,10682
27-09-2020,07 - 08,894,1167,6975,1731,10767
27-09-2020,08 - 09,1066,1235,7464,1892,11657
27-09-2020,09 - 10,1087,1255,7868,1958,12168
27-09-2020,10 - 11,1132,1252,8149,1992,12525
27-09-2020,11 - 12,1127,1364,8162,2036,12689
27-09-2020,12 - 13,1037,1475,8186,2023,12721
27-09-2020,13 - 14,967,1579,8086,2036,12668
27-09-2020,14 - 15,1002,1557,8145,2008,12712
27-09-2020,15 - 16,1139,1611,8063,2002,12815
27-09-2020,16 - 17,1110,1454,8173,2143,12880
27-09-2020,17 - 18,1105,1692,8542,2283,13622
27-09-2020,18 - 19,1179,1722,8779,2314,13994
27-09-2020,19 - 20,1178,1756,8944,2448,14326
27-09-2020,20 - 21,1220,1739,8565,2310,13834
27-09-2020,21 - 22,1091,1602,8170,2111,12974
27-09-2020,22 - 23,1032,1578,7656,1978,12244
27-09-2020,23 - 00,1036,1471,7145,1868,11520
28-09-2020,00 - 01,1006,1476,7060,1793,11335
28-09-2020,01 - 02,959,1480,7004,1716,11159
28-09-2020,02 - 03,900,1438,7040,1695,11073
28-09-2020,03 - 04,839,1429,7117,1733,11118
28-09-2020,04 - 05,1029,1370,7338,1755,11492
28-09-2020,05 - 06,1012,1471,7682,1924,12089
28-09-2020,06 - 07,1026,1730,8935,2239,13930
28-09-2020,07 - 08,1151,1933,9917,2574,15575
28-09-2020,08 - 09,1206,1859,10093,2723,15881
28-09-2020,09 - 10,1149,1824,10105,2788,15866
28-09-2020,10 - 11,1118,1864,10175,2853,16010
28-09-2020,11 - 12,1098,1879,10250,2846,16073
28-09-2020,12 - 13,1041,1820,10181,2841,15883
28-09-2020,13 - 14,1099,1767,10082,2829,15777
28-09-2020,14 - 15,1133,1746,9990,2777,15646
28-09-2020,15 - 16,1105,1737,9945,2734,15521
28-09-2020,16 - 17,1144,1732,9899,2651,15426
28-09-2020,17 - 18,1029,1775,10056,2681,15541
28-09-2020,18 - 19,1222,1929,10083,2711,15945
28-09-2020,19 - 20,1218,1951,10076,2746,15991
28-09-2020,20 - 21,1163,1877,9708,2624,15372
28-09-2020,21 - 22,1175,1697,9092,2463,14427
28-09-2020,22 - 23,1014,1591,8426,2280,13311
28-09-2020,23 - 00,905,1434,7768,2099,12206
29-09-2020,00 - 01,882,1335,7460,1995,11672
29-09-2020,01 - 02,901,1311,7245,1974,11431
29-09-2020,02 - 03,922,1264,7150,1968,11304
29-09-2020,03 - 04,883,1295,7116,1980,11274
29-09-2020,04 - 05,875,1344,7238,2000,11457
29-09-2020,05 - 06,1048,1504,7713,2158,12423
29-09-2020,06 - 07,1213,1699,8788,2502,14202
29-09-2020,07 - 08,1259,1740,9613,2784,15396
29-09-2020,08 - 09,1225,1874,9867,2848,15814
29-09-2020,09 - 10,1178,1949,9925,2768,15820
29-09-2020,10 - 11,1163,1905,9926,2734,15728
29-09-2020,11 - 12,1133,1911,9974,2721,15739
29-09-2020,12 - 13,1171,1914,9935,2669,15689
29-09-2020,13 - 14,1187,1843,9728,2663,15421
29-09-2020,14 - 15,1132,1801,9698,2649,15280
29-09-2020,15 - 16,1147,1674,9635,2618,15074
29-09-2020,16 - 17,1190,1730,9606,2557,15083
29-09-2020,17 - 18,886,1733,9718,2566,14903
29-09-2020,18 - 19,1151,1856,9782,2587,15376
29-09-2020,19 - 20,1235,1849,9862,2664,15610
29-09-2020,20 - 21,1128,1833,9526,2533,15020
29-09-2020,21 - 22,1100,1765,8947,2399,14211
29-09-2020,22 - 23,973,1709,8363,2243,13288
29-09-2020,23 - 00,955,1467,7775,2058,12255
30-09-2020,00 - 01,917,1430,7424,1991,11762
30-09-2020,01 - 02,990,1384,7259,1969,11602
30-09-2020,02 - 03,898,1359,7176,1935,11368
30-09-2020,03 - 04,891,1258,7229,1950,11328
30-09-2020,04 - 05,843,1334,7276,1994,11447
30-09-2020,05 - 06,1001,1501,7748,2135,12385
30-09-2020,06 - 07,1084,1783,8960,2476,14303
30-09-2020,07 - 08,1128,1860,9729,2755,15472
30-09-2020,08 - 09,1112,1909,9993,2831,15845
30-09-2020,09 - 10,1101,1898,10024,2811,15834
30-09-2020,10 - 11,1142,1856,9911,2795,15704
30-09-2020,11 - 12,1202,1851,9816,2801,15670
30-09-2020,12 - 13,1218,1926,9723,2769,15636
30-09-2020,13 - 14,1229,1873,9639,2743,15484
30-09-2020,14 - 15,1033,1813,9546,2699,15091
30-09-2020,15 - 16,1067,1814,9552,2678,15111
30-09-2020,16 - 17,1061,1889,9570,2626,15146
30-09-2020,17 - 18,1063,1805,9754,2662,15284
30-09-2020,18 - 19,1104,1784,9922,2649,15459
30-09-2020,19 - 20,1143,1893,10064,2757,15857
30-09-2020,20 - 21,1087,1758,9838,2640,15323
30-09-2020,21 - 22,1011,1714,9293,2462,14480
30-09-2020,22 - 23,962,1630,8591,2306,13489
30-09-2020,23 - 00,1036,1626,8030,2137,12829
01-10-2020,00 - 01,918,1499,7648,2000,12065
01-10-2020,01 - 02,951,1384,7344,1963,11642
01-10-2020,02 - 03,963,1406,7303,2010,11682
01-10-2020,03 - 04,977,1457,7256,1982,11672
01-10-2020,04 - 05,963,1476,7304,1961,11704
01-10-2020,05 - 06,1003,1545,7733,2115,12396
01-10-2020,06 - 07,1156,1783,8872,2484,14295
01-10-2020,07 - 08,979,1932,9752,2770,15433
01-10-2020,08 - 09,1127,2010,10011,2867,16015
01-10-2020,09 - 10,1129,2076,10113,2918,16236
01-10-2020,10 - 11,1114,2021,10190,3001,16326
01-10-2020,11 - 12,1013,2080,10103,3035,16231
01-10-2020,12 - 13,1070,1916,10096,2964,16046
01-10-2020,13 - 14,1052,1991,10025,2955,16023
01-10-2020,14 - 15,867,1976,10016,2936,15795
01-10-2020,15 - 16,1020,1981,10008,2902,15911
01-10-2020,16 - 17,1076,1915,9995,2808,15794
01-10-2020,17 - 18,919,1823,10128,2828,15698
01-10-2020,18 - 19,1177,1809,10037,2813,15836
01-10-2020,19 - 20,1199,1875,9837,2844,15755
01-10-2020,20 - 21,1098,1649,9377,2702,14826
01-10-2020,21 - 22,1069,1543,8815,2467,13894
01-10-2020,22 - 23,1060,1379,8112,2259,12810
01-10-2020,23 - 00,966,1497,7560,2133,12156
02-10-2020,00 - 01,990,1318,7337,2056,11701
02-10-2020,01 - 02,965,1475,7115,1991,11546
02-10-2020,02 - 03,958,1516,7082,1921,11477
02-10-2020,03 - 04,1004,1430,7055,1920,11409
02-10-2020,04 - 05,980,1438,7200,1943,11561
02-10-2020,05 - 06,970,1324,7507,2101,11902
02-10-2020,06 - 07,1043,1427,8630,2497,13597
02-10-2020,07 - 08,1052,1634,9411,2761,14858
02-10-2020,08 - 09,1225,1633,9707,2808,15373
02-10-2020,09 - 10,921,1679,9763,2868,15231
02-10-2020,10 - 11,872,1669,9735,2920,15196
02-10-2020,11 - 12,892,1771,9605,2862,15130
02-10-2020,12 - 13,973,1810,9506,2777,15066
02-10-2020,13 - 14,1109,1763,9388,2671,14931
02-10-2020,14 - 15,1092,1640,9182,2624,14538
02-10-2020,15 - 16,969,1600,9061,2606,14236
02-10-2020,16 - 17,1088,1727,9045,2628,14488
02-10-2020,17 - 18,1006,1745,9343,2623,14717
02-10-2020,18 - 19,923,1645,9362,2709,14639
02-10-2020,19 - 20,954,1587,9168,2696,14405
02-10-2020,20 - 21,892,1459,8548,2449,13348
02-10-2020,21 - 22,855,1383,8106,2335,12679
02-10-2020,22 - 23,918,1357,7792,2150,12217
02-10-2020,23 - 00,948,1477,7583,2047,12055
03-10-2020,00 - 01,921,1415,7439,1939,11714
03-10-2020,01 - 02,887,1488,7151,1894,11420
03-10-2020,02 - 03,955,1628,6964,1895,11442
03-10-2020,03 - 04,946,1597,6953,1913,11409
03-10-2020,04 - 05,1128,1513,7053,1867,11561
03-10-2020,05 - 06,1019,1370,7174,1842,11405
03-10-2020,06 - 07,953,1165,7295,1902,11315
03-10-2020,07 - 08,843,1259,7683,1990,11775
03-10-2020,08 - 09,888,1342,7972,2170,12372
03-10-2020,09 - 10,1047,1444,8393,2340,13224
03-10-2020,10 - 11,1063,1499,8670,2313,13545
03-10-2020,11 - 12,1063,1415,8745,2371,13594
03-10-2020,12 - 13,1079,1659,8777,2340,13855
03-10-2020,13 - 14,1055,1735,8864,2336,13990
03-10-2020,14 - 15,1079,1784,8667,2327,13857
03-10-2020,15 - 16,1144,1720,8591,2332,13787
03-10-2020,16 - 17,1096,1468,8608,2384,13556
03-10-2020,17 - 18,1050,1448,8863,2463,13824
03-10-2020,18 - 19,1093,1452,9034,2513,14092
03-10-2020,19 - 20,1142,1501,8835,2459,13937
03-10-2020,20 - 21,1053,1499,8421,2309,13282
03-10-2020,21 - 22,1044,1373,8084,2204,12705
03-10-2020,22 - 23,1013,1319,7710,2062,12104
03-10-2020,23 - 00,933,1424,7362,1986,11705
04-10-2020,00 - 01,1010,1330,6952,1942,11234
04-10-2020,01 - 02,958,1388,6749,1863,10958
04-10-2020,02 - 03,937,1302,6696,1781,10716
04-10-2020,03 - 04,875,1159,6621,1851,10506
04-10-2020,04 - 05,811,1093,6574,1831,10309
04-10-2020,05 - 06,905,1095,6696,1757,10453
04-10-2020,06 - 07,930,1230,6915,1820,10895
04-10-2020,07 - 08,1159,1429,7097,1914,11599
04-10-2020,08 - 09,987,1435,7606,1972,12000
04-10-2020,09 - 10,969,1419,8018,2104,12510
04-10-2020,10 - 11,1179,1616,8406,2262,13463
04-10-2020,11 - 12,1110,1589,8708,2397,13804
04-10-2020,12 - 13,989,1510,8957,2466,13922
04-10-2020,13 - 14,943,1505,9068,2439,13955
04-10-2020,14 - 15,1069,1462,9026,2379,13936
04-10-2020,15 - 16,1138,1487,8970,2371,13966
04-10-2020,16 - 17,1134,1367,8941,2385,13827
04-10-2020,17 - 18,1028,1498,9189,2431,14146
04-10-2020,18 - 19,945,1616,9502,2531,14594
04-10-2020,19 - 20,977,1837,9402,2594,14810
04-10-2020,20 - 21,1140,1567,9096,2469,14272
04-10-2020,21 - 22,1157,1290,8412,2285,13144
04-10-2020,22 - 23,1052,1158,7893,2136,12239
04-10-2020,23 - 00,1011,1157,7495,1995,11658
05-10-2020,00 - 01,922,1150,7353,1927,11352
05-10-2020,01 - 02,900,1160,7239,1916,11215
05-10-2020,02 - 03,889,1216,7300,1944,11349
05-10-2020,03 - 04,808,992,7239,1985,11024
05-10-2020,04 - 05,765,1123,7213,1950,11051
05-10-2020,05 - 06,899,1159,7635,2076,11769
05-10-2020,06 - 07,989,1530,8938,2547,14004
05-10-2020,07 - 08,1086,1762,9802,2862,15512
05-10-2020,08 - 09,1066,1638,10048,2906,15658
05-10-2020,09 - 10,1066,1551,9963,2860,15440
05-10-2020,10 - 11,1071,1493,9953,2895,15412
05-10-2020,11 - 12,1008,1613,9861,2856,15338
05-10-2020,12 - 13,1129,1702,9778,2822,15431
05-10-2020,13 - 14,1170,1796,9672,2774,15412
05-10-2020,14 - 15,1296,1779,9579,2761,15415
05-10-2020,15 - 16,1260,1768,9563,2762,15353
05-10-2020,16 - 17,1261,1811,9526,2691,15289
05-10-2020,17 - 18,981,1923,9687,2763,15354
05-10-2020,18 - 19,1114,1879,9842,2780,15615
05-10-2020,19 - 20,1145,1872,9789,2810,15616
05-10-2020,20 - 21,1360,1787,9362,2721,15230
05-10-2020,21 - 22,1216,1783,8777,2574,14350
05-10-2020,22 - 23,1111,1595,8084,2375,13165
05-10-2020,23 - 00,1002,1581,7602,2172,12357
06-10-2020,00 - 01,975,1558,7221,2089,11843
06-10-2020,01 - 02,1015,1461,7076,2024,11576
06-10-2020,02 - 03,1028,1346,7092,2024,11490
06-10-2020,03 - 04,1051,1385,7064,2022,11522
06-10-2020,04 - 05,1080,1369,7143,2033,11625
06-10-2020,05 - 06,1050,1362,7546,2173,12131
06-10-2020,06 - 07,1141,1730,8636,2558,14065
06-10-2020,07 - 08,1006,1747,9572,2849,15174
06-10-2020,08 - 09,1155,1778,9891,2865,15689
06-10-2020,09 - 10,1024,2059,10065,2902,16050
06-10-2020,10 - 11,1186,1985,10236,2940,16347
06-10-2020,11 - 12,1062,1847,10316,2884,16109
06-10-2020,12 - 13,1060,1705,10218,2816,15799
06-10-2020,13 - 14,1175,1798,10157,2827,15957
06-10-2020,14 - 15,988,1918,10120,2864,15890
06-10-2020,15 - 16,922,1711,10051,2888,15572
06-10-2020,16 - 17,953,1807,10009,2899,15668
06-10-2020,17 - 18,1003,1763,10190,2899,15855
06-10-2020,18 - 19,922,1921,10275,2892,16010
06-10-2020,19 - 20,952,1798,10112,2865,15727
06-10-2020,20 - 21,890,1686,9752,2714,15042
06-10-2020,21 - 22,948,1663,9057,2511,14179
06-10-2020,22 - 23,1018,1428,8371,2368,13185
06-10-2020,23 - 00,1051,1429,7908,2198,12586
07-10-2020,00 - 01,1095,1422,7536,2085,12138
07-10-2020,01 - 02,1036,1445,7321,2025,11827
07-10-2020,02 - 03,960,1486,7316,1998,11760
07-10-2020,03 - 04,953,1500,7197,2006,11656
07-10-2020,04 - 05,935,1405,7276,2020,11636
07-10-2020,05 - 06,851,1605,7809,2211,12476
07-10-2020,06 - 07,968,1754,8901,2589,14212
07-10-2020,07 - 08,936,1834,9894,2841,15505
07-10-2020,08 - 09,1018,1780,10147,2904,15849
07-10-2020,09 - 10,1112,1901,10106,2941,16060
07-10-2020,10 - 11,1117,1900,10184,2987,16188
07-10-2020,11 - 12,1011,1749,10112,2977,15849
07-10-2020,12 - 13,1133,1759,10056,2791,15739
07-10-2020,13 - 14,975,1823,10014,2766,15578
07-10-2020,14 - 15,881,1839,10058,2815,15593
07-10-2020,15 - 16,1024,1859,10098,2760,15741
07-10-2020,16 - 17,980,1825,10099,2729,15633
07-10-2020,17 - 18,1025,1762,10296,2798,15881
07-10-2020,18 - 19,1059,1629,10475,2876,16039
07-10-2020,19 - 20,947,1729,10319,2823,15818
07-10-2020,20 - 21,909,1562,9835,2712,15018
07-10-2020,21 - 22,1015,1558,9300,2561,14434
07-10-2020,22 - 23,1043,1469,8648,2366,13526
07-10-2020,23 - 00,900,1279,8029,2188,12396
08-10-2020,00 - 01,771,1353,7661,2049,11834
08-10-2020,01 - 02,856,1297,7419,1999,11571
08-10-2020,02 - 03,898,1334,7315,1975,11522
08-10-2020,03 - 04,908,1267,7236,1984,11395
08-10-2020,04 - 05,970,1412,7200,2015,11597
08-10-2020,05 - 06,949,1541,7672,2154,12316
08-10-2020,06 - 07,1165,1784,8835,2503,14287
08-10-2020,07 - 08,1097,1727,9752,2735,15311
08-10-2020,08 - 09,1119,1824,10074,2896,15913
08-10-2020,09 - 10,1127,1898,10204,2868,16097
08-10-2020,10 - 11,1093,1819,10074,2942,15928
08-10-2020,11 - 12,1056,1816,10084,2946,15902
08-10-2020,12 - 13,1085,1780,10089,2874,15828
08-10-2020,13 - 14,983,1715,9897,2854,15449
08-10-2020,14 - 15,909,1780,9770,2796,15255
08-10-2020,15 - 16,1012,1694,9908,2785,15399
08-10-2020,16 - 17,1133,1777,10102,2838,15850
08-10-2020,17 - 18,1011,1840,10311,2903,16065
08-10-2020,18 - 19,1062,1808,10588,2955,16413
08-10-2020,19 - 20,1056,1871,10345,2951,16223
08-10-2020,20 - 21,876,1857,9718,2853,15304
08-10-2020,21 - 22,1046,1638,9143,2683,14510
08-10-2020,22 - 23,885,1498,8560,2501,13444
08-10-2020,23 - 00,886,1380,8142,2349,12757
09-10-2020,00 - 01,853,1182,7680,2094,11809
09-10-2020,01 - 02,935,1314,7445,2002,11696
09-10-2020,02 - 03,1008,1335,7310,1954,11607
09-10-2020,03 - 04,1014,1202,7301,1903,11420
09-10-2020,04 - 05,1031,1208,7383,1964,11586
09-10-2020,05 - 06,951,1349,7798,2070,12168
09-10-2020,06 - 07,1085,1779,8903,2477,14244
09-10-2020,07 - 08,1039,1859,9818,2759,15475
09-10-2020,08 - 09,1022,1839,10211,2930,16002
09-10-2020,09 - 10,1173,1930,10263,2941,16307
09-10-2020,10 - 11,1161,1953,10142,2823,16079
09-10-2020,11 - 12,1109,1899,9914,2719,15641
09-10-2020,12 - 13,1029,1859,9781,2669,15338
09-10-2020,13 - 14,1073,1956,9551,2641,15221
09-10-2020,14 - 15,1081,1859,9398,2645,14983
09-10-2020,15 - 16,1045,1817,9345,2584,14791
09-10-2020,16 - 17,931,1890,9419,2561,14801
09-10-2020,17 - 18,1023,1849,9720,2672,15264
09-10-2020,18 - 19,1025,1808,9906,2721,15460
09-10-2020,19 - 20,992,1761,9539,2600,14892
09-10-2020,20 - 21,822,1679,8989,2412,13902
09-10-2020,21 - 22,807,1556,8641,2289,13293
09-10-2020,22 - 23,760,1518,8280,2198,12756
09-10-2020,23 - 00,773,1429,7809,2092,12103
10-10-2020,00 - 01,879,1390,7586,1995,11850
10-10-2020,01 - 02,894,1218,7478,1889,11479
10-10-2020,02 - 03,889,1298,7437,1884,11508
10-10-2020,03 - 04,978,1264,7356,1961,11559
10-10-2020,04 - 05,974,1391,7392,1976,11733
10-10-2020,05 - 06,808,1506,7570,2013,11897
10-10-2020,06 - 07,929,1668,7807,2069,12473
10-10-2020,07 - 08,993,1650,8089,2245,12977
10-10-2020,08 - 09,991,1680,8554,2409,13634
10-10-2020,09 - 10,1147,1857,8966,2497,14467
10-10-2020,10 - 11,1183,1923,9337,2599,15042
10-10-2020,11 - 12,1117,1906,9448,2634,15105
10-10-2020,12 - 13,1025,1879,9476,2613,14993
10-10-2020,13 - 14,998,1760,9306,2592,14656
10-10-2020,14 - 15,937,1740,9199,2475,14351
10-10-2020,15 - 16,919,1754,9196,2513,14382
10-10-2020,16 - 17,980,1832,9199,2529,14540
10-10-2020,17 - 18,1043,1967,9423,2553,14986
10-10-2020,18 - 19,1023,1920,9640,2707,15290
10-10-2020,19 - 20,1055,1803,9489,2682,15029
10-10-2020,20 - 21,1026,1700,9009,2542,14277
10-10-2020,21 - 22,905,1657,8691,2399,13652
10-10-2020,22 - 23,954,1480,8304,2281,13019
10-10-2020,23 - 00,970,1400,7990,2212,12572
11-10-2020,00 - 01,741,1293,7784,2159,11977
11-10-2020,01 - 02,887,1313,7596,2067,11863
11-10-2020,02 - 03,921,1429,7580,2093,12023
11-10-2020,03 - 04,936,1392,7649,2058,12035
11-10-2020,04 - 05,939,1283,7657,2040,11919
11-10-2020,05 - 06,940,1183,7766,2143,12032
11-10-2020,06 - 07,1018,1318,7987,2221,12544
11-10-2020,07 - 08,1006,1521,8257,2357,13141
11-10-2020,08 - 09,1016,1622,8719,2475,13832
11-10-2020,09 - 10,1000,1768,9115,2578,14461
11-10-2020,10 - 11,1093,1975,9297,2616,14981
11-10-2020,11 - 12,1054,2080,9292,2645,15071
11-10-2020,12 - 13,1093,1888,9353,2596,14930
11-10-2020,13 - 14,1084,1983,9319,2569,14955
11-10-2020,14 - 15,1065,1921,9143,2509,14638
11-10-2020,15 - 16,1004,1859,9173,2486,14522
11-10-2020,16 - 17,1012,1893,9283,2550,14738
11-10-2020,17 - 18,1067,1949,9725,2696,15437
11-10-2020,18 - 19,1167,1823,10363,2829,16182
11-10-2020,19 - 20,1140,1767,10193,2791,15891
11-10-2020,20 - 21,1075,1872,9797,2641,15385
11-10-2020,21 - 22,1094,1836,9342,2531,14803
11-10-2020,22 - 23,968,1805,8728,2408,13909
11-10-2020,23 - 00,963,1671,8357,2352,13343
12-10-2020,00 - 01,867,1608,8085,2278,12838
12-10-2020,01 - 02,838,1608,8014,2220,12680
12-10-2020,02 - 03,928,1523,8014,2199,12664
12-10-2020,03 - 04,925,1512,7905,2207,12549
12-10-2020,04 - 05,941,1482,7898,2275,12596
12-10-2020,05 - 06,1041,1612,8440,2461,13554
12-10-2020,06 - 07,1241,2054,9671,2842,15808
12-10-2020,07 - 08,1273,2100,10665,3157,17195
12-10-2020,08 - 09,1506,1986,11066,3288,17846
12-10-2020,09 - 10,1384,1977,11055,3232,17648
12-10-2020,10 - 11,1416,1965,10926,3206,17513
12-10-2020,11 - 12,1160,2005,10922,3152,17239
12-10-2020,12 - 13,1097,1950,10710,3032,16789
12-10-2020,13 - 14,1001,2024,10412,2979,16416
12-10-2020,14 - 15,1132,2169,10368,2967,16636
12-10-2020,15 - 16,1218,1998,10346,2974,16536
12-10-2020,16 - 17,1088,1987,10383,2953,16411
12-10-2020,17 - 18,1048,1894,10740,3028,16710
12-10-2020,18 - 19,1198,1664,11058,3135,17055
12-10-2020,19 - 20,1089,1839,10947,3113,16988
12-10-2020,20 - 21,1327,1717,10521,3001,16566
12-10-2020,21 - 22,1197,1804,10035,2859,15895
12-10-2020,22 - 23,1094,1819,9440,2718,15071
12-10-2020,23 - 00,1073,1832,8985,2588,14478
13-10-2020,00 - 01,1097,1837,8605,2456,13995
13-10-2020,01 - 02,1118,1747,8502,2391,13758
13-10-2020,02 - 03,1051,1606,8468,2384,13509
13-10-2020,03 - 04,1062,1565,8499,2395,13521
13-10-2020,04 - 05,1021,1609,8568,2452,13650
13-10-2020,05 - 06,993,1781,9124,2614,14512
13-10-2020,06 - 07,1321,1876,10260,3005,16462
13-10-2020,07 - 08,1251,1962,11100,3327,17640
13-10-2020,08 - 09,1218,1926,11197,3341,17682
13-10-2020,09 - 10,1169,2076,10960,3235,17440
13-10-2020,10 - 11,1177,2129,10901,3172,17379
13-10-2020,11 - 12,1049,2012,10674,3091,16826
13-10-2020,12 - 13,1073,2041,10615,3042,16771
13-10-2020,13 - 14,1030,2122,10422,2990,16564
13-10-2020,14 - 15,1028,1967,10346,2921,16262
13-10-2020,15 - 16,1145,1877,10357,2913,16292
13-10-2020,16 - 17,1267,1857,10356,2881,16361
13-10-2020,17 - 18,1262,1870,10737,2956,16825
13-10-2020,18 - 19,1319,2212,11090,3075,17696
13-10-2020,19 - 20,1239,2131,10831,2977,17178
13-10-2020,20 - 21,1081,2082,10319,2912,16394
13-10-2020,21 - 22,1044,1940,9670,2706,15360
13-10-2020,22 - 23,1031,1657,9032,2470,14190
13-10-2020,23 - 00,1088,1632,8597,2327,13644
14-10-2020,00 - 01,1033,1565,8068,2190,12856
14-10-2020,01 - 02,1014,1510,7872,2170,12566
14-10-2020,02 - 03,1016,1596,7797,2162,12571
14-10-2020,03 - 04,982,1594,7957,2180,12713
14-10-2020,04 - 05,1008,1587,8160,2236,12991
14-10-2020,05 - 06,977,1594,8650,2389,13610
14-10-2020,06 - 07,1263,1686,9906,2846,15701
14-10-2020,07 - 08,1091,2019,10950,3205,17265
14-10-2020,08 - 09,1062,2052,11027,3287,17428
14-10-2020,09 - 10,1210,1921,11020,3303,17454
14-10-2020,10 - 11,1212,1854,10962,3336,17364
14-10-2020,11 - 12,1100,1902,10927,3269,17198
14-10-2020,12 - 13,1155,1867,10763,3163,16948
14-10-2020,13 - 14,1083,1858,10777,3128,16846
14-10-2020,14 - 15,1001,1762,10690,3133,16586
14-10-2020,15 - 16,1033,1645,10731,3122,16531
14-10-2020,16 - 17,1119,1595,10763,3092,16569
14-10-2020,17 - 18,999,1789,11140,3129,17057
14-10-2020,18 - 19,1120,1620,11377,3240,17357
14-10-2020,19 - 20,962,1500,11165,3178,16805
14-10-2020,20 - 21,908,1429,10719,3098,16154
14-10-2020,21 - 22,906,1309,9980,2928,15123
14-10-2020,22 - 23,931,1382,9489,2741,14543
14-10-2020,23 - 00,763,1265,8918,2560,13506
15-10-2020,00 - 01,354,1118,8606,2481,12559
15-10-2020,01 - 02,390,1161,8513,2460,12524
15-10-2020,02 - 03,422,1205,8438,2414,12479
15-10-2020,03 - 04,363,1194,8503,2439,12499
15-10-2020,04 - 05,817,1233,8568,2503,13121
15-10-2020,05 - 06,897,1214,8979,2609,13699
15-10-2020,06 - 07,1183,1604,10156,2981,15924
15-10-2020,07 - 08,1244,1856,11248,3355,17703
15-10-2020,08 - 09,1242,1826,11643,3403,18114
15-10-2020,09 - 10,1163,2083,11454,3446,18146
15-10-2020,10 - 11,1230,2122,11315,3415,18082
15-10-2020,11 - 12,1182,2015,11141,3340,17678
15-10-2020,12 - 13,1188,1935,10976,3256,17355
15-10-2020,13 - 14,1097,2032,10809,3170,17108
15-10-2020,14 - 15,1048,1947,10748,3128,16871
15-10-2020,15 - 16,967,2051,10751,3092,16861
15-10-2020,16 - 17,1272,1933,11217,3068,17490
15-10-2020,17 - 18,974,1949,11346,3179,17448
15-10-2020,18 - 19,1156,1891,11425,3292,17764
15-10-2020,19 - 20,923,1858,11281,3235,17297
15-10-2020,20 - 21,897,1754,10855,3105,16611
15-10-2020,21 - 22,970,1693,10325,2901,15889
15-10-2020,22 - 23,1079,1711,9610,2733,15133
15-10-2020,23 - 00,1062,1465,8985,2562,14074
16-10-2020,00 - 01,928,1492,8789,2496,13705
16-10-2020,01 - 02,1050,1531,8540,2490,13611
16-10-2020,02 - 03,1128,1583,8388,2521,13620
16-10-2020,03 - 04,1138,1724,8356,2514,13732
16-10-2020,04 - 05,1175,1819,8410,2497,13901
16-10-2020,05 - 06,1153,1710,8809,2594,14266
16-10-2020,06 - 07,1442,1760,9935,2983,16120
16-10-2020,07 - 08,1161,1966,10991,3365,17483
16-10-2020,08 - 09,1154,1928,11084,3412,17578
16-10-2020,09 - 10,1259,1971,11079,3430,17739
16-10-2020,10 - 11,1117,2142,11102,3366,17727
16-10-2020,11 - 12,1085,2122,10926,3263,17396
16-10-2020,12 - 13,1102,2038,10796,3213,17149
16-10-2020,13 - 14,1078,1888,10564,3116,16646
16-10-2020,14 - 15,1071,1869,10519,3073,16532
16-10-2020,15 - 16,1204,1846,10364,3006,16420
16-10-2020,16 - 17,1127,1887,10361,2997,16372
16-10-2020,17 - 18,1049,2001,10810,3076,16936
16-10-2020,18 - 19,1008,1732,11171,3163,17074
16-10-2020,19 - 20,911,1763,10841,2984,16499
16-10-2020,20 - 21,863,1676,10438,2800,15777
16-10-2020,21 - 22,1031,1688,10028,2613,15360
16-10-2020,22 - 23,1121,1660,9630,2472,14883
16-10-2020,23 - 00,989,1453,9292,2366,14100
17-10-2020,00 - 01,997,1704,8989,2347,14037
17-10-2020,01 - 02,954,1640,8785,2313,13692
17-10-2020,02 - 03,975,1659,8695,2290,13619
17-10-2020,03 - 04,952,1595,8583,2330,13460
17-10-2020,04 - 05,947,1611,8514,2331,13403
17-10-2020,05 - 06,941,1519,8660,2419,13539
17-10-2020,06 - 07,954,1651,8854,2521,13980
17-10-2020,07 - 08,903,1709,9116,2673,14401
17-10-2020,08 - 09,984,1685,9474,2817,14960
17-10-2020,09 - 10,999,1837,9663,2847,15346
17-10-2020,10 - 11,1101,1904,9594,2824,15423
17-10-2020,11 - 12,1092,1956,9491,2720,15259
17-10-2020,12 - 13,1151,1893,9313,2671,15028
17-10-2020,13 - 14,1114,1789,9273,2608,14784
17-10-2020,14 - 15,1211,1935,9251,2586,14983
17-10-2020,15 - 16,1351,1833,9370,2623,15177
17-10-2020,16 - 17,1070,1789,9656,2686,15201
17-10-2020,17 - 18,1196,1962,10066,2818,16042
17-10-2020,18 - 19,1078,2004,10254,2886,16222
17-10-2020,19 - 20,1111,2002,9916,2766,15795
17-10-2020,20 - 21,1043,1790,9513,2650,14996
17-10-2020,21 - 22,1059,1886,9041,2531,14517
17-10-2020,22 - 23,1015,1925,8525,2355,13820
17-10-2020,23 - 00,1063,1818,8192,2199,13272
18-10-2020,00 - 01,1043,1456,7920,2146,12565
18-10-2020,01 - 02,960,1407,7792,2152,12311
18-10-2020,02 - 03,931,1443,7803,2187,12364
18-10-2020,03 - 04,939,1476,7853,2202,12470
18-10-2020,04 - 05,955,1392,7938,2157,12442
18-10-2020,05 - 06,1084,1383,8312,2111,12890
18-10-2020,06 - 07,1061,1830,8539,2134,13564
18-10-2020,07 - 08,1052,1815,8900,2275,14042
18-10-2020,08 - 09,1070,1802,9295,2432,14599
18-10-2020,09 - 10,1123,1885,9533,2598,15139
18-10-2020,10 - 11,1091,2015,9646,2666,15418
18-10-2020,11 - 12,1110,1994,9676,2659,15439
18-10-2020,12 - 13,1155,1909,9689,2597,15350
18-10-2020,13 - 14,1240,1823,9588,2508,15159
18-10-2020,14 - 15,1226,1864,9492,2378,14960
18-10-2020,15 - 16,1216,1879,9546,2327,14968
18-10-2020,16 - 17,1232,1786,9902,2465,15385
18-10-2020,17 - 18,1262,1917,10559,2787,16525
18-10-2020,18 - 19,1140,1851,10869,2897,16757
18-10-2020,19 - 20,1136,1890,10652,2870,16548
18-10-2020,20 - 21,1165,1660,10340,2706,15871
18-10-2020,21 - 22,1215,1707,10020,2557,15499
18-10-2020,22 - 23,1204,1699,9709,2442,15054
18-10-2020,23 - 00,1165,1684,9298,2329,14476
19-10-2020,00 - 01,1143,1638,9095,2395,14271
19-10-2020,01 - 02,1100,1623,8954,2409,14086
19-10-2020,02 - 03,1144,1597,8995,2429,14165
19-10-2020,03 - 04,1078,1638,9051,2404,14171
19-10-2020,04 - 05,1141,1643,9265,2444,14493
19-10-2020,05 - 06,1097,1754,9850,2598,15299
19-10-2020,06 - 07,1171,1931,11075,2946,17123
19-10-2020,07 - 08,1154,2080,12089,3299,18622
19-10-2020,08 - 09,1220,1920,12414,3395,18949
19-10-2020,09 - 10,1220,2031,12127,3408,18786
19-10-2020,10 - 11,1180,2061,12044,3397,18682
19-10-2020,11 - 12,1225,1982,11756,3319,18282
19-10-2020,12 - 13,1190,2036,11480,3142,17848
19-10-2020,13 - 14,1081,1980,11206,3056,17323
19-10-2020,14 - 15,1011,1981,11072,3047,17111
19-10-2020,15 - 16,1092,2052,11129,3112,17385
19-10-2020,16 - 17,1204,1872,11213,3104,17393
19-10-2020,17 - 18,1031,1831,11695,3212,17769
19-10-2020,18 - 19,1242,2029,12069,3313,18653
19-10-2020,19 - 20,1182,2056,11918,3264,18420
19-10-2020,20 - 21,1094,1979,11632,3128,17833
19-10-2020,21 - 22,1101,1829,11179,3020,17129
19-10-2020,22 - 23,919,1843,10672,2859,16293
19-10-2020,23 - 00,925,1831,10174,2728,15658
20-10-2020,00 - 01,990,1785,9692,2620,15087
20-10-2020,01 - 02,982,1764,9525,2567,14838
20-10-2020,02 - 03,969,1780,9498,2519,14766
20-10-2020,03 - 04,982,1778,9419,2496,14675
20-10-2020,04 - 05,1081,1776,9511,2524,14892
20-10-2020,05 - 06,1133,2016,10081,2676,15906
20-10-2020,06 - 07,1216,2183,11161,2994,17554
20-10-2020,07 - 08,1164,2277,12166,3318,18925
20-10-2020,08 - 09,1334,2278,12262,3326,19200
20-10-2020,09 - 10,1249,2220,12277,3345,19091
20-10-2020,10 - 11,1243,2147,12227,3359,18976
20-10-2020,11 - 12,1298,2218,12156,3298,18970
20-10-2020,12 - 13,1388,2259,12053,3229,18929
20-10-2020,13 - 14,1276,2265,11741,3211,18493
20-10-2020,14 - 15,1262,2189,11612,3187,18250
20-10-2020,15 - 16,1377,2148,11670,3132,18327
20-10-2020,16 - 17,1377,2108,11823,3108,18416
20-10-2020,17 - 18,1528,1977,12166,3170,18841
20-10-2020,18 - 19,1527,2109,12006,3189,18831
20-10-2020,19 - 20,1513,2038,11541,3064,18156
20-10-2020,20 - 21,1274,2018,10993,2969,17254
20-10-2020,21 - 22,1322,1959,10367,2838,16486
20-10-2020,22 - 23,1168,1713,9519,2695,15095
20-10-2020,23 - 00,1184,1551,9009,2512,14256
21-10-2020,00 - 01,1131,1432,8682,2407,13652
21-10-2020,01 - 02,1112,1658,8468,2322,13560
21-10-2020,02 - 03,1151,1836,8385,2295,13667
21-10-2020,03 - 04,1132,1926,8467,2280,13805
21-10-2020,04 - 05,1259,1826,8600,2340,14025
21-10-2020,05 - 06,1222,1786,8978,2489,14475
21-10-2020,06 - 07,1249,2008,9987,2847,16091
21-10-2020,07 - 08,1334,2277,11032,3159,17802
21-10-2020,08 - 09,1486,2368,11048,3214,18116
21-10-2020,09 - 10,1487,2272,11120,3208,18087
21-10-2020,10 - 11,1330,2268,11126,3240,17964
21-10-2020,11 - 12,1306,2258,11139,3301,18004
21-10-2020,12 - 13,1299,2277,11019,3311,17906
21-10-2020,13 - 14,1307,2389,10817,3285,17798
21-10-2020,14 - 15,1281,2334,10646,3267,17528
21-10-2020,15 - 16,1285,2183,10624,3240,17332
21-10-2020,16 - 17,1423,2214,10665,3158,17460
21-10-2020,17 - 18,1194,2206,11129,3204,17733
21-10-2020,18 - 19,1328,2400,11212,3232,18172
21-10-2020,19 - 20,1370,2381,10765,3119,17635
21-10-2020,20 - 21,1327,2165,10286,2956,16734
21-10-2020,21 - 22,1153,2114,9795,2754,15816
21-10-2020,22 - 23,1113,1977,9038,2584,14712
21-10-2020,23 - 00,1032,1889,8433,2395,13749
22-10-2020,00 - 01,1058,1692,8176,2310,13236
22-10-2020,01 - 02,1065,1714,7903,2254,12936
22-10-2020,02 - 03,1154,1821,7822,2203,13000
22-10-2020,03 - 04,1146,1844,7882,2185,13057
22-10-2020,04 - 05,1118,1879,8054,2182,13233
22-10-2020,05 - 06,1140,2097,8468,2345,14050
22-10-2020,06 - 07,1313,2202,9546,2703,15764
22-10-2020,07 - 08,1360,2209,10616,3048,17233
22-10-2020,08 - 09,1044,2284,10665,3066,17059
22-10-2020,09 - 10,1365,2184,10789,3106,17444
22-10-2020,10 - 11,1404,2212,10809,3204,17629
22-10-2020,11 - 12,1297,2222,10816,3196,17531
22-10-2020,12 - 13,1342,2149,10743,3062,17296
22-10-2020,13 - 14,1301,2211,10480,3043,17035
22-10-2020,14 - 15,1380,2201,10403,3055,17039
22-10-2020,15 - 16,1386,2191,10508,3080,17165
22-10-2020,16 - 17,1440,2322,10396,2976,17134
22-10-2020,17 - 18,1518,2445,10818,3110,17891
22-10-2020,18 - 19,1460,2496,10956,3166,18078
22-10-2020,19 - 20,1414,2274,10523,3104,17315
22-10-2020,20 - 21,1370,2323,9996,2990,16679
22-10-2020,21 - 22,1200,2236,9554,2808,15798
22-10-2020,22 - 23,1198,2091,8994,2640,14923
22-10-2020,23 - 00,1188,1941,8500,2476,14105
23-10-2020,00 - 01,1312,1903,8051,2200,13466
23-10-2020,01 - 02,1293,1987,7854,2141,13275
23-10-2020,02 - 03,1221,1894,7636,2137,12888
23-10-2020,03 - 04,1318,1891,7718,2166,13093
23-10-2020,04 - 05,1193,1957,7784,2156,13090
23-10-2020,05 - 06,1248,2021,8242,2338,13849
23-10-2020,06 - 07,1574,2136,9498,2719,15927
23-10-2020,07 - 08,1582,2198,10509,3067,17356
23-10-2020,08 - 09,1370,2182,10948,3146,17646
23-10-2020,09 - 10,1292,2192,11079,3183,17746
23-10-2020,10 - 11,1237,2228,11146,3251,17862
23-10-2020,11 - 12,1150,2082,11255,3200,17687
23-10-2020,12 - 13,1158,2182,11089,3160,17589
23-10-2020,13 - 14,1215,2269,10926,3093,17503
23-10-2020,14 - 15,1358,2265,10774,2998,17395
23-10-2020,15 - 16,1354,2172,10757,2923,17206
23-10-2020,16 - 17,1216,2187,10868,2868,17139
23-10-2020,17 - 18,1328,2179,11307,2947,17761
23-10-2020,18 - 19,1324,2253,11605,3003,18185
23-10-2020,19 - 20,1126,2237,11113,2848,17324
23-10-2020,20 - 21,930,2227,10670,2703,16530
23-10-2020,21 - 22,971,2197,10218,2607,15993
23-10-2020,22 - 23,976,2106,9781,2494,15357
23-10-2020,23 - 00,1086,1980,9374,2361,14801
24-10-2020,00 - 01,1183,1910,8908,2175,14176
24-10-2020,01 - 02,1093,1907,8624,2091,13715
24-10-2020,02 - 03,990,1934,8419,2083,13426
24-10-2020,03 - 04,977,1955,8239,2078,13249
24-10-2020,04 - 05,966,2143,8281,2066,13456
24-10-2020,05 - 06,1062,2132,8305,2073,13572
24-10-2020,06 - 07,1011,2176,8541,2134,13862
24-10-2020,07 - 08,902,2344,8977,2208,14431
24-10-2020,08 - 09,994,2266,9359,2392,15011
24-10-2020,09 - 10,1111,2291,9730,2598,15730
24-10-2020,10 - 11,1029,2233,9998,2638,15898
24-10-2020,11 - 12,1085,2156,10042,2613,15896
24-10-2020,12 - 13,1152,2105,9966,2564,15787
24-10-2020,13 - 14,1173,2039,9923,2543,15678
24-10-2020,14 - 15,1119,2100,9864,2484,15567
24-10-2020,15 - 16,1181,2084,9933,2527,15725
24-10-2020,16 - 17,1269,2234,10131,2601,16235
24-10-2020,17 - 18,1289,2355,10567,2751,16962
24-10-2020,18 - 19,1248,2325,10722,2845,17140
24-10-2020,19 - 20,1241,2360,10348,2658,16607
24-10-2020,20 - 21,1242,2254,9941,2533,15970
24-10-2020,21 - 22,1244,2127,9525,2454,15350
24-10-2020,22 - 23,1283,2033,9131,2339,14786
24-10-2020,23 - 00,1168,1991,8664,2226,14049
25-10-2020,00 - 01,1146,1955,8336,2137,13574
25-10-2020,01 - 02,1210,1817,8095,2100,13222
25-10-2020,02 - 03,1180,1466,8053,2046,12745
25-10-2020,02 - 03,1199,1643,7915,1911,12668
25-10-2020,03 - 04,1136,1590,7843,1922,12491
25-10-2020,04 - 05,1117,1432,7781,1924,12254
25-10-2020,05 - 06,1149,1401,7868,2012,12430
25-10-2020,06 - 07,1153,1640,8094,2101,12988
25-10-2020,07 - 08,1224,1709,8286,2218,13437
25-10-2020,08 - 09,1174,1852,8661,2344,14031
25-10-2020,09 - 10,1218,1741,9096,2436,14491
25-10-2020,10 - 11,1224,1608,9342,2491,14665
25-10-2020,11 - 12,1240,1817,9717,2553,15327
25-10-2020,12 - 13,1114,1816,9710,2578,15218
25-10-2020,13 - 14,1185,1863,9626,2593,15267
25-10-2020,14 - 15,1232,1982,9684,2624,15522
25-10-2020,15 - 16,1126,2035,9753,2658,15572
25-10-2020,16 - 17,1151,2048,10133,2773,16105
25-10-2020,17 - 18,1201,1952,10401,2923,16477
25-10-2020,18 - 19,1244,1902,10151,2889,16186
25-10-2020,19 - 20,1186,1889,9824,2840,15739
25-10-2020,20 - 21,1120,1899,9563,2724,15306
25-10-2020,21 - 22,1244,1886,9192,2576,14898
25-10-2020,22 - 23,1360,2074,8545,2317,14296
25-10-2020,23 - 00,1107,2177,8142,2201,13627
26-10-2020,00 - 01,923,1982,7813,2150,12868
26-10-2020,01 - 02,906,1841,7737,2098,12582
26-10-2020,02 - 03,1051,1776,7609,2037,12473
26-10-2020,03 - 04,1226,1788,7564,2048,12626
26-10-2020,04 - 05,1180,1685,7678,2068,12611
26-10-2020,05 - 06,1114,1636,8255,2189,13194
26-10-2020,06 - 07,1200,1962,9373,2510,15045
26-10-2020,07 - 08,1402,1898,10080,2818,16198
26-10-2020,08 - 09,1399,1714,10486,2960,16559
26-10-2020,09 - 10,1212,1713,10604,2946,16475
26-10-2020,10 - 11,1292,1676,10843,3020,16831
26-10-2020,11 - 12,1194,1585,10817,3111,16707
26-10-2020,12 - 13,1140,1711,10754,3069,16674
26-10-2020,13 - 14,1167,1813,10779,3064,16823
26-10-2020,14 - 15,1197,1826,10714,3008,16745
26-10-2020,15 - 16,1111,1658,10778,3038,16585
26-10-2020,16 - 17,1160,1586,10972,3090,16808
26-10-2020,17 - 18,1194,1499,11172,3157,17022
26-10-2020,18 - 19,1260,1462,10870,3036,16628
26-10-2020,19 - 20,1178,1696,10514,2885,16273
26-10-2020,20 - 21,944,1812,10045,2748,15549
26-10-2020,21 - 22,981,1677,9528,2578,14764
26-10-2020,22 - 23,976,1489,8911,2412,13788
26-10-2020,23 - 00,932,1453,8278,2230,12893
27-10-2020,00 - 01,770,1490,7934,2116,12310
27-10-2020,01 - 02,922,1377,7699,2075,12073
27-10-2020,02 - 03,1048,1357,7670,2143,12218
27-10-2020,03 - 04,976,1419,7675,2144,12214
27-10-2020,04 - 05,1020,1404,7823,2144,12391
27-10-2020,05 - 06,1087,1565,8270,2282,13204
27-10-2020,06 - 07,1033,1694,9343,2598,14668
27-10-2020,07 - 08,991,1908,10106,2848,15853
27-10-2020,08 - 09,1152,1744,10349,3011,16256
27-10-2020,09 - 10,1246,1721,10516,3148,16631
27-10-2020,10 - 11,1216,1687,10667,3216,16786
27-10-2020,11 - 12,1129,1638,10691,3143,16601
27-10-2020,12 - 13,1116,1585,10688,3092,16481
27-10-2020,13 - 14,908,1708,10591,3171,16378
27-10-2020,14 - 15,841,1630,10490,3079,16040
27-10-2020,15 - 16,1136,1559,10589,3073,16357
27-10-2020,16 - 17,1315,1583,10844,3136,16878
27-10-2020,17 - 18,1229,1651,11406,3241,17527
27-10-2020,18 - 19,1225,1508,10967,3149,16849
27-10-2020,19 - 20,1187,1331,10502,2987,16007
27-10-2020,20 - 21,1015,1377,10076,2805,15273
27-10-2020,21 - 22,1146,1534,9512,2649,14841
27-10-2020,22 - 23,1115,1510,9001,2479,14105
27-10-2020,23 - 00,773,1445,8508,2292,13018
28-10-2020,00 - 01,627,1401,8138,2216,12382
28-10-2020,01 - 02,1012,1294,7989,2108,12403
28-10-2020,02 - 03,1230,1329,7914,2064,12537
28-10-2020,03 - 04,1318,1477,7696,2095,12586
28-10-2020,04 - 05,1135,1501,7826,2210,12672
28-10-2020,05 - 06,990,1363,8456,2421,13230
28-10-2020,06 - 07,1004,1655,9628,2779,15066
28-10-2020,07 - 08,1044,1572,10413,3090,16119
28-10-2020,08 - 09,1097,1800,10708,3187,16792
28-10-2020,09 - 10,1107,1735,10836,3239,16917
28-10-2020,10 - 11,1116,1671,10933,3231,16951
28-10-2020,11 - 12,1140,1600,10839,3207,16786
28-10-2020,12 - 13,1175,1672,10709,3155,16711
28-10-2020,13 - 14,1176,1557,10739,3188,16660
28-10-2020,14 - 15,1153,1330,10829,3190,16502
28-10-2020,15 - 16,1174,1488,10796,3141,16599
28-10-2020,16 - 17,1203,1687,10938,3145,16973
28-10-2020,17 - 18,1148,1748,11164,3279,17339
28-10-2020,18 - 19,1231,1731,10937,3160,17059
28-10-2020,19 - 20,1163,1529,10633,3033,16358
28-10-2020,20 - 21,1025,1506,10271,2864,15666
28-10-2020,21 - 22,988,1423,9764,2737,14912
28-10-2020,22 - 23,1048,1417,9254,2601,14320
28-10-2020,23 - 00,1099,1317,8689,2460,13565
29-10-2020,00 - 01,973,1223,8377,2356,12929
29-10-2020,01 - 02,986,1346,8142,2282,12756
29-10-2020,02 - 03,1043,1280,8000,2257,12580
29-10-2020,03 - 04,1052,1223,8020,2236,12531
29-10-2020,04 - 05,1047,1346,8220,2281,12894
29-10-2020,05 - 06,979,1393,8690,2413,13475
29-10-2020,06 - 07,973,1454,9685,2752,14864
29-10-2020,07 - 08,992,1559,10468,3043,16062
29-10-2020,08 - 09,1106,1692,10882,3173,16853
29-10-2020,09 - 10,1178,1787,10957,3172,17094
29-10-2020,10 - 11,1124,1820,10993,3187,17124
29-10-2020,11 - 12,1088,1921,10936,3210,17155
29-10-2020,12 - 13,1171,1919,10798,3168,17056
29-10-2020,13 - 14,1208,1873,10694,3146,16921
29-10-2020,14 - 15,1128,1873,10684,3111,16796
29-10-2020,15 - 16,1193,1891,10782,3099,16965
29-10-2020,16 - 17,1306,1948,11202,3123,17579
29-10-2020,17 - 18,1334,2036,11663,3270,18303
29-10-2020,18 - 19,1293,2083,11398,3189,17963
29-10-2020,19 - 20,1209,2104,11135,3101,17549
29-10-2020,20 - 21,1264,1992,10686,2959,16901
29-10-2020,21 - 22,1233,1917,10146,2776,16072
29-10-2020,22 - 23,1186,1749,9599,2610,15144
29-10-2020,23 - 00,1150,1557,9132,2459,14298
30-10-2020,00 - 01,1126,1563,8744,2346,13779
30-10-2020,01 - 02,996,1568,8620,2295,13479
30-10-2020,02 - 03,1024,1602,8533,2279,13438
30-10-2020,03 - 04,1188,1634,8536,2269,13627
30-10-2020,04 - 05,1083,1606,8708,2305,13702
30-10-2020,05 - 06,1025,1614,9161,2427,14227
30-10-2020,06 - 07,1353,1791,10195,2728,16067
30-10-2020,07 - 08,1114,2015,10994,3035,17158
30-10-2020,08 - 09,1054,1916,11355,3139,17464
30-10-2020,09 - 10,1093,1992,11411,3222,17718
30-10-2020,10 - 11,1215,2021,11528,3263,18027
30-10-2020,11 - 12,1204,2005,11362,3243,17814
30-10-2020,12 - 13,1197,2062,11272,3215,17746
30-10-2020,13 - 14,1283,2111,11059,3185,17638
30-10-2020,14 - 15,1219,1875,10936,3134,17164
30-10-2020,15 - 16,1145,1844,10846,3079,16914
30-10-2020,16 - 17,1327,1905,11321,3147,17700
30-10-2020,17 - 18,1194,1895,11577,3228,17894
30-10-2020,18 - 19,1097,1781,11175,3145,17198
30-10-2020,19 - 20,1104,1722,10721,2998,16545
30-10-2020,20 - 21,1102,1644,10449,2842,16037
30-10-2020,21 - 22,1171,1541,9957,2671,15340
30-10-2020,22 - 23,1043,1410,9482,2553,14488
30-10-2020,23 - 00,1017,1243,9077,2410,13747
31-10-2020,00 - 01,965,1257,8604,2202,13028
31-10-2020,01 - 02,1007,1330,8444,2110,12891
31-10-2020,02 - 03,1042,1237,8182,2110,12571
31-10-2020,03 - 04,1034,1418,8073,2045,12570
31-10-2020,04 - 05,892,1489,7992,2007,12380
31-10-2020,05 - 06,846,1463,8158,2007,12474
31-10-2020,06 - 07,1001,1587,8514,2151,13253
31-10-2020,07 - 08,1039,1585,8737,2234,13595
31-10-2020,08 - 09,1020,1705,9057,2351,14133
31-10-2020,09 - 10,1139,1737,9389,2510,14775
31-10-2020,10 - 11,981,1744,9552,2613,14890
31-10-2020,11 - 12,1079,1924,9628,2686,15317
31-10-2020,12 - 13,1108,1856,9536,2677,15177
31-10-2020,13 - 14,1121,1894,9471,2692,15178
31-10-2020,14 - 15,1086,1864,9492,2635,15077
31-10-2020,15 - 16,1204,1958,9615,2654,15431
31-10-2020,16 - 17,1382,2041,10107,2818,16348
31-10-2020,17 - 18,1400,2016,10230,2918,16564
31-10-2020,18 - 19,1227,1918,9937,2866,15948
31-10-2020,19 - 20,1202,1821,9502,2736,15261
31-10-2020,20 - 21,1162,1746,9050,2549,14507
31-10-2020,21 - 22,1038,1666,8662,2445,13811
31-10-2020,22 - 23,966,1859,8287,2317,13429
31-10-2020,23 - 00,864,1639,7949,2196,12648
01-11-2020,00 - 01,904,1585,7688,2126,12303
01-11-2020,01 - 02,1045,1450,7527,2080,12102
01-11-2020,02 - 03,1166,1399,7481,2048,12094
01-11-2020,03 - 04,1057,1261,7298,2001,11617
01-11-2020,04 - 05,943,1226,7179,2027,11375
01-11-2020,05 - 06,815,1245,7255,2042,11357
01-11-2020,06 - 07,805,1367,7535,2092,11799
01-11-2020,07 - 08,899,1386,7755,2185,12225
01-11-2020,08 - 09,1047,1414,8103,2349,12913
01-11-2020,09 - 10,928,1436,8571,2540,13475
01-11-2020,10 - 11,958,1537,8939,2603,14037
01-11-2020,11 - 12,1077,1404,9144,2549,14174
01-11-2020,12 - 13,960,1399,9265,2491,14115
01-11-2020,13 - 14,948,1421,9257,2461,14087
01-11-2020,14 - 15,1040,1463,9401,2508,14412
01-11-2020,15 - 16,1190,1315,9646,2528,14679
01-11-2020,16 - 17,1185,1620,10121,2711,15637
01-11-2020,17 - 18,1149,1559,10283,2881,15872
01-11-2020,18 - 19,1134,1567,10071,2739,15511
01-11-2020,19 - 20,1075,1793,9796,2585,15249
01-11-2020,20 - 21,1068,1689,9338,2481,14576
01-11-2020,21 - 22,1072,1596,8820,2346,13834
01-11-2020,22 - 23,1032,1512,8342,2216,13102
01-11-2020,23 - 00,951,1342,7896,2089,12278
02-11-2020,00 - 01,1029,1243,7693,2005,11970
02-11-2020,01 - 02,1117,1372,7568,1941,11998
02-11-2020,02 - 03,1064,1434,7431,2008,11937
02-11-2020,03 - 04,1035,1313,7425,2027,11800
02-11-2020,04 - 05,1136,1249,7505,2064,11954
02-11-2020,05 - 06,1048,1325,8094,2199,12666
02-11-2020,06 - 07,1199,1684,9275,2570,14728
02-11-2020,07 - 08,1231,1817,10220,2944,16212
02-11-2020,08 - 09,1237,1761,10520,3044,16562
02-11-2020,09 - 10,1270,1780,10566,3072,16688
02-11-2020,10 - 11,1277,1823,10754,3124,16978
02-11-2020,11 - 12,1338,1816,10720,3159,17033
02-11-2020,12 - 13,1282,1885,10769,3092,17028
02-11-2020,13 - 14,1287,1879,10573,3075,16814
02-11-2020,14 - 15,1248,1673,10540,3035,16496
02-11-2020,15 - 16,1295,1637,10606,3046,16584
02-11-2020,16 - 17,1221,1785,10899,3089,16994
02-11-2020,17 - 18,1370,1819,11146,3219,17554
02-11-2020,18 - 19,1153,1777,10905,3092,16927
02-11-2020,19 - 20,1190,1589,10564,2940,16283
02-11-2020,20 - 21,997,1531,10092,2817,15437
02-11-2020,21 - 22,1074,1555,9538,2595,14762
02-11-2020,22 - 23,995,1607,8810,2469,13881
02-11-2020,23 - 00,1014,1540,8248,2389,13191
03-11-2020,00 - 01,906,1658,8011,2329,12904
03-11-2020,01 - 02,872,1742,7748,2286,12648
03-11-2020,02 - 03,867,1712,7729,2281,12589
03-11-2020,03 - 04,919,1568,7783,2351,12621
03-11-2020,04 - 05,911,1501,7895,2374,12681
03-11-2020,05 - 06,972,1804,8362,2493,13631
03-11-2020,06 - 07,1029,1859,9673,2837,15398
03-11-2020,07 - 08,1260,1722,10491,3081,16554
03-11-2020,08 - 09,1330,1879,10629,3182,17020
03-11-2020,09 - 10,1321,1924,10642,3161,17048
03-11-2020,10 - 11,1272,1909,10605,3195,16981
03-11-2020,11 - 12,1169,1759,10545,3180,16653
03-11-2020,12 - 13,874,1911,10498,3224,16507
03-11-2020,13 - 14,1056,1737,10336,3222,16351
03-11-2020,14 - 15,1304,1823,10517,3147,16791
03-11-2020,15 - 16,1503,1976,10682,3178,17339
03-11-2020,16 - 17,1214,2023,11151,3257,17645
03-11-2020,17 - 18,1266,2003,11338,3292,17899
03-11-2020,18 - 19,1134,2002,11044,3160,17340
03-11-2020,19 - 20,1068,1693,10730,3102,16593
03-11-2020,20 - 21,1047,1559,10585,3040,16231
03-11-2020,21 - 22,1101,1651,10041,2935,15728
03-11-2020,22 - 23,990,1616,9587,2633,14826
03-11-2020,23 - 00,878,1504,9088,2453,13923
04-11-2020,00 - 01,962,1605,8760,2377,13704
04-11-2020,01 - 02,1010,1658,8498,2316,13482
04-11-2020,02 - 03,923,1466,8414,2365,13168
04-11-2020,03 - 04,938,1413,8558,2415,13324
04-11-2020,04 - 05,1070,1452,8621,2432,13575
04-11-2020,05 - 06,998,1704,9247,2532,14481
04-11-2020,06 - 07,1103,1993,10403,2878,16377
04-11-2020,07 - 08,1327,2041,11378,3189,17935
04-11-2020,08 - 09,1041,1944,11635,3346,17966
04-11-2020,09 - 10,1208,2062,11579,3354,18203
04-11-2020,10 - 11,1202,2058,11582,3290,18132
04-11-2020,11 - 12,1305,2114,11829,3260,18508
04-11-2020,12 - 13,1299,2100,11163,3167,17729
04-11-2020,13 - 14,1006,2115,11123,3067,17311
04-11-2020,14 - 15,1022,2042,11276,3074,17414
04-11-2020,15 - 16,1064,1989,11486,3186,17725
04-11-2020,16 - 17,1024,1985,11679,3385,18073
04-11-2020,17 - 18,1192,2023,11973,3456,18644
04-11-2020,18 - 19,1029,1899,11743,3221,17892
04-11-2020,19 - 20,1050,1866,11422,3038,17376
04-11-2020,20 - 21,1000,1962,10877,2933,16772
04-11-2020,21 - 22,1001,1890,10208,2791,15890
04-11-2020,22 - 23,983,1722,9540,2641,14886
04-11-2020,23 - 00,1003,1659,9188,2466,14316
05-11-2020,00 - 01,1039,1568,8746,2368,13721
05-11-2020,01 - 02,977,1526,8402,2320,13225
05-11-2020,02 - 03,1004,1556,8314,2274,13148
05-11-2020,03 - 04,1108,1608,8473,2324,13513
05-11-2020,04 - 05,1152,1558,8509,2359,13578
05-11-2020,05 - 06,1102,1569,8932,2527,14130
05-11-2020,06 - 07,1176,1828,10028,2850,15882
05-11-2020,07 - 08,1206,2097,10901,3118,17322
05-11-2020,08 - 09,1125,2158,11008,3172,17463
05-11-2020,09 - 10,1218,2020,11037,3181,17456
05-11-2020,10 - 11,1248,1940,10878,3273,17339
05-11-2020,11 - 12,1221,1905,10760,3374,17260
05-11-2020,12 - 13,1170,2000,10622,3367,17159
05-11-2020,13 - 14,1202,2098,10667,3324,17291
05-11-2020,14 - 15,1200,2075,10603,3256,17134
05-11-2020,15 - 16,1227,1935,10683,3255,17100
05-11-2020,16 - 17,1284,1949,11146,3310,17689
05-11-2020,17 - 18,1511,2026,11358,3381,18276
05-11-2020,18 - 19,1416,2031,11086,3303,17836
05-11-2020,19 - 20,1248,1961,10786,3162,17157
05-11-2020,20 - 21,1185,1976,10286,2928,16375
05-11-2020,21 - 22,1193,1989,9762,2779,15723
05-11-2020,22 - 23,1158,2018,9082,2506,14764
05-11-2020,23 - 00,1134,1927,8437,2337,13835
06-11-2020,00 - 01,1096,1662,8323,2210,13291
06-11-2020,01 - 02,1032,1491,7960,2159,12642
06-11-2020,02 - 03,1000,1653,7854,2149,12656
06-11-2020,03 - 04,993,1755,7886,2125,12759
06-11-2020,04 - 05,1047,1707,8005,2118,12877
06-11-2020,05 - 06,1080,1699,8352,2281,13412
06-11-2020,06 - 07,1128,1977,9449,2591,15145
06-11-2020,07 - 08,1274,1965,10296,2908,16443
06-11-2020,08 - 09,1098,1954,10351,2986,16389
06-11-2020,09 - 10,1310,2036,10382,3016,16744
06-11-2020,10 - 11,1355,1880,10244,3053,16532
06-11-2020,11 - 12,1159,1963,10120,3092,16334
06-11-2020,12 - 13,1214,1899,9991,3128,16232
06-11-2020,13 - 14,1199,1810,9786,3082,15877
06-11-2020,14 - 15,1160,1891,9686,3003,15740
06-11-2020,15 - 16,1168,1966,9816,2966,15916
06-11-2020,16 - 17,1236,2073,10219,2980,16508
06-11-2020,17 - 18,1188,1904,10511,3066,16669
06-11-2020,18 - 19,1122,1933,10273,2996,16324
06-11-2020,19 - 20,1216,1863,9926,2884,15889
06-11-2020,20 - 21,1196,1889,9477,2696,15258
06-11-2020,21 - 22,1168,2076,9099,2528,14871
06-11-2020,22 - 23,1226,2043,8724,2421,14414
06-11-2020,23 - 00,1077,1864,8446,2304,13691
07-11-2020,00 - 01,968,1850,8121,2223,13162
07-11-2020,01 - 02,1046,1664,7954,2209,12873
07-11-2020,02 - 03,1096,1611,7804,2257,12768
07-11-2020,03 - 04,976,1456,7718,2285,12435
07-11-2020,04 - 05,1067,1426,7658,2256,12407
07-11-2020,05 - 06,1116,1498,7804,2288,12706
07-11-2020,06 - 07,1134,1439,8256,2342,13171
07-11-2020,07 - 08,1168,1550,8670,2450,13838
07-11-2020,08 - 09,1198,1790,9111,2582,14681
07-11-2020,09 - 10,1275,1911,9514,2713,15413
07-11-2020,10 - 11,1181,1832,9811,2784,15608
07-11-2020,11 - 12,1109,1839,9805,2796,15549
07-11-2020,12 - 13,1108,1764,9779,2760,15411
07-11-2020,13 - 14,1107,1721,9695,2748,15271
07-11-2020,14 - 15,1113,1979,9687,2707,15486
07-11-2020,15 - 16,1113,2083,9902,2723,15821
07-11-2020,16 - 17,1158,2260,10453,2891,16762
07-11-2020,17 - 18,1194,2056,10643,2956,16849
07-11-2020,18 - 19,1230,1975,10430,2895,16530
07-11-2020,19 - 20,1153,1865,9880,2779,15677
07-11-2020,20 - 21,1079,1847,9580,2645,15151
07-11-2020,21 - 22,1068,1804,9084,2563,14519
07-11-2020,22 - 23,1078,1856,8633,2474,14041
07-11-2020,23 - 00,1043,1818,8216,2391,13468
08-11-2020,00 - 01,1029,1613,7951,2253,12846
08-11-2020,01 - 02,1061,1452,7914,2221,12648
08-11-2020,02 - 03,1043,1530,7915,2204,12692
08-11-2020,03 - 04,1000,1603,7929,2230,12762
08-11-2020,04 - 05,1070,1580,8027,2256,12933
08-11-2020,05 - 06,1156,1565,8193,2259,13173
08-11-2020,06 - 07,1066,1696,8460,2311,13533
08-11-2020,07 - 08,1096,2023,8727,2383,14229
08-11-2020,08 - 09,1106,2010,9068,2518,14702
08-11-2020,09 - 10,1158,2043,9516,2608,15325
08-11-2020,10 - 11,1169,2080,9632,2651,15532
08-11-2020,11 - 12,1205,1966,9729,2654,15554
08-11-2020,12 - 13,1218,1932,9694,2645,15489
08-11-2020,13 - 14,1244,2014,9862,2662,15782
08-11-2020,14 - 15,1199,2093,9868,2621,15781
08-11-2020,15 - 16,1225,2016,10048,2642,15931
08-11-2020,16 - 17,1233,2110,10681,2840,16864
08-11-2020,17 - 18,1244,1993,10994,2964,17195
08-11-2020,18 - 19,1177,1943,10762,2905,16787
08-11-2020,19 - 20,1086,1859,10500,2778,16223
08-11-2020,20 - 21,1150,1813,10213,2684,15860
08-11-2020,21 - 22,1150,1695,9698,2560,15103
08-11-2020,22 - 23,1131,1690,9233,2428,14482
08-11-2020,23 - 00,1087,1778,8725,2309,13899
09-11-2020,00 - 01,1129,1814,8664,2221,13828
09-11-2020,01 - 02,1248,1784,8463,2180,13675
09-11-2020,02 - 03,1217,1630,8409,2163,13419
09-11-2020,03 - 04,932,1701,8487,2175,13295
09-11-2020,04 - 05,1146,1911,8606,2236,13899
09-11-2020,05 - 06,999,1999,9061,2425,14484
09-11-2020,06 - 07,1117,2079,10038,2793,16027
09-11-2020,07 - 08,1239,2102,11007,3096,17444
09-11-2020,08 - 09,1188,2155,11284,3213,17840
09-11-2020,09 - 10,1256,2103,11261,3285,17905
09-11-2020,10 - 11,1273,2014,11265,3360,17912
09-11-2020,11 - 12,1318,1920,11336,3388,17962
09-11-2020,12 - 13,1255,1942,11394,3357,17948
09-11-2020,13 - 14,1181,1957,11321,3327,17786
09-11-2020,14 - 15,1141,2036,11278,3290,17745
09-11-2020,15 - 16,1069,2362,11539,3285,18255
09-11-2020,16 - 17,1262,2362,11849,3330,18803
09-11-2020,17 - 18,1278,2211,12074,3375,18938
09-11-2020,18 - 19,1117,2241,11864,3291,18513
09-11-2020,19 - 20,1258,2227,11508,3129,18122
09-11-2020,20 - 21,1295,2153,11125,2990,17563
09-11-2020,21 - 22,1355,2132,10568,2817,16872
09-11-2020,22 - 23,1198,2064,9995,2686,15943
09-11-2020,23 - 00,1216,1951,9472,2490,15129
10-11-2020,00 - 01,1267,2070,9155,2391,14883
10-11-2020,01 - 02,1205,2062,8951,2336,14554
10-11-2020,02 - 03,1217,2052,8956,2312,14537
10-11-2020,03 - 04,1252,2037,8982,2325,14596
10-11-2020,04 - 05,1275,2077,9150,2372,14874
10-11-2020,05 - 06,1390,2082,9569,2467,15508
10-11-2020,06 - 07,1457,2215,10673,2854,17199
10-11-2020,07 - 08,1495,2271,11523,3089,18378
10-11-2020,08 - 09,1388,2319,11659,3148,18514
10-11-2020,09 - 10,1316,2345,11617,3215,18493
10-11-2020,10 - 11,1329,2261,11700,3267,18557
10-11-2020,11 - 12,1312,2171,11823,3289,18595
10-11-2020,12 - 13,1206,2251,11892,3255,18604
10-11-2020,13 - 14,1243,2252,11719,3274,18488
10-11-2020,14 - 15,1342,2252,11594,3279,18467
10-11-2020,15 - 16,1409,2292,11764,3330,18795
10-11-2020,16 - 17,1353,2292,11908,3347,18900
10-11-2020,17 - 18,1401,2273,11884,3393,18951
10-11-2020,18 - 19,1210,2265,11607,3282,18364
10-11-2020,19 - 20,1168,2298,11509,3198,18173
10-11-2020,20 - 21,1258,2183,11046,3079,17566
10-11-2020,21 - 22,1183,2177,10499,2864,16723
10-11-2020,22 - 23,1173,2145,9785,2695,15798
10-11-2020,23 - 00,1070,1999,9280,2491,14840
11-11-2020,00 - 01,1138,1994,8873,2410,14415
11-11-2020,01 - 02,1086,1981,8726,2363,14156
11-11-2020,02 - 03,1177,1991,8614,2353,14135
11-11-2020,03 - 04,1244,1966,8631,2359,14200
11-11-2020,04 - 05,1331,1947,8757,2388,14423
11-11-2020,05 - 06,1256,1936,9213,2516,14921
11-11-2020,06 - 07,1326,1993,10299,2863,16481
11-11-2020,07 - 08,1369,2224,11112,3211,17916
11-11-2020,08 - 09,1367,2258,11350,3287,18262
11-11-2020,09 - 10,1494,2321,11399,3332,18546
11-11-2020,10 - 11,1374,2304,11408,3395,18481
11-11-2020,11 - 12,1342,2188,11617,3399,18546
11-11-2020,12 - 13,1377,2157,11636,3393,18563
11-11-2020,13 - 14,1354,2009,11523,3379,18265
11-11-2020,14 - 15,1496,2054,11530,3368,18448
11-11-2020,15 - 16,1441,2244,11560,3371,18616
11-11-2020,16 - 17,1509,2314,11797,3434,19054
11-11-2020,17 - 18,1448,2244,11907,3483,19082
11-11-2020,18 - 19,1368,2141,11623,3361,18493
11-11-2020,19 - 20,1347,2092,11372,3269,18080
11-11-2020,20 - 21,1275,2078,10945,3084,17382
11-11-2020,21 - 22,1275,2049,10551,2913,16788
11-11-2020,22 - 23,1171,1993,9911,2738,15813
11-11-2020,23 - 00,1210,1852,9385,2560,15007
12-11-2020,00 - 01,1089,1999,8987,2460,14535
12-11-2020,01 - 02,1236,2019,8742,2433,14430
12-11-2020,02 - 03,1186,2056,8639,2409,14290
12-11-2020,03 - 04,1163,2057,8720,2400,14340
12-11-2020,04 - 05,1255,2005,8779,2424,14463
12-11-2020,05 - 06,1224,2081,9189,2577,15071
12-11-2020,06 - 07,1242,2329,10268,2893,16732
12-11-2020,07 - 08,1295,2337,11178,3205,18015
12-11-2020,08 - 09,1343,2093,11396,3279,18111
12-11-2020,09 - 10,1355,2096,11507,3360,18318
12-11-2020,10 - 11,1299,2219,11562,3408,18488
12-11-2020,11 - 12,1363,2153,11571,3441,18528
12-11-2020,12 - 13,1386,2090,11571,3416,18463
12-11-2020,13 - 14,1240,2163,11494,3391,18288
12-11-2020,14 - 15,1347,2246,11505,3339,18437
12-11-2020,15 - 16,1416,2243,11619,3339,18617
12-11-2020,16 - 17,1576,2269,11826,3444,19115
12-11-2020,17 - 18,1568,2094,11957,3452,19071
12-11-2020,18 - 19,1593,2082,11835,3405,18915
12-11-2020,19 - 20,1603,2138,11476,3327,18544
12-11-2020,20 - 21,1546,2155,11029,3172,17902
12-11-2020,21 - 22,1366,1978,10556,2978,16878
12-11-2020,22 - 23,1293,1892,9950,2805,15940
12-11-2020,23 - 00,1369,1883,9280,2623,15155
13-11-2020,00 - 01,1345,2022,8824,2489,14680
13-11-2020,01 - 02,1254,1827,8661,2432,14174
13-11-2020,02 - 03,1140,1692,8594,2468,13894
13-11-2020,03 - 04,1133,1690,8623,2435,13881
13-11-2020,04 - 05,1147,1909,8744,2474,14274
13-11-2020,05 - 06,1272,1982,9164,2599,15017
13-11-2020,06 - 07,1326,2037,10190,2864,16417
13-11-2020,07 - 08,1402,2208,11083,3173,17866
13-11-2020,08 - 09,1503,2179,11335,3238,18255
13-11-2020,09 - 10,1422,2146,11453,3235,18256
13-11-2020,10 - 11,1392,2242,11568,3251,18453
13-11-2020,11 - 12,1495,2262,11480,3249,18486
13-11-2020,12 - 13,1381,2138,11483,3177,18179
13-11-2020,13 - 14,1393,1777,11331,3115,17616
13-11-2020,14 - 15,1213,1755,11194,3044,17206
13-11-2020,15 - 16,1243,1863,11231,3077,17414
13-11-2020,16 - 17,1361,1756,11501,3210,17828
13-11-2020,17 - 18,1291,1707,11516,3256,17770
13-11-2020,18 - 19,1283,1766,11134,3094,17277
13-11-2020,19 - 20,1115,1874,10609,2929,16527
13-11-2020,20 - 21,1148,1628,10123,2735,15634
13-11-2020,21 - 22,1163,1627,9670,2591,15051
13-11-2020,22 - 23,1177,1707,9262,2473,14619
13-11-2020,23 - 00,1119,1894,8851,2392,14256
14-11-2020,00 - 01,1017,1640,8547,2361,13565
14-11-2020,01 - 02,972,1582,8353,2286,13193
14-11-2020,02 - 03,1001,1475,8214,2271,12961
14-11-2020,03 - 04,988,1518,8099,2237,12842
14-11-2020,04 - 05,995,1486,8055,2209,12745
14-11-2020,05 - 06,987,1420,8197,2266,12870
14-11-2020,06 - 07,1055,1498,8449,2310,13312
14-11-2020,07 - 08,1106,1575,8821,2402,13904
14-11-2020,08 - 09,1170,1710,9213,2559,14652
14-11-2020,09 - 10,1172,1628,9571,2662,15033
14-11-2020,10 - 11,1110,1733,9985,2752,15580
14-11-2020,11 - 12,1185,1908,10079,2757,15929
14-11-2020,12 - 13,1234,1889,10135,2738,15996
14-11-2020,13 - 14,1172,1710,10031,2695,15608
14-11-2020,14 - 15,1118,1750,10037,2687,15592
14-11-2020,15 - 16,1090,1567,10286,2749,15692
14-11-2020,16 - 17,1087,1680,10669,2963,16399
14-11-2020,17 - 18,1097,1765,10772,3081,16715
14-11-2020,18 - 19,1044,1787,10597,2992,16420
14-11-2020,19 - 20,1183,1644,10212,2892,15931
14-11-2020,20 - 21,1233,1668,9747,2777,15425
14-11-2020,21 - 22,1088,1539,9337,2644,14608
14-11-2020,22 - 23,898,1457,8897,2468,13720
14-11-2020,23 - 00,996,1570,8566,2391,13523
15-11-2020,00 - 01,995,1494,8279,2311,13079
15-11-2020,01 - 02,884,1279,8158,2288,12609
15-11-2020,02 - 03,959,1365,8044,2202,12570
15-11-2020,03 - 04,1166,1503,7900,2192,12761
15-11-2020,04 - 05,1015,1446,7835,2152,12448
15-11-2020,05 - 06,889,1415,7847,2159,12310
15-11-2020,06 - 07,975,1459,8095,2171,12700
15-11-2020,07 - 08,1249,1543,8451,2287,13530
15-11-2020,08 - 09,1096,1450,8739,2399,13684
15-11-2020,09 - 10,1012,1485,9157,2544,14198
15-11-2020,10 - 11,1113,1546,9381,2650,14690
15-11-2020,11 - 12,1157,1528,9722,2689,15096
15-11-2020,12 - 13,1169,1662,9935,2651,15417
15-11-2020,13 - 14,1208,1741,10097,2676,15722
15-11-2020,14 - 15,978,1784,10132,2725,15619
15-11-2020,15 - 16,996,1846,10283,2797,15922
15-11-2020,16 - 17,1123,1924,10585,2908,16540
15-11-2020,17 - 18,1105,1882,10590,2901,16478
15-11-2020,18 - 19,1052,1915,10438,2900,16305
15-11-2020,19 - 20,1088,1954,10225,2812,16079
15-11-2020,20 - 21,1107,1957,9757,2687,15508
15-11-2020,21 - 22,1062,1699,9194,2609,14564
15-11-2020,22 - 23,923,1373,8718,2482,13496
15-11-2020,23 - 00,955,1543,8277,2344,13119
16-11-2020,00 - 01,866,1463,8069,2267,12665
16-11-2020,01 - 02,1013,1565,7954,2221,12753
16-11-2020,02 - 03,1054,1427,7888,2167,12536
16-11-2020,03 - 04,988,1488,7839,2226,12541
16-11-2020,04 - 05,962,1664,7849,2273,12748
16-11-2020,05 - 06,861,1528,8295,2411,13095
16-11-2020,06 - 07,1135,1803,9544,2776,15258
16-11-2020,07 - 08,1186,1840,10642,3132,16800
16-11-2020,08 - 09,1190,1820,10905,3207,17122
16-11-2020,09 - 10,1425,1671,11080,3208,17384
16-11-2020,10 - 11,1262,1711,11253,3197,17423
16-11-2020,11 - 12,1094,1923,11295,3235,17547
16-11-2020,12 - 13,1192,1883,11178,3262,17515
16-11-2020,13 - 14,1253,1802,11043,3197,17295
16-11-2020,14 - 15,1242,1754,10988,3226,17210
16-11-2020,15 - 16,1242,1762,11215,3275,17494
16-11-2020,16 - 17,1225,1798,11465,3375,17863
16-11-2020,17 - 18,1261,1738,11601,3418,18018
16-11-2020,18 - 19,1097,1790,11215,3249,17351
16-11-2020,19 - 20,1167,1789,10967,3170,17093
16-11-2020,20 - 21,1278,1806,10455,3072,16611
16-11-2020,21 - 22,1252,1671,9917,2945,15785
16-11-2020,22 - 23,1146,1633,9235,2748,14762
16-11-2020,23 - 00,1183,1365,8717,2538,13803
17-11-2020,00 - 01,1143,1386,8442,2331,13302
17-11-2020,01 - 02,1037,1416,8337,2242,13032
17-11-2020,02 - 03,1001,1399,8234,2237,12871
17-11-2020,03 - 04,1059,1282,8135,2253,12729
17-11-2020,04 - 05,1042,1608,8295,2294,13239
17-11-2020,05 - 06,1068,1666,8723,2433,13890
17-11-2020,06 - 07,1076,1847,9657,2761,15341
17-11-2020,07 - 08,1171,1860,10830,3116,16977
17-11-2020,08 - 09,1055,1972,11062,3195,17284
17-11-2020,09 - 10,821,1954,11008,3200,16983
17-11-2020,10 - 11,903,1917,11031,3211,17062
17-11-2020,11 - 12,1075,1762,11130,3263,17230
17-11-2020,12 - 13,1184,1711,11368,3228,17491
17-11-2020,13 - 14,1207,1836,11337,3237,17617
17-11-2020,14 - 15,1109,1926,11240,3282,17557
17-11-2020,15 - 16,1039,1808,11511,3356,17714
17-11-2020,16 - 17,1078,1676,11750,3348,17852
17-11-2020,17 - 18,1075,1878,11891,3379,18223
17-11-2020,18 - 19,967,1896,11460,3185,17508
17-11-2020,19 - 20,895,1858,11026,3046,16825
17-11-2020,20 - 21,1004,1851,10601,2944,16400
17-11-2020,21 - 22,1032,1742,10055,2768,15597
17-11-2020,22 - 23,1302,1656,9396,2535,14889
17-11-2020,23 - 00,1239,1429,8859,2382,13909
18-11-2020,00 - 01,812,1175,8443,2255,12685
18-11-2020,01 - 02,744,1252,8200,2211,12407
18-11-2020,02 - 03,807,1204,8049,2195,12255
18-11-2020,03 - 04,862,1469,8002,2171,12504
18-11-2020,04 - 05,929,1498,8052,2196,12675
18-11-2020,05 - 06,978,1793,8542,2333,13646
18-11-2020,06 - 07,1077,1987,9539,2659,15262
18-11-2020,07 - 08,1086,1894,10570,2987,16537
18-11-2020,08 - 09,1161,1921,10652,3118,16852
18-11-2020,09 - 10,1124,1881,10806,3086,16897
18-11-2020,10 - 11,1104,1903,10949,3163,17119
18-11-2020,11 - 12,1098,2023,10961,3232,17314
18-11-2020,12 - 13,1188,2267,10972,3197,17624
18-11-2020,13 - 14,1269,2186,10747,3198,17400
18-11-2020,14 - 15,1058,2007,10902,3210,17177
18-11-2020,15 - 16,848,1973,11078,3254,17153
18-11-2020,16 - 17,1093,1899,11361,3331,17684
18-11-2020,17 - 18,1303,1695,11508,3348,17854
18-11-2020,18 - 19,1385,1575,11377,3255,17592
18-11-2020,19 - 20,1177,1623,10950,3116,16866
18-11-2020,20 - 21,1198,1694,10497,3024,16413
18-11-2020,21 - 22,1240,1742,9969,2910,15861
18-11-2020,22 - 23,1121,1843,9253,2722,14939
18-11-2020,23 - 00,956,1786,8674,2569,13985
19-11-2020,00 - 01,857,1737,8679,2467,13740
19-11-2020,01 - 02,871,1864,8256,2413,13404
19-11-2020,02 - 03,1000,1890,8091,2386,13367
19-11-2020,03 - 04,1011,2085,8251,2392,13739
19-11-2020,04 - 05,1060,2102,8544,2426,14132
19-11-2020,05 - 06,1092,2123,9213,2600,15028
19-11-2020,06 - 07,1231,2330,10395,2951,16907
19-11-2020,07 - 08,1279,2325,11460,3263,18327
19-11-2020,08 - 09,1362,2365,11647,3322,18696
19-11-2020,09 - 10,1515,2411,11714,3316,18956
19-11-2020,10 - 11,1464,2381,11762,3336,18943
19-11-2020,11 - 12,1371,2419,12010,3371,19171
19-11-2020,12 - 13,1361,2570,12172,3394,19497
19-11-2020,13 - 14,1443,2642,12346,3460,19891
19-11-2020,14 - 15,1268,2572,12595,3629,20064
19-11-2020,15 - 16,1191,2613,12823,3666,20293
19-11-2020,16 - 17,1170,2194,13038,3741,20143
19-11-2020,17 - 18,1209,2380,12935,3709,20233
19-11-2020,18 - 19,1319,2212,12952,3595,20078
19-11-2020,19 - 20,1226,2193,12585,3467,19471
19-11-2020,20 - 21,1152,2103,12069,3324,18648
19-11-2020,21 - 22,1188,2101,11598,3157,18044
19-11-2020,22 - 23,1104,2044,11214,3023,17385
19-11-2020,23 - 00,1173,1923,10858,2951,16905
20-11-2020,00 - 01,1232,1970,10566,2936,16704
20-11-2020,01 - 02,1062,1822,10434,2935,16253
20-11-2020,02 - 03,1090,1724,10412,2859,16085
20-11-2020,03 - 04,1155,1742,10298,2889,16084
20-11-2020,04 - 05,1183,1812,10327,2959,16281
20-11-2020,05 - 06,1227,1829,10635,3008,16699
20-11-2020,06 - 07,1320,1992,11625,3153,18090
20-11-2020,07 - 08,1309,2118,12670,3389,19486
20-11-2020,08 - 09,1183,2081,12905,3443,19612
20-11-2020,09 - 10,1347,2187,12745,3479,19758
20-11-2020,10 - 11,1386,2220,12788,3522,19916
20-11-2020,11 - 12,1358,2211,12536,3521,19626
20-11-2020,12 - 13,1287,2183,12328,3394,19192
20-11-2020,13 - 14,1331,2178,12235,3297,19041
20-11-2020,14 - 15,1327,2066,11979,3255,18627
20-11-2020,15 - 16,1329,2124,12155,3209,18817
20-11-2020,16 - 17,1270,2182,12556,3316,19324
20-11-2020,17 - 18,1294,2298,12673,3469,19734
20-11-2020,18 - 19,1485,2424,12578,3398,19885
20-11-2020,19 - 20,1293,2553,12255,3328,19429
20-11-2020,20 - 21,1255,2251,11727,3192,18425
20-11-2020,21 - 22,1392,2015,10994,3027,17428
20-11-2020,22 - 23,1472,2032,10361,2919,16784
20-11-2020,23 - 00,1509,1952,9973,2815,16249
21-11-2020,00 - 01,1276,1710,9918,2674,15578
21-11-2020,01 - 02,1251,1518,9661,2557,14987
21-11-2020,02 - 03,1147,1422,9536,2431,14536
21-11-2020,03 - 04,1114,1394,9512,2384,14404
21-11-2020,04 - 05,936,1605,9826,2402,14769
21-11-2020,05 - 06,792,1716,9901,2479,14888
21-11-2020,06 - 07,1112,1842,10150,2597,15701
21-11-2020,07 - 08,1227,1933,10484,2828,16472
21-11-2020,08 - 09,1160,1945,10816,2961,16882
21-11-2020,09 - 10,1292,1995,11191,3137,17615
21-11-2020,10 - 11,1301,1906,11418,3240,17865
21-11-2020,11 - 12,1290,1968,11536,3261,18055
21-11-2020,12 - 13,1306,1935,11561,3276,18078
21-11-2020,13 - 14,1301,1971,11522,3277,18071
21-11-2020,14 - 15,1289,2034,11431,3258,18012
21-11-2020,15 - 16,1298,2049,11426,3241,18014
21-11-2020,16 - 17,1272,1920,11661,3314,18167
21-11-2020,17 - 18,1258,1942,11682,3297,18179
21-11-2020,18 - 19,1402,2133,11453,3165,18153
21-11-2020,19 - 20,1525,1942,10973,3012,17452
21-11-2020,20 - 21,1340,1690,10593,2799,16422
21-11-2020,21 - 22,1068,1662,10147,2700,15577
21-11-2020,22 - 23,1176,1696,9711,2618,15201
21-11-2020,23 - 00,1105,1663,9683,2547,14998
22-11-2020,00 - 01,1116,1528,9118,2445,14207
22-11-2020,01 - 02,1209,1495,8816,2394,13914
22-11-2020,02 - 03,1146,1420,8741,2425,13732
22-11-2020,03 - 04,1153,1481,8778,2402,13814
22-11-2020,04 - 05,1192,1445,8798,2403,13838
22-11-2020,05 - 06,1165,1488,8945,2432,14030
22-11-2020,06 - 07,1175,1597,9160,2451,14383
22-11-2020,07 - 08,1280,1639,9570,2570,15059
22-11-2020,08 - 09,1393,1671,9806,2714,15584
22-11-2020,09 - 10,1402,1756,10128,2835,16121
22-11-2020,10 - 11,1370,1814,10293,2876,16353
22-11-2020,11 - 12,1373,1808,10413,2898,16492
22-11-2020,12 - 13,1352,1763,10434,2962,16511
22-11-2020,13 - 14,1303,1769,10601,2950,16623
22-11-2020,14 - 15,1387,1774,10687,2948,16796
22-11-2020,15 - 16,1257,1836,10978,3037,17108
22-11-2020,16 - 17,1200,1892,11460,3226,17778
22-11-2020,17 - 18,1323,1912,11539,3283,18057
22-11-2020,18 - 19,1323,1893,11365,3234,17815
22-11-2020,19 - 20,1048,1836,11064,3125,17073
22-11-2020,20 - 21,1377,1804,10753,3017,16951
22-11-2020,21 - 22,1531,1811,10297,2927,16566
22-11-2020,22 - 23,1339,1747,9783,2787,15656
22-11-2020,23 - 00,1258,1693,9439,2633,15023
23-11-2020,00 - 01,1256,1551,9179,2491,14477
23-11-2020,01 - 02,1251,1544,9039,2457,14291
23-11-2020,02 - 03,1178,1505,8907,2476,14066
23-11-2020,03 - 04,1067,1621,8985,2478,14151
23-11-2020,04 - 05,1146,1664,9081,2502,14393
23-11-2020,05 - 06,1275,1721,9450,2649,15095
23-11-2020,06 - 07,1041,1925,10832,3011,16809
23-11-2020,07 - 08,1279,2145,12004,3353,18781
23-11-2020,08 - 09,1569,2347,12037,3396,19349
23-11-2020,09 - 10,1483,2101,12007,3462,19053
23-11-2020,10 - 11,1412,2055,12043,3465,18975
23-11-2020,11 - 12,1436,2034,11792,3418,18680
23-11-2020,12 - 13,1500,2129,11917,3386,18932
23-11-2020,13 - 14,1221,2015,11817,3311,18364
23-11-2020,14 - 15,1269,1947,11915,3344,18475
23-11-2020,15 - 16,1334,2013,12247,3410,19004
23-11-2020,16 - 17,1241,2062,12660,3520,19483
23-11-2020,17 - 18,1383,2238,13465,3591,20677
23-11-2020,18 - 19,1296,2133,12714,3501,19644
23-11-2020,19 - 20,1199,1915,12327,3456,18897
23-11-2020,20 - 21,1075,1897,11642,3310,17924
23-11-2020,21 - 22,1107,1807,11140,3119,17173
23-11-2020,22 - 23,1116,1873,10674,2904,16567
23-11-2020,23 - 00,1029,1849,10064,2646,15588
24-11-2020,00 - 01,799,1751,9558,2531,14639
24-11-2020,01 - 02,865,1734,9442,2511,14552
24-11-2020,02 - 03,1085,1752,9383,2486,14706
24-11-2020,03 - 04,1122,1722,9399,2466,14709
24-11-2020,04 - 05,1142,1696,9573,2536,14947
24-11-2020,05 - 06,1203,1814,10047,2696,15760
24-11-2020,06 - 07,1407,2202,11072,3026,17707
24-11-2020,07 - 08,1529,2163,12062,3386,19140
24-11-2020,08 - 09,1498,2043,12257,3480,19278
24-11-2020,09 - 10,1387,2014,12234,3533,19168
24-11-2020,10 - 11,1333,1862,12195,3581,18971
24-11-2020,11 - 12,1378,1902,12140,3615,19035
24-11-2020,12 - 13,1393,2233,12163,3613,19402
24-11-2020,13 - 14,1365,2393,12015,3579,19352
24-11-2020,14 - 15,1378,2325,11939,3535,19177
24-11-2020,15 - 16,1410,2393,12082,3553,19438
24-11-2020,16 - 17,1534,2380,12231,3586,19731
24-11-2020,17 - 18,1517,2287,12353,3581,19738
24-11-2020,18 - 19,1502,2262,12223,3520,19507
24-11-2020,19 - 20,1411,2226,11804,3392,18833
24-11-2020,20 - 21,1393,2132,11260,3265,18050
24-11-2020,21 - 22,1445,2005,10567,3055,17072
24-11-2020,22 - 23,1256,1901,9851,2809,15817
24-11-2020,23 - 00,1099,1911,9242,2649,14901
25-11-2020,00 - 01,1102,1965,8843,2570,14480
25-11-2020,01 - 02,1051,1757,8543,2593,13944
25-11-2020,02 - 03,968,1522,8397,2550,13437
25-11-2020,03 - 04,922,1511,8426,2548,13407
25-11-2020,04 - 05,1109,1452,8457,2588,13606
25-11-2020,05 - 06,1230,1383,8981,2757,14351
25-11-2020,06 - 07,1303,1712,10139,3074,16228
25-11-2020,07 - 08,1213,1955,11165,3423,17756
25-11-2020,08 - 09,1241,2107,11387,3457,18192
25-11-2020,09 - 10,1360,2032,11206,3444,18042
25-11-2020,10 - 11,1310,1836,11510,3487,18143
25-11-2020,11 - 12,1261,1851,11670,3464,18246
25-11-2020,12 - 13,1279,1938,11744,3364,18325
25-11-2020,13 - 14,1306,1840,11611,3342,18099
25-11-2020,14 - 15,1399,1712,11709,3380,18200
25-11-2020,15 - 16,1371,1667,11768,3609,18415
25-11-2020,16 - 17,1248,1621,11689,3802,18360
25-11-2020,17 - 18,1205,1731,12014,3642,18592
25-11-2020,18 - 19,1154,1960,11936,3481,18531
25-11-2020,19 - 20,1224,1805,11575,3409,18013
25-11-2020,20 - 21,1221,1650,11135,3271,17277
25-11-2020,21 - 22,1155,1534,10521,3088,16298
25-11-2020,22 - 23,989,1632,9884,2943,15448
25-11-2020,23 - 00,1179,1717,9276,2817,14989
26-11-2020,00 - 01,1221,1754,8775,2683,14433
26-11-2020,01 - 02,1100,1694,8578,2592,13964
26-11-2020,02 - 03,1029,1558,8569,2556,13712
26-11-2020,03 - 04,1051,1620,8664,2581,13916
26-11-2020,04 - 05,833,1789,8717,2640,13979
26-11-2020,05 - 06,1092,1722,9073,2755,14642
26-11-2020,06 - 07,1197,1823,10180,3021,16221
26-11-2020,07 - 08,1237,2082,11177,3332,17828
26-11-2020,08 - 09,1302,1953,11562,3433,18250
26-11-2020,09 - 10,1278,1724,11490,3467,17959
26-11-2020,10 - 11,1250,1785,11452,3520,18007
26-11-2020,11 - 12,1314,1866,11423,3455,18058
26-11-2020,12 - 13,1272,1915,11470,3445,18102
26-11-2020,13 - 14,1258,1987,11545,3449,18239
26-11-2020,14 - 15,1326,1912,11635,3449,18322
26-11-2020,15 - 16,1302,1779,12045,3448,18574
26-11-2020,16 - 17,1297,1806,12409,3543,19055
26-11-2020,17 - 18,1268,2047,12438,3571,19324
26-11-2020,18 - 19,1216,1831,12331,3443,18821
26-11-2020,19 - 20,1227,2037,11988,3370,18622
26-11-2020,20 - 21,1333,1852,11579,3245,18009
26-11-2020,21 - 22,1260,1769,11252,3103,17384
26-11-2020,22 - 23,1331,1758,10789,2962,16840
26-11-2020,23 - 00,1423,1783,10330,2816,16352
27-11-2020,00 - 01,1180,1855,9973,2724,15732
27-11-2020,01 - 02,1266,1763,9854,2672,15555
27-11-2020,02 - 03,1192,1867,9825,2658,15542
27-11-2020,03 - 04,1301,1870,9960,2650,15781
27-11-2020,04 - 05,1331,1954,10077,2704,16066
27-11-2020,05 - 06,1363,1993,10491,2892,16739
27-11-2020,06 - 07,1397,2142,11614,3293,18446
27-11-2020,07 - 08,1431,2238,12767,3659,20095
27-11-2020,08 - 09,1413,2256,13062,3772,20503
27-11-2020,09 - 10,1434,2303,13000,3772,20509
27-11-2020,10 - 11,1488,2420,12861,3777,20546
27-11-2020,11 - 12,1408,2378,12717,3747,20250
27-11-2020,12 - 13,1378,2318,12628,3714,20038
27-11-2020,13 - 14,1305,2300,12366,3618,19589
27-11-2020,14 - 15,1519,2067,12167,3592,19345
27-11-2020,15 - 16,1590,2203,12496,3582,19871
27-11-2020,16 - 17,1603,2364,12879,3688,20534
27-11-2020,17 - 18,1680,2338,12961,3727,20706
27-11-2020,18 - 19,1379,2410,12746,3621,20156
27-11-2020,19 - 20,1373,2462,12378,3546,19759
27-11-2020,20 - 21,1368,2407,12015,3416,19206
27-11-2020,21 - 22,1278,2216,11560,3267,18321
27-11-2020,22 - 23,1243,2111,11112,3138,17604
27-11-2020,23 - 00,1249,2094,10704,2990,17037
28-11-2020,00 - 01,1207,2098,10387,2947,16639
28-11-2020,01 - 02,1267,2112,10171,2879,16429
28-11-2020,02 - 03,1233,2106,10041,2865,16245
28-11-2020,03 - 04,1176,2009,10072,2868,16125
28-11-2020,04 - 05,1142,2012,10075,2911,16140
28-11-2020,05 - 06,1259,2071,10200,2944,16474
28-11-2020,06 - 07,1320,2102,10559,3076,17057
28-11-2020,07 - 08,1359,1953,10971,3215,17498
28-11-2020,08 - 09,1186,2005,11355,3321,17867
28-11-2020,09 - 10,1230,1961,11795,3450,18436
28-11-2020,10 - 11,1370,1848,11974,3492,18684
28-11-2020,11 - 12,1368,1883,12157,3507,18915
28-11-2020,12 - 13,1275,1941,12214,3449,18879
28-11-2020,13 - 14,1206,2062,12180,3402,18850
28-11-2020,14 - 15,1270,1952,12252,3408,18882
28-11-2020,15 - 16,1342,2013,12461,3453,19269
28-11-2020,16 - 17,1353,2156,12734,3646,19889
28-11-2020,17 - 18,1385,2185,12832,3655,20057
28-11-2020,18 - 19,1479,2394,12594,3601,20068
28-11-2020,19 - 20,1318,2471,12209,3497,19495
28-11-2020,20 - 21,1298,2346,11743,3331,18718
28-11-2020,21 - 22,1332,2180,11307,3180,17999
28-11-2020,22 - 23,1392,2003,10826,3092,17313
28-11-2020,23 - 00,1597,2033,10458,2996,17084
29-11-2020,00 - 01,1328,2125,10289,2935,16677
29-11-2020,01 - 02,1344,2064,10108,2871,16387
29-11-2020,02 - 03,1259,2085,10077,2854,16275
29-11-2020,03 - 04,1290,2110,10084,2865,16349
29-11-2020,04 - 05,1183,2057,10110,2879,16229
29-11-2020,05 - 06,1221,2077,10251,2921,16470
29-11-2020,06 - 07,1168,2096,10483,2986,16733
29-11-2020,07 - 08,1329,2155,10830,3137,17451
29-11-2020,08 - 09,1298,2278,11213,3243,18032
29-11-2020,09 - 10,1455,2372,11652,3391,18870
29-11-2020,10 - 11,1653,2486,12036,3434,19609
29-11-2020,11 - 12,1477,2432,12339,3473,19721
29-11-2020,12 - 13,1127,2342,12431,3478,19378
29-11-2020,13 - 14,1441,2381,12436,3465,19723
29-11-2020,14 - 15,1201,2405,12510,3510,19626
29-11-2020,15 - 16,1239,2461,12925,3575,20200
29-11-2020,16 - 17,1468,2415,13311,3683,20877
29-11-2020,17 - 18,1541,2324,13314,3739,20918
29-11-2020,18 - 19,1364,2183,12891,3693,20131
29-11-2020,19 - 20,1357,2216,12676,3589,19838
29-11-2020,20 - 21,1384,2134,12308,3446,19272
29-11-2020,21 - 22,1358,2208,11903,3338,18807
29-11-2020,22 - 23,1381,2102,11440,3194,18117
29-11-2020,23 - 00,1175,1889,10996,3096,17156
30-11-2020,00 - 01,1177,2009,10633,3069,16888
30-11-2020,01 - 02,1084,2076,10190,3004,16354
30-11-2020,02 - 03,1007,2134,10395,2997,16533
30-11-2020,03 - 04,1075,2171,10335,3009,16590
30-11-2020,04 - 05,1131,2204,10479,3046,16860
30-11-2020,05 - 06,1445,2237,10891,3252,17825
30-11-2020,06 - 07,1575,2414,11931,3621,19541
30-11-2020,07 - 08,1325,2599,12941,4014,20879
30-11-2020,08 - 09,1413,2698,13202,4090,21403
30-11-2020,09 - 10,1595,2714,13228,4119,21656
30-11-2020,10 - 11,1419,2681,13468,4154,21722
30-11-2020,11 - 12,1349,2615,13426,4139,21529
30-11-2020,12 - 13,1426,2606,13451,4088,21571
30-11-2020,13 - 14,1526,2586,13456,4030,21598
30-11-2020,14 - 15,1465,2596,13493,3998,21552
30-11-2020,15 - 16,1432,2534,13784,4020,21770
30-11-2020,16 - 17,1340,2687,13851,4113,21991
30-11-2020,17 - 18,1443,2462,13823,4154,21882
30-11-2020,18 - 19,1445,2438,13542,4102,21527
30-11-2020,19 - 20,1352,2360,13156,3963,20831
30-11-2020,20 - 21,1288,2316,12579,3776,19959
30-11-2020,21 - 22,1268,2319,12160,3617,19364
30-11-2020,22 - 23,1325,2098,11462,3456,18341
30-11-2020,23 - 00,1197,2041,10828,3281,17347
01-12-2020,00 - 01,1121,1978,10388,3089,16576
01-12-2020,01 - 02,1242,1854,10062,3009,16167
01-12-2020,02 - 03,1164,1757,9928,2983,15832
01-12-2020,03 - 04,1112,1914,9886,3031,15943
01-12-2020,04 - 05,1130,2036,10060,3051,16277
01-12-2020,05 - 06,1210,2018,10572,3174,16974
01-12-2020,06 - 07,1172,2180,11649,3504,18505
01-12-2020,07 - 08,1215,2257,12603,3819,19894
01-12-2020,08 - 09,1134,2352,12917,3909,20312
01-12-2020,09 - 10,1212,2187,12943,3888,20230
01-12-2020,10 - 11,1252,2020,12990,3918,20180
01-12-2020,11 - 12,1201,2300,12872,3898,20271
01-12-2020,12 - 13,1216,2403,12878,3850,20347
01-12-2020,13 - 14,1401,2319,12812,3861,20393
01-12-2020,14 - 15,1443,2227,12713,3834,20217
01-12-2020,15 - 16,1543,2204,12669,3900,20316
01-12-2020,16 - 17,1488,2434,13181,3962,21065
01-12-2020,17 - 18,1483,2694,13524,3984,21685
01-12-2020,18 - 19,1420,2778,13465,3847,21510
01-12-2020,19 - 20,1305,2519,13132,3748,20704
01-12-2020,20 - 21,1349,2441,12747,3614,20151
01-12-2020,21 - 22,1385,2331,12200,3434,19350
01-12-2020,22 - 23,1371,2090,11700,3248,18409
01-12-2020,23 - 00,1328,1669,10951,3042,16990
02-12-2020,00 - 01,1206,1443,10482,2931,16062
02-12-2020,01 - 02,1130,1162,10394,2877,15563
02-12-2020,02 - 03,1027,1253,10298,2870,15448
02-12-2020,03 - 04,879,1593,10259,2891,15622
02-12-2020,04 - 05,913,1646,10291,2943,15793
02-12-2020,05 - 06,985,1830,10762,3089,16666
02-12-2020,06 - 07,1061,2026,11917,3457,18461
02-12-2020,07 - 08,1106,2187,12969,3791,20053
02-12-2020,08 - 09,1134,2058,13070,3836,20098
02-12-2020,09 - 10,1180,1789,12720,3835,19524
02-12-2020,10 - 11,1238,1913,12686,3910,19747
02-12-2020,11 - 12,1244,2201,12904,3938,20287
02-12-2020,12 - 13,1331,2289,12990,3867,20477
02-12-2020,13 - 14,1266,2265,13066,3837,20434
02-12-2020,14 - 15,1325,2305,13185,3820,20635
02-12-2020,15 - 16,1247,2296,13440,3848,20831
02-12-2020,16 - 17,1250,2373,13449,3909,20981
02-12-2020,17 - 18,1341,2399,13566,3942,21248
02-12-2020,18 - 19,1182,2225,13296,3881,20584
02-12-2020,19 - 20,1170,2216,12816,3697,19899
02-12-2020,20 - 21,1154,2084,12369,3527,19134
02-12-2020,21 - 22,1183,2135,11872,3348,18538
02-12-2020,22 - 23,1144,2237,11249,3137,17767
02-12-2020,23 - 00,1063,2146,10630,2960,16799
03-12-2020,00 - 01,1243,2061,10320,2915,16539
03-12-2020,01 - 02,1102,2172,10075,2839,16188
03-12-2020,02 - 03,950,1903,10027,2779,15659
03-12-2020,03 - 04,1040,1799,10059,2754,15652
03-12-2020,04 - 05,1101,1863,10128,2838,15930
03-12-2020,05 - 06,1069,1925,10640,3053,16687
03-12-2020,06 - 07,1238,2027,11733,3484,18482
03-12-2020,07 - 08,1324,1874,12789,3829,19816
03-12-2020,08 - 09,1261,2149,12928,3867,20205
03-12-2020,09 - 10,1270,2133,12943,3910,20256
03-12-2020,10 - 11,1311,2064,13053,4097,20525
03-12-2020,11 - 12,1169,2020,13285,4151,20625
03-12-2020,12 - 13,1075,2180,13226,4124,20605
03-12-2020,13 - 14,1248,2194,12993,4067,20502
03-12-2020,14 - 15,1358,2220,13382,3990,20950
03-12-2020,15 - 16,1283,2174,13679,3977,21113
03-12-2020,16 - 17,1273,2275,13641,4092,21281
03-12-2020,17 - 18,1207,2241,13656,4147,21251
03-12-2020,18 - 19,1238,2058,13500,4094,20890
03-12-2020,19 - 20,1283,2139,13182,3999,20603
03-12-2020,20 - 21,1271,2226,12811,3822,20130
03-12-2020,21 - 22,1177,2151,12276,3590,19194
03-12-2020,22 - 23,1114,2073,11614,3349,18150
03-12-2020,23 - 00,1257,2130,10953,3141,17481
04-12-2020,00 - 01,1122,2266,10292,3057,16737
04-12-2020,01 - 02,1043,2168,10002,3007,16220
04-12-2020,02 - 03,1141,2080,9860,2939,16020
04-12-2020,03 - 04,1165,2006,9929,2889,15989
04-12-2020,04 - 05,1259,1845,9925,2900,15929
04-12-2020,05 - 06,1251,2067,10440,3108,16866
04-12-2020,06 - 07,1273,2161,11474,3439,18347
04-12-2020,07 - 08,1281,2249,12612,3819,19961
04-12-2020,08 - 09,1263,2498,12952,3881,20594
04-12-2020,09 - 10,1337,2416,12882,3895,20530
04-12-2020,10 - 11,1383,2344,12916,3958,20601
04-12-2020,11 - 12,1429,2376,12980,3917,20702
04-12-2020,12 - 13,1390,2551,12990,3845,20776
04-12-2020,13 - 14,1383,2573,12770,3765,20491
04-12-2020,14 - 15,1358,2558,12647,3699,20262
04-12-2020,15 - 16,1405,2547,12670,3680,20302
04-12-2020,16 - 17,1335,2711,12738,3719,20503
04-12-2020,17 - 18,1350,2525,12769,3725,20369
04-12-2020,18 - 19,1379,2516,12506,3674,20075
04-12-2020,19 - 20,1228,2510,12231,3566,19535
04-12-2020,20 - 21,1159,2423,11622,3432,18636
04-12-2020,21 - 22,1189,2298,11046,3233,17766
04-12-2020,22 - 23,1344,2263,10393,3103,17103
04-12-2020,23 - 00,1320,2186,9823,2970,16299
05-12-2020,00 - 01,1219,2105,9496,2784,15604
05-12-2020,01 - 02,1292,2013,9206,2635,15146
05-12-2020,02 - 03,1236,1965,9040,2642,14883
05-12-2020,03 - 04,1210,1982,9009,2689,14890
05-12-2020,04 - 05,1226,1886,9013,2666,14791
05-12-2020,05 - 06,1212,1830,9116,2683,14841
05-12-2020,06 - 07,1241,1923,9453,2802,15419
05-12-2020,07 - 08,1272,2092,10005,2876,16245
05-12-2020,08 - 09,1278,2074,10312,3013,16677
05-12-2020,09 - 10,1313,1997,10661,3203,17174
05-12-2020,10 - 11,1348,1950,10992,3293,17583
05-12-2020,11 - 12,1301,2070,11272,3365,18008
05-12-2020,12 - 13,1279,2101,11449,3338,18167
05-12-2020,13 - 14,1302,2118,11357,3172,17949
05-12-2020,14 - 15,1271,2308,11332,3139,18050
05-12-2020,15 - 16,1313,2239,11598,3294,18444
05-12-2020,16 - 17,1267,2224,11702,3422,18615
05-12-2020,17 - 18,1256,2306,11734,3418,18714
05-12-2020,18 - 19,1202,2248,11443,3362,18255
05-12-2020,19 - 20,1236,2127,11032,3239,17634
05-12-2020,20 - 21,1139,2011,10560,3062,16772
05-12-2020,21 - 22,1222,1989,10095,2963,16269
05-12-2020,22 - 23,1343,1949,9724,2885,15901
05-12-2020,23 - 00,1218,1945,9378,2792,15333
06-12-2020,00 - 01,1195,1777,8940,2718,14630
06-12-2020,01 - 02,1139,1745,8724,2614,14222
06-12-2020,02 - 03,1083,1717,8632,2581,14013
06-12-2020,03 - 04,1097,1691,8552,2610,13950
06-12-2020,04 - 05,1083,1742,8563,2627,14015
06-12-2020,05 - 06,1076,1733,8628,2618,14055
06-12-2020,06 - 07,1062,1791,8977,2689,14519
06-12-2020,07 - 08,1096,1858,9228,2721,14903
06-12-2020,08 - 09,1190,1851,9662,2796,15499
06-12-2020,09 - 10,1203,1898,10108,2933,16142
06-12-2020,10 - 11,1238,2048,10564,2967,16817
06-12-2020,11 - 12,1243,2072,10834,2981,17130
06-12-2020,12 - 13,1249,2068,10996,3003,17316
06-12-2020,13 - 14,1258,2026,11006,3047,17337
06-12-2020,14 - 15,1263,2187,11225,3021,17696
06-12-2020,15 - 16,1300,2220,11402,3024,17946
06-12-2020,16 - 17,1360,2175,11424,3163,18122
06-12-2020,17 - 18,1392,2085,11594,3239,18310
06-12-2020,18 - 19,1362,2094,11399,3220,18075
06-12-2020,19 - 20,1229,1952,11094,3152,17427
06-12-2020,20 - 21,1058,2086,10820,3049,17013
06-12-2020,21 - 22,1053,2056,10250,2924,16283
06-12-2020,22 - 23,1022,1998,9779,2788,15587
06-12-2020,23 - 00,960,1752,9389,2651,14752
07-12-2020,00 - 01,1038,1853,9111,2660,14662
07-12-2020,01 - 02,1043,1908,8865,2592,14408
07-12-2020,02 - 03,991,1805,8813,2530,14139
07-12-2020,03 - 04,1041,1677,8787,2501,14006
07-12-2020,04 - 05,1086,1794,8742,2548,14170
07-12-2020,05 - 06,1187,1823,9319,2761,15090
07-12-2020,06 - 07,1272,2021,10559,3110,16962
07-12-2020,07 - 08,1309,2082,11674,3481,18546
07-12-2020,08 - 09,1458,2158,12059,3597,19272
07-12-2020,09 - 10,1203,2090,12077,3604,18974
07-12-2020,10 - 11,1274,2092,12197,3656,19219
07-12-2020,11 - 12,1272,2164,12318,3668,19422
07-12-2020,12 - 13,1378,2082,12498,3698,19656
07-12-2020,13 - 14,1372,1992,12541,3763,19668
07-12-2020,14 - 15,1335,2134,12535,3722,19726
07-12-2020,15 - 16,1315,2142,12748,3771,19976
07-12-2020,16 - 17,1321,2133,12784,3795,20033
07-12-2020,17 - 18,1451,2163,12946,3828,20388
07-12-2020,18 - 19,1359,2000,12657,3746,19762
07-12-2020,19 - 20,1238,2027,12345,3615,19225
07-12-2020,20 - 21,1254,1843,11819,3447,18363
07-12-2020,21 - 22,1120,1903,11359,3328,17710
07-12-2020,22 - 23,1186,1994,11353,3152,17685
07-12-2020,23 - 00,1208,2074,10769,2989,17040
08-12-2020,00 - 01,1221,2038,9799,2939,15997
08-12-2020,01 - 02,1206,1984,9720,2875,15785
08-12-2020,02 - 03,1211,2116,9602,2831,15760
08-12-2020,03 - 04,1270,2165,9620,2841,15896
08-12-2020,04 - 05,1230,2131,9744,2853,15958
08-12-2020,05 - 06,1253,2244,10212,2959,16668
08-12-2020,06 - 07,1310,2407,11279,3303,18299
08-12-2020,07 - 08,1368,2620,12257,3691,19936
08-12-2020,08 - 09,1384,2695,12405,3735,20219
08-12-2020,09 - 10,1348,2577,12458,3711,20094
08-12-2020,10 - 11,1378,2517,12697,3835,20427
08-12-2020,11 - 12,1332,2485,12831,3853,20501
08-12-2020,12 - 13,1424,2431,13029,3855,20739
08-12-2020,13 - 14,1436,2639,12973,3857,20905
08-12-2020,14 - 15,1369,2714,13087,3778,20948
08-12-2020,15 - 16,1394,2791,13391,3787,21363
08-12-2020,16 - 17,1413,2602,13530,3907,21452
08-12-2020,17 - 18,1349,2731,13485,3887,21452
08-12-2020,18 - 19,1311,2665,13207,3796,20979
08-12-2020,19 - 20,1344,2583,13006,3694,20627
08-12-2020,20 - 21,1298,2738,12655,3614,20305
08-12-2020,21 - 22,1335,2396,12062,3420,19213
08-12-2020,22 - 23,1267,2383,11370,3228,18248
08-12-2020,23 - 00,1136,2371,10773,3063,17343
09-12-2020,00 - 01,1184,2252,10321,2901,16658
09-12-2020,01 - 02,1304,2117,10064,2835,16320
09-12-2020,02 - 03,1148,2151,10051,2796,16146
09-12-2020,03 - 04,1139,2187,10019,2801,16146
09-12-2020,04 - 05,1235,2210,10113,2858,16416
09-12-2020,05 - 06,1219,2340,10569,3012,17140
09-12-2020,06 - 07,1205,2509,11671,3322,18707
09-12-2020,07 - 08,1335,2536,12634,3640,20145
09-12-2020,08 - 09,1388,2502,12960,3706,20556
09-12-2020,09 - 10,1372,2665,12925,3647,20609
09-12-2020,10 - 11,1208,2739,13054,3757,20758
09-12-2020,11 - 12,1310,2538,13177,3762,20787
09-12-2020,12 - 13,1345,2565,13146,3782,20838
09-12-2020,13 - 14,1314,2680,12954,3757,20705
09-12-2020,14 - 15,1258,2630,12987,3794,20669
09-12-2020,15 - 16,1392,2462,13193,3819,20866
09-12-2020,16 - 17,1425,2510,13194,3775,20904
09-12-2020,17 - 18,1384,2583,13188,3805,20960
09-12-2020,18 - 19,1342,2443,12989,3818,20592
09-12-2020,19 - 20,1396,2524,12682,3708,20310
09-12-2020,20 - 21,1390,2454,12238,3572,19654
09-12-2020,21 - 22,1369,2403,11722,3418,18912
09-12-2020,22 - 23,1271,2248,11056,3241,17816
09-12-2020,23 - 00,1101,2124,10481,3006,16712
10-12-2020,00 - 01,1083,2012,9930,2817,15842
10-12-2020,01 - 02,1164,2035,9782,2742,15723
10-12-2020,02 - 03,1048,2035,9852,2747,15682
10-12-2020,03 - 04,1014,2015,9918,2759,15706
10-12-2020,04 - 05,1021,2007,9999,2815,15842
10-12-2020,05 - 06,1117,2077,10296,2903,16393
10-12-2020,06 - 07,1218,2218,11432,3190,18058
10-12-2020,07 - 08,1092,2494,12434,3491,19511
10-12-2020,08 - 09,1135,2530,12685,3641,19991
10-12-2020,09 - 10,1570,2411,12672,3725,20378
10-12-2020,10 - 11,1395,2392,12772,3461,20020
10-12-2020,11 - 12,1299,2258,12870,3759,20186
10-12-2020,12 - 13,1218,2397,12911,3933,20459
10-12-2020,13 - 14,1207,2346,12914,3889,20356
10-12-2020,14 - 15,1145,2401,12959,3863,20368
10-12-2020,15 - 16,1129,2525,13252,3828,20734
10-12-2020,16 - 17,1359,2380,13155,3784,20678
10-12-2020,17 - 18,1421,2311,13041,3817,20590
10-12-2020,18 - 19,1340,2397,12865,3846,20448
10-12-2020,19 - 20,1343,2245,12594,3794,19976
10-12-2020,20 - 21,1328,2292,12156,3669,19445
10-12-2020,21 - 22,1198,2288,11783,3494,18763
10-12-2020,22 - 23,1131,2234,11252,3307,17924
10-12-2020,23 - 00,1124,2160,10477,3093,16854
11-12-2020,00 - 01,1175,2118,10230,3021,16544
11-12-2020,01 - 02,1143,2087,10049,2967,16246
11-12-2020,02 - 03,1081,2051,9991,2908,16031
11-12-2020,03 - 04,1037,2075,10072,2879,16063
11-12-2020,04 - 05,1109,2119,10269,2914,16411
11-12-2020,05 - 06,1216,2255,10653,3048,17172
11-12-2020,06 - 07,1298,2397,11664,3395,18754
11-12-2020,07 - 08,1317,2425,12754,3738,20234
11-12-2020,08 - 09,1366,2508,13140,3824,20838
11-12-2020,09 - 10,1348,2514,13010,3807,20679
11-12-2020,10 - 11,1393,2476,13215,3862,20946
11-12-2020,11 - 12,1419,2408,13308,3901,21036
11-12-2020,12 - 13,1386,2442,13325,3886,21039
11-12-2020,13 - 14,1366,2440,13119,3833,20758
11-12-2020,14 - 15,1397,2387,13112,3751,20647
11-12-2020,15 - 16,1435,2383,13273,3774,20865
11-12-2020,16 - 17,1429,2361,13342,3787,20919
11-12-2020,17 - 18,1378,2464,13450,3760,21052
11-12-2020,18 - 19,1364,2350,13184,3634,20532
11-12-2020,19 - 20,1295,2337,13018,3491,20141
11-12-2020,20 - 21,1318,2284,12590,3325,19517
11-12-2020,21 - 22,1244,2177,11518,3169,18108
11-12-2020,22 - 23,1247,2076,11145,2964,17432
11-12-2020,23 - 00,1185,2271,10400,2907,16763
12-12-2020,00 - 01,1388,2179,10043,2815,16425
12-12-2020,01 - 02,1227,2076,9795,2753,15851
12-12-2020,02 - 03,1233,2047,9648,2711,15639
12-12-2020,03 - 04,1217,2034,9365,2686,15302
12-12-2020,04 - 05,1256,2071,9308,2692,15327
12-12-2020,05 - 06,1264,2102,9572,2734,15672
12-12-2020,06 - 07,1256,2131,9890,2843,16120
12-12-2020,07 - 08,1299,2159,10188,2970,16616
12-12-2020,08 - 09,1287,2223,10615,3081,17206
12-12-2020,09 - 10,1412,2347,11119,3229,18107
12-12-2020,10 - 11,1421,2324,11508,3349,18602
12-12-2020,11 - 12,1356,2337,11566,3438,18697
12-12-2020,12 - 13,1428,2251,11561,3396,18636
12-12-2020,13 - 14,1441,2244,11569,3352,18606
12-12-2020,14 - 15,1457,2327,11485,3342,18611
12-12-2020,15 - 16,1444,2368,11808,3443,19063
12-12-2020,16 - 17,1356,2340,11992,3537,19225
12-12-2020,17 - 18,1378,2330,12060,3530,19298
12-12-2020,18 - 19,1375,2290,11818,3454,18937
12-12-2020,19 - 20,1340,2243,11468,3321,18372
12-12-2020,20 - 21,1324,2195,11039,3156,17714
12-12-2020,21 - 22,1327,2106,10642,3030,17105
12-12-2020,22 - 23,1300,2072,10248,2897,16517
12-12-2020,23 - 00,1273,2070,9811,2760,15914
13-12-2020,00 - 01,1230,2074,9402,2655,15361
13-12-2020,01 - 02,1234,2078,9131,2594,15037
13-12-2020,02 - 03,1238,2036,8980,2555,14809
13-12-2020,03 - 04,1230,2037,8968,2511,14746
13-12-2020,04 - 05,1231,2029,8984,2543,14787
13-12-2020,05 - 06,1212,2126,9116,2565,15019
13-12-2020,06 - 07,1280,2110,9346,2665,15401
13-12-2020,07 - 08,1230,2089,9748,2798,15865
13-12-2020,08 - 09,1336,2140,10168,2915,16559
13-12-2020,09 - 10,1355,2161,10635,3021,17172
13-12-2020,10 - 11,1311,2194,11081,3141,17727
13-12-2020,11 - 12,1307,2219,11336,3189,18051
13-12-2020,12 - 13,1339,2242,11440,3199,18220
13-12-2020,13 - 14,1454,2260,11590,3183,18487
13-12-2020,14 - 15,1372,2289,11738,3195,18594
13-12-2020,15 - 16,1389,2334,12039,3278,19040
13-12-2020,16 - 17,1440,2413,12175,3373,19401
13-12-2020,17 - 18,1476,2486,12241,3440,19643
13-12-2020,18 - 19,1511,2378,12143,3416,19448
13-12-2020,19 - 20,1471,2296,11878,3337,18982
13-12-2020,20 - 21,1457,2256,11520,3214,18447
13-12-2020,21 - 22,1389,2216,11097,3118,17820
13-12-2020,22 - 23,1321,2155,10633,3015,17124
13-12-2020,23 - 00,1329,2166,10121,2922,16538
14-12-2020,00 - 01,1257,2078,9777,2819,15931
14-12-2020,01 - 02,1287,2158,9667,2756,15868
14-12-2020,02 - 03,1278,2138,9690,2743,15849
14-12-2020,03 - 04,1281,2181,9676,2730,15868
14-12-2020,04 - 05,1285,2191,9915,2768,16159
14-12-2020,05 - 06,1304,2242,10353,2957,16856
14-12-2020,06 - 07,1398,2462,11345,3341,18546
14-12-2020,07 - 08,1379,2507,12110,3597,19593
14-12-2020,08 - 09,1480,2563,12361,3622,20026
14-12-2020,09 - 10,1513,2569,12242,3620,19944
14-12-2020,10 - 11,1436,2591,12556,3601,20184
14-12-2020,11 - 12,1418,2562,12640,3684,20304
14-12-2020,12 - 13,1419,2654,12604,3657,20334
14-12-2020,13 - 14,1451,2471,12559,3689,20170
14-12-2020,14 - 15,1461,2486,12636,3660,20243
14-12-2020,15 - 16,1431,2626,12943,3674,20674
14-12-2020,16 - 17,1468,2604,12953,3697,20722
14-12-2020,17 - 18,1431,2479,12775,3665,20350
14-12-2020,18 - 19,1386,2568,12496,3569,20019
14-12-2020,19 - 20,1392,2471,12344,3511,19718
14-12-2020,20 - 21,1439,2226,11997,3452,19114
14-12-2020,21 - 22,1384,2130,11411,3294,18219
14-12-2020,22 - 23,1308,2082,10826,3116,17332
14-12-2020,23 - 00,1278,2100,10092,2887,16357
15-12-2020,00 - 01,1272,2022,9669,2776,15739
15-12-2020,01 - 02,1268,1951,9571,2706,15496
15-12-2020,02 - 03,1247,1980,9494,2650,15371
15-12-2020,03 - 04,1305,1998,9441,2644,15388
15-12-2020,04 - 05,1281,1918,9419,2711,15329
15-12-2020,05 - 06,1294,2065,9872,2836,16067
15-12-2020,06 - 07,1548,2109,10855,3110,17622
15-12-2020,07 - 08,1563,2250,11990,3464,19267
15-12-2020,08 - 09,1482,2343,12088,3567,19480
15-12-2020,09 - 10,1401,2299,12018,3535,19253
15-12-2020,10 - 11,1374,2291,12077,3578,19320
15-12-2020,11 - 12,1349,2196,12224,3605,19374
15-12-2020,12 - 13,1288,2219,12253,3551,19311
15-12-2020,13 - 14,1282,2256,12201,3542,19281
15-12-2020,14 - 15,1241,2288,12265,3627,19421
15-12-2020,15 - 16,1428,2340,12496,3697,19961
15-12-2020,16 - 17,1528,2313,12473,3695,20009
15-12-2020,17 - 18,1427,2439,12460,3713,20039
15-12-2020,18 - 19,1509,2397,12133,3623,19662
15-12-2020,19 - 20,1440,2346,11789,3468,19043
15-12-2020,20 - 21,1388,2131,11330,3355,18204
15-12-2020,21 - 22,1416,2011,10815,3193,17435
15-12-2020,22 - 23,1302,1955,10182,3001,16440
15-12-2020,23 - 00,1313,1967,9665,2847,15792
16-12-2020,00 - 01,1301,2046,9213,2718,15278
16-12-2020,01 - 02,1346,1988,9018,2599,14951
16-12-2020,02 - 03,1294,2041,8889,2545,14769
16-12-2020,03 - 04,1273,1970,8801,2503,14547
16-12-2020,04 - 05,1288,2012,8907,2543,14750
16-12-2020,05 - 06,1352,2059,9431,2688,15530
16-12-2020,06 - 07,1479,2029,10469,2956,16933
16-12-2020,07 - 08,1390,2154,11523,3272,18339
16-12-2020,08 - 09,1521,1868,11915,3414,18718
16-12-2020,09 - 10,1522,1830,11966,3453,18771
16-12-2020,10 - 11,1554,1868,11965,3461,18848
16-12-2020,11 - 12,1540,1964,12122,3410,19036
16-12-2020,12 - 13,1535,1874,12070,3405,18884
16-12-2020,13 - 14,1472,1946,12047,3418,18883
16-12-2020,14 - 15,1482,1958,12139,3407,18986
16-12-2020,15 - 16,1478,2152,12479,3522,19631
16-12-2020,16 - 17,1533,2230,12633,3614,20010
16-12-2020,17 - 18,1526,2223,12736,3622,20107
16-12-2020,18 - 19,1555,2240,12547,3550,19892
16-12-2020,19 - 20,1606,2321,12155,3363,19445
16-12-2020,20 - 21,1567,2246,11760,3166,18739
16-12-2020,21 - 22,1485,2192,11197,2995,17869
16-12-2020,22 - 23,1586,2108,10687,2776,17157
16-12-2020,23 - 00,1623,2039,10051,2511,16224
17-12-2020,00 - 01,1464,2005,9693,2404,15566
17-12-2020,01 - 02,1413,1978,9505,2363,15259
17-12-2020,02 - 03,1366,1948,9347,2349,15010
17-12-2020,03 - 04,1312,1907,9345,2395,14959
17-12-2020,04 - 05,1402,1878,9448,2472,15200
17-12-2020,05 - 06,1458,1889,9980,2649,15976
17-12-2020,06 - 07,1462,2180,11041,3042,17725
17-12-2020,07 - 08,1438,2255,11996,3419,19108
17-12-2020,08 - 09,1519,2386,12338,3579,19822
17-12-2020,09 - 10,1566,2411,12340,3577,19894
17-12-2020,10 - 11,1500,2447,12453,3642,20042
17-12-2020,11 - 12,1406,2401,12547,3660,20014
17-12-2020,12 - 13,1437,2504,12645,3655,20241
17-12-2020,13 - 14,1441,2373,12615,3657,20086
17-12-2020,14 - 15,1468,2349,12633,3617,20067
17-12-2020,15 - 16,1516,2385,12818,3667,20386
17-12-2020,16 - 17,1527,2533,12728,3610,20398
17-12-2020,17 - 18,1500,2498,12840,3718,20556
17-12-2020,18 - 19,1476,2351,12510,3583,19920
17-12-2020,19 - 20,1402,2245,11873,3379,18899
17-12-2020,20 - 21,1391,2240,11367,3203,18201
17-12-2020,21 - 22,1390,2191,10894,3082,17557
17-12-2020,22 - 23,1364,2067,10304,2917,16652
17-12-2020,23 - 00,1384,1850,9535,2753,15522
18-12-2020,00 - 01,1252,1904,9011,2612,14779
18-12-2020,01 - 02,1240,1864,8888,2505,14497
18-12-2020,02 - 03,1205,1823,8794,2470,14292
18-12-2020,03 - 04,1202,1767,8769,2482,14220
18-12-2020,04 - 05,1227,1901,8963,2539,14630
18-12-2020,05 - 06,1342,1949,9463,2642,15396
18-12-2020,06 - 07,1425,2081,10473,2988,16967
18-12-2020,07 - 08,1415,2204,11555,3365,18539
18-12-2020,08 - 09,1396,2295,12060,3468,19219
18-12-2020,09 - 10,1350,2392,12046,3471,19259
18-12-2020,10 - 11,1387,2358,12125,3445,19315
18-12-2020,11 - 12,1397,2307,12064,3237,19005
18-12-2020,12 - 13,1425,2347,12069,3320,19161
18-12-2020,13 - 14,1435,2317,11836,3392,18980
18-12-2020,14 - 15,1389,2384,11798,3412,18983
18-12-2020,15 - 16,1372,2377,12004,3403,19156
18-12-2020,16 - 17,1333,2457,12050,3425,19265
18-12-2020,17 - 18,1300,2315,12012,3362,18989
18-12-2020,18 - 19,1248,2202,11656,3365,18471
18-12-2020,19 - 20,1282,2053,11162,3152,17649
18-12-2020,20 - 21,1293,1832,10598,2961,16684
18-12-2020,21 - 22,1244,1650,10052,2880,15826
18-12-2020,22 - 23,1278,1538,9589,2784,15189
18-12-2020,23 - 00,1288,1535,9161,2685,14669
19-12-2020,00 - 01,1249,1604,8894,2604,14351
19-12-2020,01 - 02,1230,1549,8702,2478,13959
19-12-2020,02 - 03,1247,1547,8496,2389,13679
19-12-2020,03 - 04,1237,1748,8405,2406,13796
19-12-2020,04 - 05,1252,1604,8425,2432,13713
19-12-2020,05 - 06,1265,1610,8575,2522,13972
19-12-2020,06 - 07,1261,1838,9003,2687,14789
19-12-2020,07 - 08,1219,1769,9360,2851,15199
19-12-2020,08 - 09,1287,1811,9873,3015,15986
19-12-2020,09 - 10,1415,2018,10215,3083,16731
19-12-2020,10 - 11,1372,1898,10540,3151,16961
19-12-2020,11 - 12,1402,1886,10721,3136,17145
19-12-2020,12 - 13,1519,1928,10747,3122,17316
19-12-2020,13 - 14,1450,1847,10782,3187,17266
19-12-2020,14 - 15,1486,1848,10827,3184,17345
19-12-2020,15 - 16,1436,1791,11157,3264,17648
19-12-2020,16 - 17,1413,1999,11432,3272,18116
19-12-2020,17 - 18,1442,2042,11640,3279,18403
19-12-2020,18 - 19,1490,1976,11546,3354,18366
19-12-2020,19 - 20,1400,1855,11177,3280,17712
19-12-2020,20 - 21,1417,1732,10826,3104,17079
19-12-2020,21 - 22,1451,1769,10350,2916,16486
19-12-2020,22 - 23,1241,1583,9856,2804,15484
19-12-2020,23 - 00,1253,1566,9419,2685,14923
20-12-2020,00 - 01,1201,1436,9083,2612,14332
20-12-2020,01 - 02,1282,1559,8742,2544,14127
20-12-2020,02 - 03,1274,1533,8673,2519,13999
20-12-2020,03 - 04,1274,1575,8635,2510,13994
20-12-2020,04 - 05,1349,1302,8522,2514,13687
20-12-2020,05 - 06,1458,1233,8556,2546,13793
20-12-2020,06 - 07,1404,1411,8777,2606,14198
20-12-2020,07 - 08,1386,1454,9171,2730,14741
20-12-2020,08 - 09,1414,1566,9666,2877,15523
20-12-2020,09 - 10,1106,1745,10030,2982,15863
20-12-2020,10 - 11,1062,1781,10309,3087,16239
20-12-2020,11 - 12,1373,1745,10449,3043,16610
20-12-2020,12 - 13,1420,1786,10556,2967,16729
20-12-2020,13 - 14,1266,1745,10697,3109,16817
20-12-2020,14 - 15,1234,1787,10747,3114,16882
20-12-2020,15 - 16,1321,1946,11204,3206,17677
20-12-2020,16 - 17,1388,1889,11339,3274,17890
20-12-2020,17 - 18,1340,1840,11429,3398,18007
20-12-2020,18 - 19,1315,1810,11276,3342,17743
20-12-2020,19 - 20,1468,1905,10973,3252,17598
20-12-2020,20 - 21,1356,1907,10647,3129,17039
20-12-2020,21 - 22,1355,1830,10214,2992,16391
20-12-2020,22 - 23,1397,1581,9782,2846,15606
20-12-2020,23 - 00,1339,1376,9195,2742,14652
21-12-2020,00 - 01,1159,1592,8784,2606,14141
21-12-2020,01 - 02,1087,1637,8539,2564,13827
21-12-2020,02 - 03,1121,1557,8469,2543,13690
21-12-2020,03 - 04,860,1510,8390,2517,13277
21-12-2020,04 - 05,871,1646,8595,2551,13663
21-12-2020,05 - 06,1045,1558,9057,2667,14327
21-12-2020,06 - 07,1277,1791,10180,3016,16264
21-12-2020,07 - 08,1181,2059,11185,3418,17843
21-12-2020,08 - 09,1156,2011,11600,3541,18308
21-12-2020,09 - 10,1351,2028,11594,3558,18531
21-12-2020,10 - 11,1426,1968,11743,3493,18630
21-12-2020,11 - 12,1316,2001,11750,3536,18603
21-12-2020,12 - 13,1361,2066,11774,3555,18756
21-12-2020,13 - 14,1362,2031,11822,3546,18761
21-12-2020,14 - 15,1242,2023,11899,3548,18712
21-12-2020,15 - 16,1379,2038,12247,3538,19202
21-12-2020,16 - 17,1386,1915,12372,3607,19280
21-12-2020,17 - 18,1342,1936,12392,3614,19284
21-12-2020,18 - 19,1415,1928,12054,3534,18931
21-12-2020,19 - 20,1308,1936,11672,3426,18342
21-12-2020,20 - 21,1269,1675,11269,3263,17476
21-12-2020,21 - 22,1176,1841,10702,3115,16834
21-12-2020,22 - 23,1006,1847,10078,2943,15874
21-12-2020,23 - 00,1089,1591,9588,2743,15011
22-12-2020,00 - 01,1073,1543,9179,2546,14341
22-12-2020,01 - 02,1040,1478,8945,2454,13917
22-12-2020,02 - 03,1195,1450,8890,2397,13932
22-12-2020,03 - 04,1165,1452,8808,2427,13852
22-12-2020,04 - 05,1114,1458,8923,2437,13932
22-12-2020,05 - 06,905,1303,9314,2559,14081
22-12-2020,06 - 07,1049,1527,10183,2894,15653
22-12-2020,07 - 08,1351,1893,11297,3258,17799
22-12-2020,08 - 09,1458,1962,11886,3456,18762
22-12-2020,09 - 10,1369,2026,12123,3484,19002
22-12-2020,10 - 11,1482,2012,12143,3526,19163
22-12-2020,11 - 12,1358,1843,12242,3575,19018
22-12-2020,12 - 13,1378,2037,12407,3525,19347
22-12-2020,13 - 14,1361,1868,12468,3541,19238
22-12-2020,14 - 15,1359,1870,12524,3475,19228
22-12-2020,15 - 16,1397,2026,12667,3446,19536
22-12-2020,16 - 17,1441,2003,12732,3529,19705
22-12-2020,17 - 18,1373,1879,12737,3506,19495
22-12-2020,18 - 19,1253,2024,12290,3441,19008
22-12-2020,19 - 20,1409,1815,11919,3335,18478
22-12-2020,20 - 21,1435,1901,11512,3239,18087
22-12-2020,21 - 22,1258,1993,11022,3023,17296
22-12-2020,22 - 23,1039,2046,10450,2877,16412
22-12-2020,23 - 00,1245,1873,9762,2768,15648
23-12-2020,00 - 01,1225,1840,9169,2689,14923
23-12-2020,01 - 02,1282,1908,8904,2602,14696
23-12-2020,02 - 03,1181,1887,8743,2571,14382
23-12-2020,03 - 04,1124,1774,8754,2582,14234
23-12-2020,04 - 05,1113,1883,8786,2564,14346
23-12-2020,05 - 06,1352,2102,9214,2638,15306
23-12-2020,06 - 07,1412,2108,10128,2882,16530
23-12-2020,07 - 08,1528,2152,10840,3190,17710
23-12-2020,08 - 09,1415,2374,11312,3331,18432
23-12-2020,09 - 10,1265,2282,11598,3381,18526
23-12-2020,10 - 11,1310,2105,11838,3387,18640
23-12-2020,11 - 12,1277,2034,11880,3401,18592
23-12-2020,12 - 13,1299,2056,11741,3383,18479
23-12-2020,13 - 14,1357,2156,11720,3351,18584
23-12-2020,14 - 15,1453,2183,11695,3343,18674
23-12-2020,15 - 16,1389,2135,12244,3380,19148
23-12-2020,16 - 17,1375,2155,12578,3460,19568
23-12-2020,17 - 18,1364,2113,12606,3504,19587
23-12-2020,18 - 19,1300,2138,12309,3431,19178
23-12-2020,19 - 20,1341,2071,11877,3295,18584
23-12-2020,20 - 21,1206,2103,11369,3094,17772
23-12-2020,21 - 22,1173,2042,10799,2939,16953
23-12-2020,22 - 23,1087,1811,10348,2836,16082
23-12-2020,23 - 00,1083,1891,10055,2751,15780
24-12-2020,00 - 01,1105,1718,9567,2566,14956
24-12-2020,01 - 02,1197,1642,9120,2476,14435
24-12-2020,02 - 03,1220,1604,8904,2387,14115
24-12-2020,03 - 04,1233,1557,8744,2353,13887
24-12-2020,04 - 05,1134,1555,8930,2344,13963
24-12-2020,05 - 06,1163,1587,9153,2425,14328
24-12-2020,06 - 07,1238,1672,9652,2540,15102
24-12-2020,07 - 08,1207,1678,10144,2723,15752
24-12-2020,08 - 09,1285,1818,10816,2935,16854
24-12-2020,09 - 10,1363,1854,11258,3082,17557
24-12-2020,10 - 11,1366,1849,11625,3186,18026
24-12-2020,11 - 12,1320,1888,11746,3235,18189
24-12-2020,12 - 13,1330,2018,11619,3270,18237
24-12-2020,13 - 14,1347,1968,11455,3267,18037
24-12-2020,14 - 15,1290,1991,11494,3277,18052
24-12-2020,15 - 16,1313,1812,11776,3305,18206
24-12-2020,16 - 17,1277,1857,11829,3433,18396
24-12-2020,17 - 18,1260,1846,11683,3384,18173
24-12-2020,18 - 19,1206,1753,11367,3317,17643
24-12-2020,19 - 20,1215,1673,11134,3226,17248
24-12-2020,20 - 21,1270,1708,10891,3172,17041
24-12-2020,21 - 22,1260,1653,10757,3118,16788
24-12-2020,22 - 23,1320,1706,10454,3056,16536
24-12-2020,23 - 00,1264,1756,10269,2971,16260
25-12-2020,00 - 01,1251,1710,9917,2796,15674
25-12-2020,01 - 02,1242,1795,9732,2748,15517
25-12-2020,02 - 03,1309,1695,9656,2725,15385
25-12-2020,03 - 04,1276,1515,9481,2672,14944
25-12-2020,04 - 05,1309,1531,9491,2678,15009
25-12-2020,05 - 06,1418,1683,9705,2757,15563
25-12-2020,06 - 07,1327,1887,10164,2871,16249
25-12-2020,07 - 08,1350,1838,10452,2993,16633
25-12-2020,08 - 09,1421,2080,10776,3091,17368
25-12-2020,09 - 10,1354,2095,11012,3134,17595
25-12-2020,10 - 11,1329,2240,11321,3218,18108
25-12-2020,11 - 12,1352,2359,11417,3278,18406
25-12-2020,12 - 13,1461,2366,11598,3272,18697
25-12-2020,13 - 14,1431,2283,11691,3293,18698
25-12-2020,14 - 15,1500,2404,11830,3323,19057
25-12-2020,15 - 16,1279,2460,12217,3399,19355
25-12-2020,16 - 17,1410,2601,12626,3562,20199
25-12-2020,17 - 18,1376,2597,12769,3571,20313
25-12-2020,18 - 19,1548,2478,12548,3467,20041
25-12-2020,19 - 20,1419,2381,12318,3387,19505
25-12-2020,20 - 21,1381,2285,12006,3275,18947
25-12-2020,21 - 22,1505,2265,11602,3175,18547
25-12-2020,22 - 23,1368,2213,11296,3110,17987
25-12-2020,23 - 00,1364,2220,10977,3050,17611
26-12-2020,00 - 01,1300,2155,10701,2987,17143
26-12-2020,01 - 02,1308,2190,10501,2950,16949
26-12-2020,02 - 03,1350,2151,10293,2924,16718
26-12-2020,03 - 04,1355,2060,10191,2891,16497
26-12-2020,04 - 05,1359,1991,10099,2866,16315
26-12-2020,05 - 06,1365,1999,10145,2913,16422
26-12-2020,06 - 07,1363,1971,10290,2922,16546
26-12-2020,07 - 08,1382,1940,10573,3028,16923
26-12-2020,08 - 09,1407,1988,10692,3109,17196
26-12-2020,09 - 10,1469,1997,10940,3177,17583
26-12-2020,10 - 11,1416,2046,11319,3252,18033
26-12-2020,11 - 12,1425,2006,11527,3301,18259
26-12-2020,12 - 13,1406,2027,11506,3301,18240
26-12-2020,13 - 14,1472,2115,11554,3300,18441
26-12-2020,14 - 15,1481,2233,11672,3273,18659
26-12-2020,15 - 16,1476,2282,12042,3255,19055
26-12-2020,16 - 17,1474,2328,12199,3312,19313
26-12-2020,17 - 18,1445,2217,12133,3334,19129
26-12-2020,18 - 19,1473,2401,12026,3300,19200
26-12-2020,19 - 20,1447,2392,11584,3203,18626
26-12-2020,20 - 21,1306,2318,11179,3081,17884
26-12-2020,21 - 22,1380,2206,10620,2955,17161
26-12-2020,22 - 23,1460,2212,10177,2874,16723
26-12-2020,23 - 00,1417,2012,9913,2746,16088
27-12-2020,00 - 01,1447,1913,9419,2654,15433
27-12-2020,01 - 02,1505,1917,9254,2615,15291
27-12-2020,02 - 03,1508,1859,9095,2587,15049
27-12-2020,03 - 04,1476,1924,9066,2565,15031
27-12-2020,04 - 05,1479,1941,9066,2591,15077
27-12-2020,05 - 06,1512,1910,9134,2617,15173
27-12-2020,06 - 07,1511,1965,9329,2721,15526
27-12-2020,07 - 08,1571,1977,9561,2819,15928
27-12-2020,08 - 09,1451,1931,9962,2927,16271
27-12-2020,09 - 10,1416,2046,10301,3041,16804
27-12-2020,10 - 11,1376,2113,10713,3151,17353
27-12-2020,11 - 12,1406,2043,11046,3257,17752
27-12-2020,12 - 13,1446,1966,11167,3326,17905
27-12-2020,13 - 14,1400,2001,11251,3372,18024
27-12-2020,14 - 15,1386,2057,11318,3432,18193
27-12-2020,15 - 16,1501,2046,11627,3511,18685
27-12-2020,16 - 17,1475,2074,11799,3608,18956
27-12-2020,17 - 18,1375,2100,11906,3642,19023
27-12-2020,18 - 19,1439,1952,11836,3594,18821
27-12-2020,19 - 20,1484,1870,11520,3493,18367
27-12-2020,20 - 21,1444,1834,11224,3362,17864
27-12-2020,21 - 22,1413,1937,10776,3250,17376
27-12-2020,22 - 23,1437,1809,10260,3121,16627
27-12-2020,23 - 00,1360,1732,9683,3012,15787
28-12-2020,00 - 01,1326,1712,9432,2886,15356
28-12-2020,01 - 02,1350,1744,9562,2840,15496
28-12-2020,02 - 03,1330,1692,9489,2756,15267
28-12-2020,03 - 04,1325,1719,9415,2735,15194
28-12-2020,04 - 05,1275,1778,9484,2804,15341
28-12-2020,05 - 06,1342,1966,9840,2955,16103
28-12-2020,06 - 07,1386,2038,10581,3153,17158
28-12-2020,07 - 08,1530,2091,11379,3337,18337
28-12-2020,08 - 09,1471,1962,11791,3517,18741
28-12-2020,09 - 10,1413,2125,12007,3598,19143
28-12-2020,10 - 11,1490,2169,12274,3591,19524
28-12-2020,11 - 12,1499,2223,12378,3588,19688
28-12-2020,12 - 13,1612,2179,12478,3608,19877
28-12-2020,13 - 14,1625,2294,12510,3631,20060
28-12-2020,14 - 15,1540,2495,12641,3594,20270
28-12-2020,15 - 16,1478,2447,12889,3592,20406
28-12-2020,16 - 17,1485,2532,12847,3604,20468
28-12-2020,17 - 18,1502,2663,12835,3684,20684
28-12-2020,18 - 19,1479,2492,12516,3629,20116
28-12-2020,19 - 20,1388,2441,12110,3511,19450
28-12-2020,20 - 21,1340,2351,11696,3328,18715
28-12-2020,21 - 22,1388,2278,11307,3163,18136
28-12-2020,22 - 23,1445,2021,10817,3019,17302
28-12-2020,23 - 00,1402,2018,10362,2907,16689
29-12-2020,00 - 01,1209,2111,9939,2780,16039
29-12-2020,01 - 02,1321,2115,9700,2691,15827
29-12-2020,02 - 03,1266,2153,9554,2667,15640
29-12-2020,03 - 04,1407,2169,9478,2688,15742
29-12-2020,04 - 05,1208,2192,9602,2670,15672
29-12-2020,05 - 06,1379,2035,9865,2739,16018
29-12-2020,06 - 07,1395,2209,10478,2924,17006
29-12-2020,07 - 08,1405,2369,11075,3186,18035
29-12-2020,08 - 09,1423,2453,11456,3267,18599
29-12-2020,09 - 10,1360,2211,11533,3373,18477
29-12-2020,10 - 11,1378,2428,11768,3435,19009
29-12-2020,11 - 12,1375,2542,11928,3494,19339
29-12-2020,12 - 13,1409,2517,12109,3488,19523
29-12-2020,13 - 14,1414,2683,12131,3465,19693
29-12-2020,14 - 15,1418,2701,12165,3473,19757
29-12-2020,15 - 16,1422,2710,12390,3550,20072
29-12-2020,16 - 17,1468,2611,12348,3548,19975
29-12-2020,17 - 18,1454,2492,12258,3495,19699
29-12-2020,18 - 19,1412,2469,12026,3462,19369
29-12-2020,19 - 20,1397,2460,11595,3381,18833
29-12-2020,20 - 21,1395,2540,11204,3345,18484
29-12-2020,21 - 22,1357,2534,10800,3217,17908
29-12-2020,22 - 23,1348,2408,10479,3023,17258
29-12-2020,23 - 00,1279,2281,10120,2853,16533
30-12-2020,00 - 01,1243,2156,9767,2638,15804
30-12-2020,01 - 02,1196,2171,9558,2628,15553
30-12-2020,02 - 03,1303,2092,9491,2582,15468
30-12-2020,03 - 04,1318,2100,9449,2585,15452
30-12-2020,04 - 05,1316,2225,9513,2636,15690
30-12-2020,05 - 06,1358,2196,9848,2729,16131
30-12-2020,06 - 07,1345,2275,10575,2868,17063
30-12-2020,07 - 08,1373,2446,11203,3103,18125
30-12-2020,08 - 09,1330,2415,11633,3224,18602
30-12-2020,09 - 10,1397,2510,11802,3276,18985
30-12-2020,10 - 11,1388,2552,11996,3309,19245
30-12-2020,11 - 12,1391,2451,12291,3403,19536
30-12-2020,12 - 13,1374,2399,12425,3482,19680
30-12-2020,13 - 14,1373,2421,12395,3456,19645
30-12-2020,14 - 15,1372,2379,12343,3397,19491
30-12-2020,15 - 16,1342,2507,12616,3427,19892
30-12-2020,16 - 17,1400,2602,12763,3516,20281
30-12-2020,17 - 18,1401,2555,12712,3497,20165
30-12-2020,18 - 19,1364,2484,12477,3410,19735
30-12-2020,19 - 20,1386,2427,12092,3279,19184
30-12-2020,20 - 21,1398,2376,11597,3100,18471
30-12-2020,21 - 22,1433,2352,11116,2954,17855
30-12-2020,22 - 23,1422,2294,10627,2751,17094
30-12-2020,23 - 00,1307,2210,10188,2633,16338
31-12-2020,00 - 01,1293,2189,9756,2489,15727
31-12-2020,01 - 02,1362,2142,9417,2440,15361
31-12-2020,02 - 03,1343,2148,9273,2432,15196
31-12-2020,03 - 04,1334,2098,9222,2425,15079
31-12-2020,04 - 05,1381,2085,9182,2424,15072
31-12-2020,05 - 06,1413,2084,9286,2480,15263
31-12-2020,06 - 07,1329,2189,9606,2624,15748
31-12-2020,07 - 08,1329,2240,9925,2721,16215
31-12-2020,08 - 09,1358,2249,10272,2757,16636
31-12-2020,09 - 10,1364,2221,10616,2871,17072
31-12-2020,10 - 11,1335,2318,10998,3017,17668
31-12-2020,11 - 12,1296,2368,11166,3105,17935
31-12-2020,12 - 13,1288,2376,11407,3152,18223
31-12-2020,13 - 14,1295,2348,11538,3119,18300
31-12-2020,14 - 15,1349,2360,11726,3185,18620
31-12-2020,15 - 16,1313,2450,12091,3344,19198
31-12-2020,16 - 17,1366,2431,12369,3515,19681
31-12-2020,17 - 18,1424,2428,12323,3492,19667
31-12-2020,18 - 19,1386,2348,11981,3418,19133
31-12-2020,19 - 20,1292,2233,11320,3245,18090
31-12-2020,20 - 21,1232,2165,10751,3020,17168
31-12-2020,21 - 22,1224,2249,10264,2877,16614
31-12-2020,22 - 23,1210,2203,9964,2808,16185
31-12-2020,23 - 00,1186,2119,9703,2758,15766
