,Hours,SE1,SE2,SE3,SE4,SE
01-01-2019,00 - 01,1126,1873,9212,2386,14597
01-01-2019,01 - 02,1140,1830,9057,2348,14375
01-01-2019,02 - 03,1127,1738,8949,2339,14153
01-01-2019,03 - 04,1057,1742,8812,2285,13896
01-01-2019,04 - 05,1093,1795,8804,2263,13955
01-01-2019,05 - 06,1155,1812,8898,2301,14166
01-01-2019,06 - 07,1135,1711,9107,2399,14352
01-01-2019,07 - 08,1131,1740,9426,2510,14807
01-01-2019,08 - 09,1118,1856,9520,2570,15064
01-01-2019,09 - 10,1219,1947,9679,2647,15492
01-01-2019,10 - 11,1341,1844,9876,2749,15810
01-01-2019,11 - 12,1272,1892,10047,2834,16045
01-01-2019,12 - 13,1317,1957,10175,2805,16254
01-01-2019,13 - 14,1342,1940,10215,2824,16321
01-01-2019,14 - 15,1446,2056,10474,2898,16874
01-01-2019,15 - 16,1399,2089,10966,2982,17436
01-01-2019,16 - 17,1432,2131,11395,3215,18173
01-01-2019,17 - 18,1416,2278,11434,3260,18388
01-01-2019,18 - 19,1437,2202,11379,3182,18200
01-01-2019,19 - 20,1278,2127,11252,3068,17725
01-01-2019,20 - 21,1289,2069,11078,2988,17424
01-01-2019,21 - 22,1315,2012,10802,2901,17030
01-01-2019,22 - 23,1288,2095,10541,2821,16745
01-01-2019,23 - 00,1282,2024,10343,2686,16335
02-01-2019,00 - 01,1222,1915,10239,2632,16008
02-01-2019,01 - 02,1226,1937,10193,2582,15938
02-01-2019,02 - 03,1222,1883,10070,2596,15771
02-01-2019,03 - 04,1237,1928,10106,2622,15893
02-01-2019,04 - 05,1261,2012,10269,2721,16263
02-01-2019,05 - 06,1297,2031,10670,2921,16919
02-01-2019,06 - 07,1322,2077,11616,3185,18200
02-01-2019,07 - 08,1434,2202,12592,3529,19757
02-01-2019,08 - 09,1429,2271,13094,3690,20484
02-01-2019,09 - 10,1382,2228,13220,3763,20593
02-01-2019,10 - 11,1400,2343,13394,3754,20891
02-01-2019,11 - 12,1410,2255,13278,3670,20613
02-01-2019,12 - 13,1375,2388,13351,3629,20743
02-01-2019,13 - 14,1557,2227,13333,3626,20743
02-01-2019,14 - 15,1581,2470,13524,3656,21231
02-01-2019,15 - 16,1600,2424,13852,3788,21664
02-01-2019,16 - 17,1494,2415,14097,3991,21997
02-01-2019,17 - 18,1517,2441,14065,4059,22082
02-01-2019,18 - 19,1516,2334,13865,3966,21681
02-01-2019,19 - 20,1390,2205,13607,3834,21036
02-01-2019,20 - 21,1394,2337,13173,3733,20637
02-01-2019,21 - 22,1512,2366,12447,3557,19882
02-01-2019,22 - 23,1283,2416,11862,3393,18954
02-01-2019,23 - 00,1325,2239,11466,3147,18177
03-01-2019,00 - 01,1354,2132,10989,3013,17488
03-01-2019,01 - 02,1359,2218,10689,2827,17093
03-01-2019,02 - 03,1376,2074,10687,2686,16823
03-01-2019,03 - 04,1351,2067,10787,2665,16870
03-01-2019,04 - 05,1340,2082,10813,2756,16991
03-01-2019,05 - 06,1328,2186,11115,3007,17636
03-01-2019,06 - 07,1386,2352,11951,3369,19058
03-01-2019,07 - 08,1363,2682,12883,3684,20612
03-01-2019,08 - 09,1468,2623,13434,3885,21410
03-01-2019,09 - 10,1553,2477,13520,3889,21439
03-01-2019,10 - 11,1502,2284,13700,3896,21382
03-01-2019,11 - 12,1479,2113,13707,3891,21190
03-01-2019,12 - 13,1536,2220,13578,3828,21162
03-01-2019,13 - 14,1550,2180,13475,3816,21021
03-01-2019,14 - 15,1480,2236,13454,3810,20980
03-01-2019,15 - 16,1454,2308,13478,3913,21153
03-01-2019,16 - 17,1459,2412,14063,4079,22013
03-01-2019,17 - 18,1423,2263,14253,4030,21969
03-01-2019,18 - 19,1422,2161,14009,3953,21545
03-01-2019,19 - 20,1408,2130,13341,3833,20712
03-01-2019,20 - 21,1252,2079,13253,3654,20238
03-01-2019,21 - 22,1384,2017,12412,3435,19248
03-01-2019,22 - 23,1302,1956,11887,3232,18377
03-01-2019,23 - 00,1285,1828,11173,2981,17267
04-01-2019,00 - 01,1141,1772,10712,2908,16533
04-01-2019,01 - 02,1199,1778,10627,2757,16361
04-01-2019,02 - 03,1230,1839,10385,2729,16183
04-01-2019,03 - 04,1244,1861,10220,2735,16060
04-01-2019,04 - 05,1242,1853,10092,2773,15960
04-01-2019,05 - 06,1272,1779,10392,2902,16345
04-01-2019,06 - 07,1613,1997,11418,3199,18227
04-01-2019,07 - 08,1466,2128,12392,3552,19538
04-01-2019,08 - 09,1450,2267,12872,3771,20360
04-01-2019,09 - 10,1436,2249,12914,3734,20333
04-01-2019,10 - 11,1431,2138,13042,3819,20430
04-01-2019,11 - 12,1397,2073,12830,3774,20074
04-01-2019,12 - 13,1389,2073,12613,3663,19738
04-01-2019,13 - 14,1419,2085,12410,3611,19525
04-01-2019,14 - 15,1433,2107,12105,3498,19143
04-01-2019,15 - 16,1381,2042,12430,3420,19273
04-01-2019,16 - 17,1414,2130,12638,3523,19705
04-01-2019,17 - 18,1407,2192,12606,3590,19795
04-01-2019,18 - 19,1364,2144,12379,3490,19377
04-01-2019,19 - 20,1349,2002,12082,3266,18699
04-01-2019,20 - 21,1320,1959,11733,3130,18142
04-01-2019,21 - 22,1267,2052,11135,2971,17425
04-01-2019,22 - 23,1281,1960,10466,2827,16534
04-01-2019,23 - 00,1267,1923,10066,2720,15976
05-01-2019,00 - 01,1291,1912,9760,2629,15592
05-01-2019,01 - 02,1272,1905,9405,2567,15149
05-01-2019,02 - 03,1237,1869,9244,2545,14895
05-01-2019,03 - 04,1246,1910,9287,2508,14951
05-01-2019,04 - 05,1258,1927,9381,2535,15101
05-01-2019,05 - 06,1276,1898,9558,2564,15296
05-01-2019,06 - 07,1334,1857,9892,2668,15751
05-01-2019,07 - 08,1405,1916,10422,2763,16506
05-01-2019,08 - 09,1380,2008,10817,2936,17141
05-01-2019,09 - 10,1430,2065,11188,3002,17685
05-01-2019,10 - 11,1409,2157,11588,3112,18266
05-01-2019,11 - 12,1352,2214,11785,3192,18543
05-01-2019,12 - 13,1322,2063,11819,3130,18334
05-01-2019,13 - 14,1348,1972,11758,3087,18165
05-01-2019,14 - 15,1416,1988,11864,3054,18322
05-01-2019,15 - 16,1481,1991,12111,3186,18769
05-01-2019,16 - 17,1444,2008,12524,3342,19318
05-01-2019,17 - 18,1503,2051,12680,3393,19627
05-01-2019,18 - 19,1464,2106,12540,3361,19471
05-01-2019,19 - 20,1455,1996,12124,3300,18875
05-01-2019,20 - 21,1422,2014,11650,3181,18267
05-01-2019,21 - 22,1370,1869,11304,3066,17609
05-01-2019,22 - 23,1349,1818,10938,2963,17068
05-01-2019,23 - 00,1174,1820,10563,2891,16448
06-01-2019,00 - 01,1234,1744,10234,2854,16066
06-01-2019,01 - 02,1259,1728,9955,2797,15739
06-01-2019,02 - 03,1264,1619,9847,2774,15504
06-01-2019,03 - 04,1309,1548,9720,2774,15351
06-01-2019,04 - 05,1279,1536,9672,2785,15272
06-01-2019,05 - 06,1179,1509,9711,2837,15236
06-01-2019,06 - 07,1250,1482,9930,2944,15606
06-01-2019,07 - 08,1340,1545,10329,3026,16240
06-01-2019,08 - 09,1253,1768,10746,3090,16857
06-01-2019,09 - 10,1271,1912,11210,3259,17652
06-01-2019,10 - 11,1300,1881,11629,3352,18162
06-01-2019,11 - 12,1336,1928,11805,3395,18464
06-01-2019,12 - 13,1307,1927,11800,3368,18402
06-01-2019,13 - 14,1309,2116,11701,3294,18420
06-01-2019,14 - 15,1281,1940,11717,3255,18193
06-01-2019,15 - 16,1263,2026,11952,3275,18516
06-01-2019,16 - 17,1262,2133,12443,3502,19340
06-01-2019,17 - 18,1287,2190,12567,3564,19608
06-01-2019,18 - 19,1282,2107,12383,3518,19290
06-01-2019,19 - 20,1290,1978,12057,3388,18713
06-01-2019,20 - 21,1298,1997,11794,3287,18376
06-01-2019,21 - 22,1305,1921,11276,3149,17651
06-01-2019,22 - 23,1232,1904,10828,2983,16947
06-01-2019,23 - 00,1094,1748,10344,2864,16050
07-01-2019,00 - 01,947,1818,9997,2806,15568
07-01-2019,01 - 02,1144,1839,9800,2734,15517
07-01-2019,02 - 03,1188,1783,9807,2693,15471
07-01-2019,03 - 04,1182,1765,9792,2716,15455
07-01-2019,04 - 05,1149,1824,9949,2748,15670
07-01-2019,05 - 06,1311,2024,10490,2904,16729
07-01-2019,06 - 07,1376,2270,11846,3372,18864
07-01-2019,07 - 08,1187,2156,12983,3754,20080
07-01-2019,08 - 09,1266,2315,13350,3841,20772
07-01-2019,09 - 10,1358,2407,13381,3829,20975
07-01-2019,10 - 11,1337,2373,13535,3903,21148
07-01-2019,11 - 12,1378,2282,13462,3931,21053
07-01-2019,12 - 13,1366,2344,13523,3908,21141
07-01-2019,13 - 14,1320,2317,13399,3861,20897
07-01-2019,14 - 15,1282,2444,13423,3822,20971
07-01-2019,15 - 16,1338,2384,13708,3919,21349
07-01-2019,16 - 17,1429,2393,13859,3967,21648
07-01-2019,17 - 18,1328,2440,13871,3958,21597
07-01-2019,18 - 19,1423,2322,13466,3791,21002
07-01-2019,19 - 20,1420,2291,13019,3637,20367
07-01-2019,20 - 21,1366,2199,12656,3431,19652
07-01-2019,21 - 22,1346,2099,12127,3284,18856
07-01-2019,22 - 23,1235,2103,11445,3092,17875
07-01-2019,23 - 00,1148,1998,10896,2878,16920
08-01-2019,00 - 01,1213,1971,10459,2678,16321
08-01-2019,01 - 02,1082,1865,10185,2662,15794
08-01-2019,02 - 03,1059,1812,10019,2657,15547
08-01-2019,03 - 04,1091,1806,10009,2605,15511
08-01-2019,04 - 05,1135,1895,10219,2648,15897
08-01-2019,05 - 06,1158,1936,10694,2817,16605
08-01-2019,06 - 07,1262,2215,11894,3217,18588
08-01-2019,07 - 08,1427,2337,12895,3684,20343
08-01-2019,08 - 09,1426,2216,13189,3770,20601
08-01-2019,09 - 10,1400,2230,13219,3709,20558
08-01-2019,10 - 11,1364,2290,13315,3755,20724
08-01-2019,11 - 12,1405,2185,13321,3732,20643
08-01-2019,12 - 13,1381,2093,13213,3702,20389
08-01-2019,13 - 14,1424,2054,13398,3709,20585
08-01-2019,14 - 15,1429,2186,13577,3770,20962
08-01-2019,15 - 16,1442,2245,13789,3810,21286
08-01-2019,16 - 17,1496,2341,13986,3894,21717
08-01-2019,17 - 18,1451,2267,14105,3939,21762
08-01-2019,18 - 19,1418,2106,13814,3886,21224
08-01-2019,19 - 20,1378,2134,13471,3766,20749
08-01-2019,20 - 21,1374,2128,13110,3633,20245
08-01-2019,21 - 22,1416,1997,12490,3506,19409
08-01-2019,22 - 23,1402,2102,11809,3313,18626
08-01-2019,23 - 00,1268,1900,11128,3143,17439
09-01-2019,00 - 01,1217,1947,10629,3004,16797
09-01-2019,01 - 02,1219,1936,10520,2917,16592
09-01-2019,02 - 03,1219,1947,10424,2913,16503
09-01-2019,03 - 04,1188,1868,10439,2933,16428
09-01-2019,04 - 05,1269,1962,10615,2981,16827
09-01-2019,05 - 06,1297,2049,11112,3190,17648
09-01-2019,06 - 07,1415,2189,12354,3606,19564
09-01-2019,07 - 08,1441,2371,13525,3958,21295
09-01-2019,08 - 09,1440,2441,13865,4100,21846
09-01-2019,09 - 10,1476,2331,13772,4051,21630
09-01-2019,10 - 11,1398,2385,13906,4046,21735
09-01-2019,11 - 12,1377,2387,13887,4095,21746
09-01-2019,12 - 13,1390,2348,13695,4092,21525
09-01-2019,13 - 14,1388,2284,13663,4036,21371
09-01-2019,14 - 15,1412,2433,13787,4074,21706
09-01-2019,15 - 16,1511,2479,14074,4134,22198
09-01-2019,16 - 17,1514,2476,14523,4229,22742
09-01-2019,17 - 18,1509,2474,14616,4312,22911
09-01-2019,18 - 19,1432,2460,14377,4219,22488
09-01-2019,19 - 20,1391,2456,14109,4108,22064
09-01-2019,20 - 21,1367,2444,13645,4004,21460
09-01-2019,21 - 22,1349,2352,13139,3881,20721
09-01-2019,22 - 23,1340,2309,12412,3694,19755
09-01-2019,23 - 00,1266,2241,11785,3467,18759
10-01-2019,00 - 01,1218,2184,11332,3262,17996
10-01-2019,01 - 02,1162,2142,11262,3170,17736
10-01-2019,02 - 03,1093,2170,11336,3129,17728
10-01-2019,03 - 04,1054,2237,11322,3144,17757
10-01-2019,04 - 05,1145,2277,11502,3223,18147
10-01-2019,05 - 06,1237,2203,12038,3400,18878
10-01-2019,06 - 07,1341,2262,13420,3872,20895
10-01-2019,07 - 08,1347,2257,14575,4224,22403
10-01-2019,08 - 09,1337,2366,14632,4288,22623
10-01-2019,09 - 10,1338,2441,14411,4274,22464
10-01-2019,10 - 11,1375,2317,14311,4291,22294
10-01-2019,11 - 12,1395,2403,14230,4241,22269
10-01-2019,12 - 13,1363,2384,14189,4091,22027
10-01-2019,13 - 14,1354,2344,14011,4065,21774
10-01-2019,14 - 15,1385,2435,13939,4093,21852
10-01-2019,15 - 16,1389,2565,14198,4159,22311
10-01-2019,16 - 17,1358,2558,14341,4226,22483
10-01-2019,17 - 18,1308,2457,14279,4247,22291
10-01-2019,18 - 19,1294,2347,14114,4135,21890
10-01-2019,19 - 20,1359,2284,13870,4030,21543
10-01-2019,20 - 21,1307,2224,13312,3881,20724
10-01-2019,21 - 22,1322,2280,12676,3652,19930
10-01-2019,22 - 23,1198,2236,11787,3391,18612
10-01-2019,23 - 00,1179,2205,11045,3209,17638
11-01-2019,00 - 01,1023,2146,10590,3033,16792
11-01-2019,01 - 02,1060,2082,10404,2944,16490
11-01-2019,02 - 03,1097,2170,10288,2911,16466
11-01-2019,03 - 04,1098,2168,10327,2972,16565
11-01-2019,04 - 05,1178,2135,10356,3060,16729
11-01-2019,05 - 06,1224,2177,10822,3268,17491
11-01-2019,06 - 07,1240,2471,11906,3645,19262
11-01-2019,07 - 08,1292,2565,13092,3957,20906
11-01-2019,08 - 09,1306,2576,13536,3961,21379
11-01-2019,09 - 10,1266,2550,13607,3913,21336
11-01-2019,10 - 11,1246,2535,13615,3958,21354
11-01-2019,11 - 12,1228,2517,13474,3928,21147
11-01-2019,12 - 13,1261,2403,13285,3794,20743
11-01-2019,13 - 14,1263,2452,13121,3635,20471
11-01-2019,14 - 15,1279,2425,13102,3570,20376
11-01-2019,15 - 16,1255,2456,13367,3594,20672
11-01-2019,16 - 17,1256,2494,13681,3682,21113
11-01-2019,17 - 18,1199,2491,13851,3814,21355
11-01-2019,18 - 19,1218,2400,13538,3742,20898
11-01-2019,19 - 20,1203,2352,13177,3624,20356
11-01-2019,20 - 21,1230,2250,12598,3469,19547
11-01-2019,21 - 22,1148,2235,12193,3327,18903
11-01-2019,22 - 23,1182,2181,11588,3153,18104
11-01-2019,23 - 00,1134,2117,11119,2954,17324
12-01-2019,00 - 01,1076,2039,10831,2840,16786
12-01-2019,01 - 02,1121,2004,10598,2850,16573
12-01-2019,02 - 03,1123,1932,10418,2903,16376
12-01-2019,03 - 04,1119,1877,10290,2885,16171
12-01-2019,04 - 05,1137,1802,10403,2830,16172
12-01-2019,05 - 06,1147,1974,10559,2895,16575
12-01-2019,06 - 07,1187,1973,10900,2990,17050
12-01-2019,07 - 08,1200,2135,11388,3200,17923
12-01-2019,08 - 09,1231,2245,12051,3345,18872
12-01-2019,09 - 10,1248,2436,12393,3410,19487
12-01-2019,10 - 11,1242,2434,12629,3363,19668
12-01-2019,11 - 12,1230,2375,12741,3336,19682
12-01-2019,12 - 13,1277,2390,12396,3341,19404
12-01-2019,13 - 14,1284,2426,12457,3314,19481
12-01-2019,14 - 15,1319,2388,12538,3279,19524
12-01-2019,15 - 16,1295,2359,12833,3365,19852
12-01-2019,16 - 17,1293,2458,13408,3509,20668
12-01-2019,17 - 18,1282,2514,13498,3562,20856
12-01-2019,18 - 19,1297,2426,13151,3467,20341
12-01-2019,19 - 20,1239,2345,12733,3329,19646
12-01-2019,20 - 21,1234,2260,12312,3187,18993
12-01-2019,21 - 22,1212,2149,12015,3125,18501
12-01-2019,22 - 23,1171,2166,11581,3028,17946
12-01-2019,23 - 00,1075,2095,11193,2936,17299
13-01-2019,00 - 01,1007,1942,10816,2760,16525
13-01-2019,01 - 02,1015,2012,10754,2683,16464
13-01-2019,02 - 03,1033,2004,10585,2619,16241
13-01-2019,03 - 04,1137,2006,10533,2604,16280
13-01-2019,04 - 05,1163,1990,10496,2539,16188
13-01-2019,05 - 06,1127,1953,10592,2606,16278
13-01-2019,06 - 07,1184,1995,10840,2729,16748
13-01-2019,07 - 08,1248,1960,11143,2772,17123
13-01-2019,08 - 09,1349,1960,11452,2778,17539
13-01-2019,09 - 10,1219,2057,11932,2892,18100
13-01-2019,10 - 11,1276,2179,12099,3101,18655
13-01-2019,11 - 12,1316,2197,12174,3134,18821
13-01-2019,12 - 13,1330,2133,12258,2991,18712
13-01-2019,13 - 14,1329,2031,12282,2960,18602
13-01-2019,14 - 15,1232,2074,12296,3026,18628
13-01-2019,15 - 16,1306,2147,12462,3140,19055
13-01-2019,16 - 17,1236,2287,12766,3324,19613
13-01-2019,17 - 18,1365,2172,12841,3379,19757
13-01-2019,18 - 19,1306,2157,12837,3380,19680
13-01-2019,19 - 20,1273,2206,12717,3325,19521
13-01-2019,20 - 21,1212,2093,12364,3217,18886
13-01-2019,21 - 22,1149,2134,11979,3062,18324
13-01-2019,22 - 23,1178,2133,11457,2843,17611
13-01-2019,23 - 00,1101,2015,11151,2718,16985
14-01-2019,00 - 01,1039,2140,11142,2757,17078
14-01-2019,01 - 02,1109,2162,11008,2885,17164
14-01-2019,02 - 03,1130,2148,11087,2914,17279
14-01-2019,03 - 04,1130,2181,11073,2972,17356
14-01-2019,04 - 05,1142,2097,11262,3101,17602
14-01-2019,05 - 06,1230,2315,11898,3336,18779
14-01-2019,06 - 07,1220,2702,13265,3734,20921
14-01-2019,07 - 08,1179,2632,14479,4208,22498
14-01-2019,08 - 09,1303,2490,14878,4262,22933
14-01-2019,09 - 10,1363,2468,14800,4279,22910
14-01-2019,10 - 11,1314,2583,14742,4324,22963
14-01-2019,11 - 12,1330,2566,14543,4274,22713
14-01-2019,12 - 13,1276,2513,14428,4058,22275
14-01-2019,13 - 14,1309,2469,14288,3888,21954
14-01-2019,14 - 15,1279,2520,14081,3843,21723
14-01-2019,15 - 16,1325,2622,14393,3923,22263
14-01-2019,16 - 17,1375,2657,14783,3996,22811
14-01-2019,17 - 18,1402,2638,14939,4126,23105
14-01-2019,18 - 19,1425,2447,14658,4032,22562
14-01-2019,19 - 20,1424,2475,14179,3983,22061
14-01-2019,20 - 21,1374,2429,13750,3829,21382
14-01-2019,21 - 22,1350,2270,13097,3586,20303
14-01-2019,22 - 23,1269,2201,12395,3379,19244
14-01-2019,23 - 00,1234,2138,11870,3218,18460
15-01-2019,00 - 01,1219,2087,11430,3116,17852
15-01-2019,01 - 02,1153,2069,11357,3088,17667
15-01-2019,02 - 03,1172,2169,11320,3071,17732
15-01-2019,03 - 04,1250,2134,11238,3096,17718
15-01-2019,04 - 05,1251,2227,11357,3143,17978
15-01-2019,05 - 06,1312,2220,11917,3315,18764
15-01-2019,06 - 07,1439,2573,13348,3848,21208
15-01-2019,07 - 08,1447,2826,14696,4234,23203
15-01-2019,08 - 09,1459,2950,14956,4303,23668
15-01-2019,09 - 10,1427,2868,14979,4227,23501
15-01-2019,10 - 11,1424,2947,14898,4283,23552
15-01-2019,11 - 12,1399,2998,14750,4254,23401
15-01-2019,12 - 13,1450,2827,14496,4155,22928
15-01-2019,13 - 14,1451,2750,14429,4066,22696
15-01-2019,14 - 15,1459,2722,14297,3921,22399
15-01-2019,15 - 16,1507,2799,14581,3697,22584
15-01-2019,16 - 17,1509,2856,14760,3759,22884
15-01-2019,17 - 18,1499,2814,14845,3873,23031
15-01-2019,18 - 19,1479,2737,14674,3802,22692
15-01-2019,19 - 20,1435,2717,14255,3736,22143
15-01-2019,20 - 21,1426,2640,13667,3557,21290
15-01-2019,21 - 22,1414,2589,13077,3371,20451
15-01-2019,22 - 23,1397,2475,12450,3204,19526
15-01-2019,23 - 00,1366,2414,11919,3036,18735
16-01-2019,00 - 01,1163,2284,11559,2943,17949
16-01-2019,01 - 02,1317,2296,11413,2903,17929
16-01-2019,02 - 03,1320,2347,11313,2804,17784
16-01-2019,03 - 04,1243,2435,11408,2832,17918
16-01-2019,04 - 05,1379,2491,11719,2896,18485
16-01-2019,05 - 06,1431,2594,12395,3128,19548
16-01-2019,06 - 07,1559,2708,13679,3494,21440
16-01-2019,07 - 08,1578,2904,14949,3887,23318
16-01-2019,08 - 09,1497,2957,15107,3935,23496
16-01-2019,09 - 10,1532,2876,14974,3777,23159
16-01-2019,10 - 11,1508,2802,14834,3706,22850
16-01-2019,11 - 12,1510,2753,14569,3713,22545
16-01-2019,12 - 13,1637,2662,14394,3601,22294
16-01-2019,13 - 14,1675,2625,14196,3586,22082
16-01-2019,14 - 15,1644,2597,14082,3592,21915
16-01-2019,15 - 16,1694,2541,14100,3666,22001
16-01-2019,16 - 17,1663,2670,14235,3750,22318
16-01-2019,17 - 18,1627,2788,14108,3794,22317
16-01-2019,18 - 19,1656,2757,13942,3661,22016
16-01-2019,19 - 20,1561,2773,13526,3563,21423
16-01-2019,20 - 21,1597,2723,13040,3393,20753
16-01-2019,21 - 22,1600,2591,12501,3215,19907
16-01-2019,22 - 23,1492,2503,11887,2981,18863
16-01-2019,23 - 00,1401,2404,11309,2819,17933
17-01-2019,00 - 01,1474,2335,10719,2733,17261
17-01-2019,01 - 02,1463,2283,10604,2669,17019
17-01-2019,02 - 03,1458,2308,10805,2685,17256
17-01-2019,03 - 04,1467,2320,11134,2758,17679
17-01-2019,04 - 05,1468,2380,11414,2798,18060
17-01-2019,05 - 06,1501,2383,11985,2922,18791
17-01-2019,06 - 07,1605,2611,13460,3362,21038
17-01-2019,07 - 08,1659,2864,14717,3790,23030
17-01-2019,08 - 09,1739,2929,14927,3939,23534
17-01-2019,09 - 10,1695,2922,14860,3940,23417
17-01-2019,10 - 11,1665,2864,14994,3995,23518
17-01-2019,11 - 12,1712,2682,14884,4010,23288
17-01-2019,12 - 13,1643,2726,14794,3962,23125
17-01-2019,13 - 14,1598,2730,14615,3950,22893
17-01-2019,14 - 15,1635,2704,14658,3938,22935
17-01-2019,15 - 16,1689,2817,14970,4032,23508
17-01-2019,16 - 17,1708,3027,15421,4121,24277
17-01-2019,17 - 18,1660,2834,15531,4108,24133
17-01-2019,18 - 19,1572,2861,15373,4015,23821
17-01-2019,19 - 20,1576,2831,15087,3936,23430
17-01-2019,20 - 21,1497,2660,14596,3776,22529
17-01-2019,21 - 22,1451,2495,13949,3638,21533
17-01-2019,22 - 23,1483,2463,13207,3463,20616
17-01-2019,23 - 00,1490,2427,12649,3298,19864
18-01-2019,00 - 01,1468,2310,12373,3278,19429
18-01-2019,01 - 02,1460,2186,12088,3191,18925
18-01-2019,02 - 03,1437,2190,12034,3100,18761
18-01-2019,03 - 04,1425,2290,12109,3123,18947
18-01-2019,04 - 05,1460,2334,12289,3134,19217
18-01-2019,05 - 06,1577,2399,12833,3278,20087
18-01-2019,06 - 07,1698,2739,14223,3748,22408
18-01-2019,07 - 08,1767,2962,15491,4165,24385
18-01-2019,08 - 09,1727,2956,15573,4261,24517
18-01-2019,09 - 10,1709,2803,15350,4261,24123
18-01-2019,10 - 11,1636,2825,15200,4247,23908
18-01-2019,11 - 12,1622,2624,15106,4179,23531
18-01-2019,12 - 13,1644,2610,14863,4022,23139
18-01-2019,13 - 14,1666,2534,14523,3921,22644
18-01-2019,14 - 15,1580,2515,14390,3868,22353
18-01-2019,15 - 16,1583,2577,14499,3861,22520
18-01-2019,16 - 17,1601,2786,14979,3948,23314
18-01-2019,17 - 18,1658,2619,15244,4050,23571
18-01-2019,18 - 19,1666,2598,15091,3970,23325
18-01-2019,19 - 20,1662,2580,14815,3824,22881
18-01-2019,20 - 21,1632,2427,14236,3643,21938
18-01-2019,21 - 22,1452,2467,13620,3480,21019
18-01-2019,22 - 23,1529,2330,13211,3322,20392
18-01-2019,23 - 00,1509,2322,12771,3174,19776
19-01-2019,00 - 01,1507,2177,12358,3066,19108
19-01-2019,01 - 02,1504,2244,12029,3012,18789
19-01-2019,02 - 03,1451,2282,11839,3048,18620
19-01-2019,03 - 04,1459,2278,11714,2987,18438
19-01-2019,04 - 05,1475,2255,11644,3019,18393
19-01-2019,05 - 06,1468,2228,11817,3025,18538
19-01-2019,06 - 07,1541,2272,12239,3021,19073
19-01-2019,07 - 08,1620,2347,12861,3179,20007
19-01-2019,08 - 09,1614,2546,13270,3366,20796
19-01-2019,09 - 10,1707,2541,13499,3534,21281
19-01-2019,10 - 11,1683,2560,13595,3627,21465
19-01-2019,11 - 12,1686,2443,13382,3530,21041
19-01-2019,12 - 13,1683,2422,13149,3408,20662
19-01-2019,13 - 14,1684,2411,12985,3351,20431
19-01-2019,14 - 15,1683,2182,12845,3278,19988
19-01-2019,15 - 16,1682,2300,13032,3366,20380
19-01-2019,16 - 17,1714,2458,13478,3665,21315
19-01-2019,17 - 18,1747,2525,13630,3737,21639
19-01-2019,18 - 19,1547,2456,13448,3689,21140
19-01-2019,19 - 20,1577,2316,13119,3526,20538
19-01-2019,20 - 21,1618,2213,12579,3397,19807
19-01-2019,21 - 22,1597,2193,12104,3253,19147
19-01-2019,22 - 23,1434,2105,11692,3079,18310
19-01-2019,23 - 00,1414,1978,11459,2956,17807
20-01-2019,00 - 01,1470,2063,11312,2906,17751
20-01-2019,01 - 02,1494,2146,11074,2825,17539
20-01-2019,02 - 03,1454,2182,11038,2793,17467
20-01-2019,03 - 04,1409,2169,11085,2810,17473
20-01-2019,04 - 05,1457,2210,11121,2852,17640
20-01-2019,05 - 06,1470,2202,11221,2895,17788
20-01-2019,06 - 07,1469,2363,11619,3000,18451
20-01-2019,07 - 08,1506,2434,12117,3138,19195
20-01-2019,08 - 09,1468,2486,12577,3234,19765
20-01-2019,09 - 10,1494,2534,13175,3349,20552
20-01-2019,10 - 11,1585,2633,13417,3415,21050
20-01-2019,11 - 12,1573,2641,13437,3471,21122
20-01-2019,12 - 13,1608,2629,13378,3478,21093
20-01-2019,13 - 14,1601,2634,13169,3443,20847
20-01-2019,14 - 15,1526,2613,13218,3408,20765
20-01-2019,15 - 16,1400,2631,13471,3478,20980
20-01-2019,16 - 17,1558,2703,14176,3665,22102
20-01-2019,17 - 18,1760,2780,14604,3789,22933
20-01-2019,18 - 19,1743,2721,14545,3756,22765
20-01-2019,19 - 20,1721,2755,14421,3658,22555
20-01-2019,20 - 21,1626,2645,14139,3540,21950
20-01-2019,21 - 22,1580,2530,13519,3343,20972
20-01-2019,22 - 23,1505,2489,12887,3172,20053
20-01-2019,23 - 00,1475,2467,12432,2994,19368
21-01-2019,00 - 01,1447,2448,12081,2970,18946
21-01-2019,01 - 02,1484,2359,11997,2898,18738
21-01-2019,02 - 03,1452,2383,11997,2884,18716
21-01-2019,03 - 04,1454,2417,11988,2977,18836
21-01-2019,04 - 05,1564,2479,12268,3066,19377
21-01-2019,05 - 06,1637,2355,12843,3269,20104
21-01-2019,06 - 07,1572,2749,14285,3778,22384
21-01-2019,07 - 08,1739,2945,15506,4176,24366
21-01-2019,08 - 09,1714,3015,15722,4195,24646
21-01-2019,09 - 10,1690,3020,15574,4146,24430
21-01-2019,10 - 11,1701,3004,15577,4212,24494
21-01-2019,11 - 12,1735,2962,15491,4226,24414
21-01-2019,12 - 13,1769,2969,15345,4202,24285
21-01-2019,13 - 14,1623,2776,15117,4236,23752
21-01-2019,14 - 15,1647,2853,15001,4234,23735
21-01-2019,15 - 16,1743,2916,15130,4203,23992
21-01-2019,16 - 17,1712,2944,15409,4204,24269
21-01-2019,17 - 18,1742,2970,15569,4281,24562
21-01-2019,18 - 19,1763,2981,15234,4160,24138
21-01-2019,19 - 20,1683,2863,14918,4046,23510
21-01-2019,20 - 21,1616,2805,14368,3879,22668
21-01-2019,21 - 22,1581,2658,13603,3690,21532
21-01-2019,22 - 23,1550,2682,12875,3463,20570
21-01-2019,23 - 00,1476,2520,12135,3213,19344
22-01-2019,00 - 01,1534,2401,11606,3013,18554
22-01-2019,01 - 02,1452,2415,11436,2944,18247
22-01-2019,02 - 03,1419,2375,11334,2907,18035
22-01-2019,03 - 04,1458,2387,11296,2898,18039
22-01-2019,04 - 05,1430,2445,11423,2957,18255
22-01-2019,05 - 06,1487,2690,11965,3185,19327
22-01-2019,06 - 07,1605,2873,13383,3619,21480
22-01-2019,07 - 08,1691,3008,14414,3992,23105
22-01-2019,08 - 09,1732,2913,14494,4024,23163
22-01-2019,09 - 10,1678,2929,14361,3983,22951
22-01-2019,10 - 11,1562,2889,14376,4014,22841
22-01-2019,11 - 12,1543,2763,14373,3996,22675
22-01-2019,12 - 13,1643,2735,14258,3962,22598
22-01-2019,13 - 14,1682,2756,14152,3960,22550
22-01-2019,14 - 15,1723,2779,14151,3963,22616
22-01-2019,15 - 16,1725,2792,14225,3974,22716
22-01-2019,16 - 17,1689,2890,14541,4026,23146
22-01-2019,17 - 18,1610,2925,14819,4119,23473
22-01-2019,18 - 19,1677,2896,14585,4029,23187
22-01-2019,19 - 20,1576,2854,14240,3917,22587
22-01-2019,20 - 21,1630,2808,13842,3745,22025
22-01-2019,21 - 22,1636,2697,13088,3592,21013
22-01-2019,22 - 23,1548,2619,12340,3412,19919
22-01-2019,23 - 00,1520,2475,11671,3157,18823
23-01-2019,00 - 01,1474,2436,11275,3051,18236
23-01-2019,01 - 02,1491,2405,11019,3001,17916
23-01-2019,02 - 03,1473,2364,11001,2966,17804
23-01-2019,03 - 04,1486,2347,11016,2952,17801
23-01-2019,04 - 05,1561,2340,11200,2969,18070
23-01-2019,05 - 06,1579,2386,11794,3185,18944
23-01-2019,06 - 07,1730,2590,13086,3655,21061
23-01-2019,07 - 08,1715,2746,14302,4068,22831
23-01-2019,08 - 09,1720,2723,14292,4155,22890
23-01-2019,09 - 10,1633,2813,14282,4186,22914
23-01-2019,10 - 11,1597,2832,14353,4174,22956
23-01-2019,11 - 12,1637,2852,14259,4108,22856
23-01-2019,12 - 13,1624,2796,14144,4023,22587
23-01-2019,13 - 14,1592,2817,14004,3969,22382
23-01-2019,14 - 15,1614,2836,13923,3953,22326
23-01-2019,15 - 16,1656,2867,14150,3991,22664
23-01-2019,16 - 17,1632,3028,15730,4106,24496
23-01-2019,17 - 18,1729,2948,16176,4230,25083
23-01-2019,18 - 19,1794,2911,15068,4082,23855
23-01-2019,19 - 20,1648,2685,14858,4009,23200
23-01-2019,20 - 21,1624,2787,14406,3873,22690
23-01-2019,21 - 22,1625,2847,13940,3714,22126
23-01-2019,22 - 23,1554,2539,13354,3475,20922
23-01-2019,23 - 00,1393,2592,12692,3269,19946
24-01-2019,00 - 01,1531,2523,12131,3075,19260
24-01-2019,01 - 02,1490,2402,11896,3058,18846
24-01-2019,02 - 03,1460,2381,11812,3064,18717
24-01-2019,03 - 04,1485,2335,11943,3072,18835
24-01-2019,04 - 05,1512,2327,12322,3136,19297
24-01-2019,05 - 06,1592,2218,12775,3381,19966
24-01-2019,06 - 07,1616,2513,14327,3812,22268
24-01-2019,07 - 08,1749,2583,15698,4259,24289
24-01-2019,08 - 09,1703,2568,15701,4261,24233
24-01-2019,09 - 10,1635,2572,15582,4285,24074
24-01-2019,10 - 11,1623,2611,15510,4301,24045
24-01-2019,11 - 12,1675,2537,15292,4283,23787
24-01-2019,12 - 13,1644,2439,15052,4184,23319
24-01-2019,13 - 14,1622,2495,14817,4133,23067
24-01-2019,14 - 15,1593,2537,14691,4151,22972
24-01-2019,15 - 16,1598,2473,14883,4167,23121
24-01-2019,16 - 17,1552,2471,15467,4237,23727
24-01-2019,17 - 18,1600,2585,15696,4290,24171
24-01-2019,18 - 19,1569,2610,15339,4130,23648
24-01-2019,19 - 20,1552,2556,14944,4084,23136
24-01-2019,20 - 21,1519,2444,14417,3931,22311
24-01-2019,21 - 22,1476,2361,13837,3732,21406
24-01-2019,22 - 23,1430,2207,13019,3507,20163
24-01-2019,23 - 00,1423,2284,12411,3293,19411
25-01-2019,00 - 01,1396,2274,12092,3210,18972
25-01-2019,01 - 02,1380,2199,11844,3194,18617
25-01-2019,02 - 03,1334,2231,11673,3166,18404
25-01-2019,03 - 04,1332,2204,11625,3203,18364
25-01-2019,04 - 05,1350,2213,11869,3288,18720
25-01-2019,05 - 06,1302,2354,12409,3494,19559
25-01-2019,06 - 07,1561,2506,13717,3909,21693
25-01-2019,07 - 08,1565,2533,14694,4225,23017
25-01-2019,08 - 09,1521,2611,14967,4370,23469
25-01-2019,09 - 10,1535,2618,14861,4406,23420
25-01-2019,10 - 11,1555,2694,14767,4449,23465
25-01-2019,11 - 12,1586,2636,14748,4443,23413
25-01-2019,12 - 13,1554,2708,14553,4387,23202
25-01-2019,13 - 14,1546,2605,14231,4361,22743
25-01-2019,14 - 15,1573,2671,14153,4285,22682
25-01-2019,15 - 16,1568,2742,14143,4243,22696
25-01-2019,16 - 17,1620,2780,14603,4297,23300
25-01-2019,17 - 18,1586,2861,14835,4365,23647
25-01-2019,18 - 19,1460,2836,14611,4275,23182
25-01-2019,19 - 20,1457,2759,14182,4114,22512
25-01-2019,20 - 21,1494,2682,13530,3920,21626
25-01-2019,21 - 22,1517,2544,12984,3742,20787
25-01-2019,22 - 23,1591,2481,12465,3571,20108
25-01-2019,23 - 00,1366,2374,11952,3386,19078
26-01-2019,00 - 01,1349,2289,11510,3210,18358
26-01-2019,01 - 02,1397,2247,11261,3151,18056
26-01-2019,02 - 03,1308,2191,11181,3081,17761
26-01-2019,03 - 04,1317,2292,11151,3084,17844
26-01-2019,04 - 05,1329,2385,11220,3106,18040
26-01-2019,05 - 06,1348,2435,11368,3178,18329
26-01-2019,06 - 07,1296,2484,11686,3310,18776
26-01-2019,07 - 08,1448,2549,12237,3411,19645
26-01-2019,08 - 09,1477,2558,12654,3557,20246
26-01-2019,09 - 10,1572,2671,13245,3726,21214
26-01-2019,10 - 11,1633,2684,13508,3873,21698
26-01-2019,11 - 12,1544,2670,13603,3911,21728
26-01-2019,12 - 13,1532,2693,13565,3884,21674
26-01-2019,13 - 14,1553,2717,13356,3804,21430
26-01-2019,14 - 15,1513,2683,13214,3738,21148
26-01-2019,15 - 16,1520,2705,13375,3702,21302
26-01-2019,16 - 17,1544,2855,13859,3821,22079
26-01-2019,17 - 18,1576,2903,14123,3931,22533
26-01-2019,18 - 19,1539,2743,14022,3877,22181
26-01-2019,19 - 20,1471,2709,13615,3749,21544
26-01-2019,20 - 21,1464,2745,13131,3606,20946
26-01-2019,21 - 22,1452,2591,12683,3411,20137
26-01-2019,22 - 23,1484,2588,12210,3275,19557
26-01-2019,23 - 00,1443,2399,11871,3105,18818
27-01-2019,00 - 01,1359,2355,11799,3111,18624
27-01-2019,01 - 02,1348,2270,11729,3068,18415
27-01-2019,02 - 03,1341,2350,11592,3058,18341
27-01-2019,03 - 04,1319,2372,11606,2991,18288
27-01-2019,04 - 05,1330,2409,11676,2985,18400
27-01-2019,05 - 06,1352,2372,11834,3063,18621
27-01-2019,06 - 07,1382,2398,12173,3221,19174
27-01-2019,07 - 08,1405,2442,12602,3374,19823
27-01-2019,08 - 09,1437,2522,12871,3438,20268
27-01-2019,09 - 10,1451,2614,13406,3541,21012
27-01-2019,10 - 11,1497,2638,13742,3622,21499
27-01-2019,11 - 12,1503,2539,13843,3687,21572
27-01-2019,12 - 13,1501,2566,13826,3688,21581
27-01-2019,13 - 14,1498,2516,13727,3666,21407
27-01-2019,14 - 15,1503,2531,13671,3638,21343
27-01-2019,15 - 16,1542,2575,13776,3637,21530
27-01-2019,16 - 17,1550,2738,14222,3773,22283
27-01-2019,17 - 18,1540,2661,14444,3897,22542
27-01-2019,18 - 19,1535,2732,14383,3850,22500
27-01-2019,19 - 20,1519,2741,14054,3747,22061
27-01-2019,20 - 21,1457,2612,13577,3615,21261
27-01-2019,21 - 22,1410,2580,13145,3476,20611
27-01-2019,22 - 23,1460,2517,12590,3325,19892
27-01-2019,23 - 00,1376,2417,11951,3101,18845
28-01-2019,00 - 01,1373,2281,11759,3039,18452
28-01-2019,01 - 02,1396,2250,11615,3006,18267
28-01-2019,02 - 03,1390,2263,11559,2984,18196
28-01-2019,03 - 04,1393,2307,11600,2989,18289
28-01-2019,04 - 05,1388,2396,11797,3085,18666
28-01-2019,05 - 06,1536,2518,12307,3235,19596
28-01-2019,06 - 07,1586,2645,13514,3639,21384
28-01-2019,07 - 08,1640,2888,14750,4082,23360
28-01-2019,08 - 09,1554,2911,14904,4106,23475
28-01-2019,09 - 10,1518,2818,14693,4079,23108
28-01-2019,10 - 11,1524,2736,14651,4091,23002
28-01-2019,11 - 12,1512,2852,14662,4010,23036
28-01-2019,12 - 13,1508,2818,14598,3918,22842
28-01-2019,13 - 14,1463,2761,14534,3902,22660
28-01-2019,14 - 15,1513,2820,14500,3920,22753
28-01-2019,15 - 16,1680,2837,14582,3951,23050
28-01-2019,16 - 17,1684,2888,14824,3998,23394
28-01-2019,17 - 18,1624,2788,15049,4121,23582
28-01-2019,18 - 19,1557,2789,14855,4059,23260
28-01-2019,19 - 20,1414,2730,14450,3941,22535
28-01-2019,20 - 21,1551,2621,13930,3779,21881
28-01-2019,21 - 22,1494,2623,13253,3583,20953
28-01-2019,22 - 23,1379,2536,12531,3353,19799
28-01-2019,23 - 00,1363,2346,11968,3104,18781
29-01-2019,00 - 01,1371,2375,11585,3044,18375
29-01-2019,01 - 02,1390,2340,11387,2990,18107
29-01-2019,02 - 03,1383,2363,11326,2970,18042
29-01-2019,03 - 04,1333,2399,11345,2947,18024
29-01-2019,04 - 05,1365,2371,11505,3026,18267
29-01-2019,05 - 06,1456,2451,12104,3195,19206
29-01-2019,06 - 07,1636,2687,13346,3691,21360
29-01-2019,07 - 08,1623,2781,14582,4068,23054
29-01-2019,08 - 09,1523,2812,14737,4095,23167
29-01-2019,09 - 10,1500,2793,14850,4092,23235
29-01-2019,10 - 11,1486,2824,14757,4125,23192
29-01-2019,11 - 12,1520,2781,14628,4121,23050
29-01-2019,12 - 13,1578,2704,14499,4024,22805
29-01-2019,13 - 14,1550,2648,14344,3988,22530
29-01-2019,14 - 15,1520,2696,14325,3962,22503
29-01-2019,15 - 16,1545,2750,14426,4003,22724
29-01-2019,16 - 17,1597,2824,14893,4066,23380
29-01-2019,17 - 18,1624,2820,15364,4229,24037
29-01-2019,18 - 19,1576,2801,15324,4138,23839
29-01-2019,19 - 20,1501,2844,15064,4116,23525
29-01-2019,20 - 21,1455,2744,14794,3982,22975
29-01-2019,21 - 22,1420,2660,14215,3752,22047
29-01-2019,22 - 23,1274,2543,13412,3552,20781
29-01-2019,23 - 00,1291,2439,12776,3357,19863
30-01-2019,00 - 01,1311,2579,12436,3257,19583
30-01-2019,01 - 02,1340,2532,12348,3185,19405
30-01-2019,02 - 03,1395,2516,12348,3174,19433
30-01-2019,03 - 04,1408,2489,12402,3182,19481
30-01-2019,04 - 05,1364,2567,12676,3233,19840
30-01-2019,05 - 06,1405,2648,13266,3409,20728
30-01-2019,06 - 07,1569,2958,14659,3870,23056
30-01-2019,07 - 08,1755,3166,15785,4264,24970
30-01-2019,08 - 09,1586,3238,15982,4297,25103
30-01-2019,09 - 10,1563,3178,15891,4230,24862
30-01-2019,10 - 11,1495,3295,15925,4273,24988
30-01-2019,11 - 12,1512,3059,15833,4211,24615
30-01-2019,12 - 13,1505,2839,15650,4097,24091
30-01-2019,13 - 14,1501,2629,15588,4093,23811
30-01-2019,14 - 15,1497,2817,15534,4079,23927
30-01-2019,15 - 16,1520,2770,15533,4064,23887
30-01-2019,16 - 17,1552,2770,15865,4099,24286
30-01-2019,17 - 18,1581,2811,16312,4269,24973
30-01-2019,18 - 19,1554,2888,16085,4242,24769
30-01-2019,19 - 20,1516,2884,15678,4120,24198
30-01-2019,20 - 21,1520,2831,15152,3913,23416
30-01-2019,21 - 22,1519,2738,14452,3729,22438
30-01-2019,22 - 23,1452,2753,13730,3488,21423
30-01-2019,23 - 00,1448,2463,13125,3295,20331
31-01-2019,00 - 01,1430,2309,12660,3117,19516
31-01-2019,01 - 02,1441,2392,12402,3010,19245
31-01-2019,02 - 03,1364,2397,12297,3010,19068
31-01-2019,03 - 04,1388,2463,12379,3040,19270
31-01-2019,04 - 05,1388,2500,12500,3103,19491
31-01-2019,05 - 06,1523,2679,13077,3284,20563
31-01-2019,06 - 07,1754,2957,14311,3718,22740
31-01-2019,07 - 08,1711,3055,15367,4095,24228
31-01-2019,08 - 09,1607,3017,15479,4212,24315
31-01-2019,09 - 10,1618,2978,15527,4174,24297
31-01-2019,10 - 11,1620,2959,15531,4224,24334
31-01-2019,11 - 12,1609,2949,15356,4212,24126
31-01-2019,12 - 13,1650,2920,15170,4231,23971
31-01-2019,13 - 14,1603,2821,14866,4226,23516
31-01-2019,14 - 15,1601,2731,14744,4245,23321
31-01-2019,15 - 16,1578,2827,14968,4260,23633
31-01-2019,16 - 17,1600,2900,15211,4223,23934
31-01-2019,17 - 18,1680,3020,15515,4316,24531
31-01-2019,18 - 19,1657,2789,15324,4211,23981
31-01-2019,19 - 20,1613,2673,14876,4064,23226
31-01-2019,20 - 21,1604,2751,14293,3876,22524
31-01-2019,21 - 22,1570,2689,13609,3619,21487
31-01-2019,22 - 23,1537,2545,12794,3413,20289
31-01-2019,23 - 00,1513,2397,12171,3192,19273
01-02-2019,00 - 01,1400,2388,11680,3051,18519
01-02-2019,01 - 02,1414,2452,11422,2984,18272
01-02-2019,02 - 03,1381,2478,11288,2983,18130
01-02-2019,03 - 04,1391,2511,11341,2977,18220
01-02-2019,04 - 05,1450,2521,11515,3040,18526
01-02-2019,05 - 06,1501,2640,12058,3214,19413
01-02-2019,06 - 07,1578,2838,13274,3628,21318
01-02-2019,07 - 08,1600,2955,14439,4001,22995
01-02-2019,08 - 09,1639,2978,14639,4069,23325
01-02-2019,09 - 10,1611,2933,14674,4128,23346
01-02-2019,10 - 11,1650,2950,14747,4149,23496
01-02-2019,11 - 12,1651,2852,14659,4084,23246
01-02-2019,12 - 13,1671,2753,14626,4024,23074
01-02-2019,13 - 14,1650,2797,14416,3949,22812
01-02-2019,14 - 15,1648,2816,14215,3874,22553
01-02-2019,15 - 16,1669,2885,14085,3856,22495
01-02-2019,16 - 17,1690,3010,14353,3858,22911
01-02-2019,17 - 18,1759,3137,14711,4020,23627
01-02-2019,18 - 19,1690,3047,14305,3962,23004
01-02-2019,19 - 20,1564,2915,13645,3782,21906
01-02-2019,20 - 21,1564,2767,12969,3523,20823
01-02-2019,21 - 22,1520,2665,12460,3328,19973
01-02-2019,22 - 23,1538,2516,11812,3208,19074
01-02-2019,23 - 00,1397,2469,11412,3077,18355
02-02-2019,00 - 01,1471,2630,11092,2944,18137
02-02-2019,01 - 02,1486,2701,10864,2852,17903
02-02-2019,02 - 03,1507,2669,10649,2868,17693
02-02-2019,03 - 04,1531,2687,10577,2896,17691
02-02-2019,04 - 05,1542,2705,10615,2912,17774
02-02-2019,05 - 06,1549,2689,10701,2969,17908
02-02-2019,06 - 07,1552,2717,11051,3074,18394
02-02-2019,07 - 08,1543,2740,11480,3257,19020
02-02-2019,08 - 09,1626,2835,11885,3379,19725
02-02-2019,09 - 10,1713,2871,12460,3557,20601
02-02-2019,10 - 11,1594,2840,12855,3618,20907
02-02-2019,11 - 12,1581,2846,12983,3720,21130
02-02-2019,12 - 13,1562,2842,13046,3787,21237
02-02-2019,13 - 14,1531,2717,12908,3703,20859
02-02-2019,14 - 15,1550,2662,12943,3571,20726
02-02-2019,15 - 16,1600,2686,12990,3494,20770
02-02-2019,16 - 17,1639,2778,13383,3613,21413
02-02-2019,17 - 18,1691,2864,13822,3801,22178
02-02-2019,18 - 19,1634,2852,13750,3739,21975
02-02-2019,19 - 20,1668,2773,13401,3605,21447
02-02-2019,20 - 21,1541,2745,12901,3331,20518
02-02-2019,21 - 22,1504,2688,12366,3183,19741
02-02-2019,22 - 23,1600,2566,12049,3055,19270
02-02-2019,23 - 00,1387,2503,11690,2873,18453
03-02-2019,00 - 01,1410,2401,11406,2847,18064
03-02-2019,01 - 02,1456,2522,11227,2827,18032
03-02-2019,02 - 03,1480,2454,11125,2812,17871
03-02-2019,03 - 04,1481,2451,11125,2824,17881
03-02-2019,04 - 05,1460,2454,11145,2855,17914
03-02-2019,05 - 06,1461,2447,11241,2840,17989
03-02-2019,06 - 07,1477,2511,11653,2897,18538
03-02-2019,07 - 08,1520,2588,12011,3002,19121
03-02-2019,08 - 09,1592,2609,12398,3125,19724
03-02-2019,09 - 10,1581,2706,13005,3282,20574
03-02-2019,10 - 11,1556,2800,13425,3407,21188
03-02-2019,11 - 12,1582,2821,13629,3559,21591
03-02-2019,12 - 13,1594,2836,13688,3588,21706
03-02-2019,13 - 14,1618,2782,13511,3520,21431
03-02-2019,14 - 15,1590,2769,13560,3466,21385
03-02-2019,15 - 16,1553,2814,13546,3472,21385
03-02-2019,16 - 17,1577,2972,14012,3604,22165
03-02-2019,17 - 18,1689,2975,14789,3872,23325
03-02-2019,18 - 19,1746,2851,14931,3891,23419
03-02-2019,19 - 20,1565,2738,14714,3818,22835
03-02-2019,20 - 21,1575,2731,14349,3587,22242
03-02-2019,21 - 22,1556,2594,13773,3452,21375
03-02-2019,22 - 23,1453,2504,13241,3349,20547
03-02-2019,23 - 00,1438,2540,12870,3253,20101
04-02-2019,00 - 01,1448,2508,12551,3152,19659
04-02-2019,01 - 02,1402,2523,12361,3038,19324
04-02-2019,02 - 03,1418,2485,12314,3018,19235
04-02-2019,03 - 04,1426,2420,12248,3054,19148
04-02-2019,04 - 05,1406,2400,12508,3129,19443
04-02-2019,05 - 06,1420,2463,13112,3329,20324
04-02-2019,06 - 07,1564,2704,14405,3789,22462
04-02-2019,07 - 08,1508,2870,15406,4177,23961
04-02-2019,08 - 09,1589,2825,15595,4224,24233
04-02-2019,09 - 10,1536,2922,15578,4191,24227
04-02-2019,10 - 11,1512,2971,15351,4124,23958
04-02-2019,11 - 12,1523,2903,15162,4042,23630
04-02-2019,12 - 13,1602,2803,14951,3962,23318
04-02-2019,13 - 14,1612,2751,14735,4013,23111
04-02-2019,14 - 15,1617,2675,14733,4021,23046
04-02-2019,15 - 16,1642,2713,14762,4014,23131
04-02-2019,16 - 17,1664,2826,14925,3941,23356
04-02-2019,17 - 18,1735,2891,15278,4033,23937
04-02-2019,18 - 19,1677,2734,15000,3986,23397
04-02-2019,19 - 20,1605,2690,14568,3868,22731
04-02-2019,20 - 21,1613,2695,14078,3760,22146
04-02-2019,21 - 22,1588,2680,13346,3616,21230
04-02-2019,22 - 23,1491,2516,12550,3358,19915
04-02-2019,23 - 00,1454,2493,11892,3190,19029
05-02-2019,00 - 01,1467,2466,11390,3095,18418
05-02-2019,01 - 02,1418,2484,11218,3054,18174
05-02-2019,02 - 03,1456,2413,11197,3043,18109
05-02-2019,03 - 04,1477,2364,11127,3031,17999
05-02-2019,04 - 05,1456,2510,11160,3107,18233
05-02-2019,05 - 06,1464,2501,11605,3267,18837
05-02-2019,06 - 07,1579,2703,12796,3685,20763
05-02-2019,07 - 08,1670,2959,13902,4143,22674
05-02-2019,08 - 09,1666,2912,14021,4082,22681
05-02-2019,09 - 10,1664,2920,14011,4002,22597
05-02-2019,10 - 11,1636,2889,14151,4020,22696
05-02-2019,11 - 12,1600,2832,14228,4000,22660
05-02-2019,12 - 13,1575,2755,14058,3902,22290
05-02-2019,13 - 14,1546,2743,13935,3898,22122
05-02-2019,14 - 15,1464,2658,13861,3881,21864
05-02-2019,15 - 16,1647,2511,13997,3884,22039
05-02-2019,16 - 17,1549,2585,14229,3867,22230
05-02-2019,17 - 18,1605,2675,14710,4062,23052
05-02-2019,18 - 19,1597,2507,14510,4045,22659
05-02-2019,19 - 20,1541,2481,14143,3887,22052
05-02-2019,20 - 21,1508,2421,13724,3730,21383
05-02-2019,21 - 22,1473,2360,13183,3550,20566
05-02-2019,22 - 23,1476,2242,12487,3324,19529
05-02-2019,23 - 00,1457,2194,11886,3145,18682
06-02-2019,00 - 01,1412,2330,11701,2977,18420
06-02-2019,01 - 02,1394,2271,11727,2904,18296
06-02-2019,02 - 03,1464,2340,11852,2918,18574
06-02-2019,03 - 04,1435,2288,12000,2929,18652
06-02-2019,04 - 05,1458,2291,12241,2969,18959
06-02-2019,05 - 06,1510,2430,12903,3181,20024
06-02-2019,06 - 07,1682,2593,14126,3650,22051
06-02-2019,07 - 08,1811,2827,15319,4060,24017
06-02-2019,08 - 09,1789,2945,15411,4069,24214
06-02-2019,09 - 10,1760,2929,15364,4052,24105
06-02-2019,10 - 11,1631,2941,15161,4098,23831
06-02-2019,11 - 12,1603,2897,15060,4058,23618
06-02-2019,12 - 13,1615,2721,14985,4051,23372
06-02-2019,13 - 14,1587,2793,14759,4069,23208
06-02-2019,14 - 15,1603,2824,14721,4100,23248
06-02-2019,15 - 16,1607,2874,14921,4142,23544
06-02-2019,16 - 17,1588,2770,15150,4158,23666
06-02-2019,17 - 18,1570,2747,15519,4232,24068
06-02-2019,18 - 19,1713,2635,15170,4133,23651
06-02-2019,19 - 20,1660,2527,14833,4020,23040
06-02-2019,20 - 21,1588,2391,14262,3904,22145
06-02-2019,21 - 22,1520,2237,13369,3683,20809
06-02-2019,22 - 23,1366,2282,12473,3406,19527
06-02-2019,23 - 00,1337,2190,11700,3201,18428
07-02-2019,00 - 01,1347,2092,11096,3003,17538
07-02-2019,01 - 02,1383,2088,10866,2883,17220
07-02-2019,02 - 03,1392,2140,10682,2824,17038
07-02-2019,03 - 04,1403,2060,10723,2845,17031
07-02-2019,04 - 05,1438,2082,10919,2880,17319
07-02-2019,05 - 06,1536,2114,11350,3038,18038
07-02-2019,06 - 07,1611,2135,12600,3442,19788
07-02-2019,07 - 08,1562,2339,13649,3845,21395
07-02-2019,08 - 09,1573,2343,13746,3889,21551
07-02-2019,09 - 10,1594,2312,13813,3870,21589
07-02-2019,10 - 11,1542,2321,13865,3896,21624
07-02-2019,11 - 12,1557,2538,13858,3870,21823
07-02-2019,12 - 13,1590,2631,13805,3820,21846
07-02-2019,13 - 14,1559,2582,13669,3791,21601
07-02-2019,14 - 15,1589,2532,13497,3764,21382
07-02-2019,15 - 16,1576,2534,13516,3774,21400
07-02-2019,16 - 17,1590,2624,13767,3829,21810
07-02-2019,17 - 18,1596,2612,14146,3967,22321
07-02-2019,18 - 19,1548,2579,14004,3978,22109
07-02-2019,19 - 20,1518,2345,13501,3872,21236
07-02-2019,20 - 21,1497,2246,12943,3633,20319
07-02-2019,21 - 22,1481,2219,12158,3462,19320
07-02-2019,22 - 23,1473,2144,11486,3292,18395
07-02-2019,23 - 00,1453,2201,10979,3035,17668
08-02-2019,00 - 01,1446,2107,10699,2982,17234
08-02-2019,01 - 02,1412,2174,10575,2891,17052
08-02-2019,02 - 03,1414,2189,10541,2844,16988
08-02-2019,03 - 04,1425,2202,10497,2845,16969
08-02-2019,04 - 05,1459,2341,10751,2875,17426
08-02-2019,05 - 06,1525,2482,11256,3021,18284
08-02-2019,06 - 07,1668,2688,12370,3403,20129
08-02-2019,07 - 08,1669,2740,13384,3801,21594
08-02-2019,08 - 09,1615,2700,13412,3888,21615
08-02-2019,09 - 10,1639,2698,13338,3881,21556
08-02-2019,10 - 11,1592,2618,13204,3857,21271
08-02-2019,11 - 12,1553,2573,13092,3813,21031
08-02-2019,12 - 13,1526,2509,12917,3745,20697
08-02-2019,13 - 14,1550,2501,12671,3681,20403
08-02-2019,14 - 15,1590,2442,12549,3669,20250
08-02-2019,15 - 16,1610,2492,12541,3624,20267
08-02-2019,16 - 17,1545,2546,12805,3630,20526
08-02-2019,17 - 18,1502,2583,13351,3720,21156
08-02-2019,18 - 19,1443,2516,13288,3616,20863
08-02-2019,19 - 20,1532,2369,12611,3399,19911
08-02-2019,20 - 21,1444,2292,11892,3219,18847
08-02-2019,21 - 22,1453,2230,11461,3057,18201
08-02-2019,22 - 23,1476,2152,11006,2889,17523
08-02-2019,23 - 00,1346,2063,10492,2794,16695
09-02-2019,00 - 01,1364,2031,10126,2730,16251
09-02-2019,01 - 02,1369,2060,9919,2680,16028
09-02-2019,02 - 03,1394,2077,9749,2629,15849
09-02-2019,03 - 04,1339,2079,9763,2643,15824
09-02-2019,04 - 05,1365,2109,9869,2655,15998
09-02-2019,05 - 06,1362,2062,9999,2723,16146
09-02-2019,06 - 07,1399,2185,10272,2823,16679
09-02-2019,07 - 08,1379,2309,10635,2957,17280
09-02-2019,08 - 09,1474,2377,11016,3066,17933
09-02-2019,09 - 10,1511,2431,11466,3162,18570
09-02-2019,10 - 11,1470,2466,11729,3240,18905
09-02-2019,11 - 12,1431,2427,11801,3302,18961
09-02-2019,12 - 13,1474,2347,11793,3314,18928
09-02-2019,13 - 14,1464,2318,11781,3259,18822
09-02-2019,14 - 15,1463,2310,11627,3206,18606
09-02-2019,15 - 16,1454,2286,11580,3240,18560
09-02-2019,16 - 17,1504,2369,11794,3275,18942
09-02-2019,17 - 18,1489,2436,12206,3483,19614
09-02-2019,18 - 19,1480,2445,12082,3379,19386
09-02-2019,19 - 20,1460,2316,11771,3262,18809
09-02-2019,20 - 21,1458,2258,11440,3123,18279
09-02-2019,21 - 22,1405,2151,11046,3045,17647
09-02-2019,22 - 23,1336,2120,10602,2926,16984
09-02-2019,23 - 00,1312,2181,10298,2794,16585
10-02-2019,00 - 01,1309,2206,9997,2732,16244
10-02-2019,01 - 02,1190,2187,9803,2677,15857
10-02-2019,02 - 03,1279,2117,9677,2633,15706
10-02-2019,03 - 04,1336,2038,9641,2620,15635
10-02-2019,04 - 05,1329,2085,9648,2624,15686
10-02-2019,05 - 06,1350,2096,9774,2734,15954
10-02-2019,06 - 07,1367,2143,10066,2807,16383
10-02-2019,07 - 08,1365,2136,10346,2901,16748
10-02-2019,08 - 09,1426,2195,10554,2945,17120
10-02-2019,09 - 10,1456,2244,11053,3043,17796
10-02-2019,10 - 11,1472,2212,11172,3029,17885
10-02-2019,11 - 12,1459,2110,11229,3120,17918
10-02-2019,12 - 13,1422,2106,11317,3220,18065
10-02-2019,13 - 14,1399,2057,11213,3270,17939
10-02-2019,14 - 15,1413,2135,11199,3251,17998
10-02-2019,15 - 16,1402,2151,11229,3202,17984
10-02-2019,16 - 17,1437,2240,11665,3256,18598
10-02-2019,17 - 18,1434,2256,12221,3396,19307
10-02-2019,18 - 19,1397,2266,12300,3357,19320
10-02-2019,19 - 20,1339,2245,11995,3277,18856
10-02-2019,20 - 21,1318,2189,11574,3137,18218
10-02-2019,21 - 22,1302,2117,11150,2964,17533
10-02-2019,22 - 23,1330,2024,10781,2859,16994
10-02-2019,23 - 00,1260,1965,10426,2777,16428
11-02-2019,00 - 01,1242,1987,10067,2699,15995
11-02-2019,01 - 02,1250,1875,9963,2665,15753
11-02-2019,02 - 03,1225,1824,9875,2653,15577
11-02-2019,03 - 04,1195,2002,10053,2728,15978
11-02-2019,04 - 05,1230,1904,10216,2796,16146
11-02-2019,05 - 06,1176,2037,10788,2962,16963
11-02-2019,06 - 07,1303,2249,12115,3331,18998
11-02-2019,07 - 08,1458,2324,13197,3728,20707
11-02-2019,08 - 09,1465,2355,13297,3825,20942
11-02-2019,09 - 10,1515,2361,13326,3865,21067
11-02-2019,10 - 11,1466,2382,13440,3926,21214
11-02-2019,11 - 12,1419,2401,13450,3964,21234
11-02-2019,12 - 13,1405,2402,13296,3936,21039
11-02-2019,13 - 14,1403,2387,13148,3865,20803
11-02-2019,14 - 15,1476,2383,13091,3777,20727
11-02-2019,15 - 16,1459,2403,13068,3785,20715
11-02-2019,16 - 17,1506,2366,13262,3814,20948
11-02-2019,17 - 18,1476,2420,13973,4014,21883
11-02-2019,18 - 19,1416,2225,13885,4004,21530
11-02-2019,19 - 20,1289,2184,13613,3940,21026
11-02-2019,20 - 21,1244,2191,13069,3833,20337
11-02-2019,21 - 22,1375,2131,12565,3604,19675
11-02-2019,22 - 23,1270,2072,11944,3356,18642
11-02-2019,23 - 00,1364,2112,11320,3094,17890
12-02-2019,00 - 01,1327,1953,11003,2982,17265
12-02-2019,01 - 02,1286,1888,10794,2969,16937
12-02-2019,02 - 03,1239,1915,10777,2944,16875
12-02-2019,03 - 04,1246,1924,10903,2993,17066
12-02-2019,04 - 05,1244,1962,11121,3054,17381
12-02-2019,05 - 06,1280,2161,11773,3253,18467
12-02-2019,06 - 07,1320,2327,13132,3655,20434
12-02-2019,07 - 08,1437,2495,14240,4078,22250
12-02-2019,08 - 09,1294,2391,14300,4222,22207
12-02-2019,09 - 10,1387,2514,14091,4149,22141
12-02-2019,10 - 11,1552,2610,13763,4098,22023
12-02-2019,11 - 12,1465,2561,13555,3964,21545
12-02-2019,12 - 13,1494,2436,13254,3729,20913
12-02-2019,13 - 14,1414,2410,12850,3612,20286
12-02-2019,14 - 15,1415,2378,12854,3645,20292
12-02-2019,15 - 16,1471,2439,12985,3757,20652
12-02-2019,16 - 17,1492,2647,13218,3824,21181
12-02-2019,17 - 18,1421,2614,13784,4001,21820
12-02-2019,18 - 19,1454,2397,13601,3975,21427
12-02-2019,19 - 20,1413,2445,13292,3858,21008
12-02-2019,20 - 21,1469,2417,12796,3587,20269
12-02-2019,21 - 22,1328,2370,12122,3367,19187
12-02-2019,22 - 23,1295,2187,11479,3102,18063
12-02-2019,23 - 00,1420,1978,10967,2835,17200
13-02-2019,00 - 01,1387,2045,10853,2852,17137
13-02-2019,01 - 02,1380,1952,10511,2751,16594
13-02-2019,02 - 03,1429,1913,10265,2698,16305
13-02-2019,03 - 04,1335,1787,10128,2703,15953
13-02-2019,04 - 05,1276,1780,10201,2740,15997
13-02-2019,05 - 06,1272,1802,10729,2871,16674
13-02-2019,06 - 07,1337,2065,11834,3326,18562
13-02-2019,07 - 08,1435,2256,12673,3665,20029
13-02-2019,08 - 09,1407,2210,12813,3671,20101
13-02-2019,09 - 10,1390,2205,12763,3569,19927
13-02-2019,10 - 11,1373,2120,12638,3481,19612
13-02-2019,11 - 12,1449,2231,12303,3387,19370
13-02-2019,12 - 13,1382,2203,12008,3311,18904
13-02-2019,13 - 14,1441,2176,11903,3295,18815
13-02-2019,14 - 15,1381,2281,11788,3377,18827
13-02-2019,15 - 16,1469,2343,11908,3461,19181
13-02-2019,16 - 17,1442,2241,12095,3448,19226
13-02-2019,17 - 18,1411,2243,13076,3714,20444
13-02-2019,18 - 19,1493,2113,12929,3694,20229
13-02-2019,19 - 20,1407,2230,12613,3565,19815
13-02-2019,20 - 21,1364,2318,12307,3405,19394
13-02-2019,21 - 22,1293,2234,11728,3144,18399
13-02-2019,22 - 23,1169,2307,11060,3004,17540
13-02-2019,23 - 00,1312,2320,10385,2824,16841
14-02-2019,00 - 01,1274,1839,9925,2689,15727
14-02-2019,01 - 02,1349,1772,9760,2623,15504
14-02-2019,02 - 03,1302,1754,9887,2575,15518
14-02-2019,03 - 04,1237,1637,9950,2602,15426
14-02-2019,04 - 05,1106,1706,10029,2665,15506
14-02-2019,05 - 06,1061,1880,10579,2882,16402
14-02-2019,06 - 07,1206,1986,11850,3270,18312
14-02-2019,07 - 08,1332,2151,12728,3564,19775
14-02-2019,08 - 09,1340,2110,12863,3578,19891
14-02-2019,09 - 10,1337,2210,12972,3556,20075
14-02-2019,10 - 11,1296,2194,12971,3590,20051
14-02-2019,11 - 12,1298,2217,12854,3534,19903
14-02-2019,12 - 13,1308,2148,12506,3486,19448
14-02-2019,13 - 14,1233,2140,12357,3404,19134
14-02-2019,14 - 15,1163,2253,12443,3399,19258
14-02-2019,15 - 16,1286,2205,12333,3466,19290
14-02-2019,16 - 17,1231,2218,12452,3542,19443
14-02-2019,17 - 18,1235,2292,13010,3702,20239
14-02-2019,18 - 19,1253,2321,12870,3640,20084
14-02-2019,19 - 20,1417,2220,12702,3485,19824
14-02-2019,20 - 21,1402,2207,12180,3358,19147
14-02-2019,21 - 22,1243,2153,11627,3231,18254
14-02-2019,22 - 23,1216,2140,10972,3009,17337
14-02-2019,23 - 00,1217,1948,10467,2834,16466
15-02-2019,00 - 01,1161,1930,9949,2692,15732
15-02-2019,01 - 02,1128,1854,9780,2706,15468
15-02-2019,02 - 03,1104,1903,9628,2704,15339
15-02-2019,03 - 04,1113,1890,9620,2618,15241
15-02-2019,04 - 05,1144,1924,9717,2685,15470
15-02-2019,05 - 06,1236,1955,10299,2882,16372
15-02-2019,06 - 07,1259,2119,11491,3336,18205
15-02-2019,07 - 08,1328,2264,12512,3668,19772
15-02-2019,08 - 09,1358,2178,12741,3787,20064
15-02-2019,09 - 10,1347,2173,12648,3744,19912
15-02-2019,10 - 11,1439,2248,12648,3719,20054
15-02-2019,11 - 12,1503,2221,12414,3655,19793
15-02-2019,12 - 13,1548,1985,12175,3536,19244
15-02-2019,13 - 14,1434,1813,11898,3412,18557
15-02-2019,14 - 15,1350,1936,11771,3290,18347
15-02-2019,15 - 16,1322,2161,11925,3275,18683
15-02-2019,16 - 17,1332,2254,12120,3325,19031
15-02-2019,17 - 18,1274,2417,12679,3505,19875
15-02-2019,18 - 19,1266,2197,12579,3589,19631
15-02-2019,19 - 20,1212,2018,12097,3468,18795
15-02-2019,20 - 21,1186,1856,11603,3247,17892
15-02-2019,21 - 22,1076,1760,11073,3022,16931
15-02-2019,22 - 23,1028,1679,10722,2908,16337
15-02-2019,23 - 00,1001,1534,10256,2783,15574
16-02-2019,00 - 01,1029,1507,9885,2710,15131
16-02-2019,01 - 02,1019,1615,9743,2669,15046
16-02-2019,02 - 03,1033,1598,9565,2680,14876
16-02-2019,03 - 04,1041,1626,9483,2696,14846
16-02-2019,04 - 05,1098,1672,9572,2748,15090
16-02-2019,05 - 06,1085,1694,9707,2812,15298
16-02-2019,06 - 07,1077,1711,10052,2925,15765
16-02-2019,07 - 08,1134,1859,10408,3037,16438
16-02-2019,08 - 09,1092,1965,10722,3150,16929
16-02-2019,09 - 10,1239,1950,11074,3215,17478
16-02-2019,10 - 11,1297,1956,11086,3161,17500
16-02-2019,11 - 12,1346,2059,10930,3093,17428
16-02-2019,12 - 13,1319,2029,10645,2919,16912
16-02-2019,13 - 14,1339,1933,10528,2851,16651
16-02-2019,14 - 15,1339,1903,10515,2788,16545
16-02-2019,15 - 16,1357,1877,10610,2767,16611
16-02-2019,16 - 17,1503,1976,11029,2853,17361
16-02-2019,17 - 18,1436,2153,11663,3111,18363
16-02-2019,18 - 19,1326,2191,11731,3256,18504
16-02-2019,19 - 20,1276,2131,11429,3189,18025
16-02-2019,20 - 21,1319,2079,11109,2987,17494
16-02-2019,21 - 22,1218,1908,10704,2898,16728
16-02-2019,22 - 23,1206,1896,10290,2792,16184
16-02-2019,23 - 00,1249,1821,9940,2715,15725
17-02-2019,00 - 01,1257,1846,9644,2493,15240
17-02-2019,01 - 02,1266,1836,9485,2441,15028
17-02-2019,02 - 03,1262,1851,9439,2432,14984
17-02-2019,03 - 04,1235,1837,9487,2471,15030
17-02-2019,04 - 05,1242,1839,9495,2528,15104
17-02-2019,05 - 06,1226,1875,9586,2594,15281
17-02-2019,06 - 07,1287,2012,9897,2661,15857
17-02-2019,07 - 08,1309,1910,10173,2768,16160
17-02-2019,08 - 09,1330,2009,10543,2851,16733
17-02-2019,09 - 10,1357,2148,10951,3010,17466
17-02-2019,10 - 11,1273,2238,11215,3045,17771
17-02-2019,11 - 12,1228,2229,11296,3041,17794
17-02-2019,12 - 13,1277,2109,11336,2997,17719
17-02-2019,13 - 14,1295,1984,11229,2930,17438
17-02-2019,14 - 15,1223,1932,11216,2883,17254
17-02-2019,15 - 16,1228,1950,11271,2905,17354
17-02-2019,16 - 17,1299,1987,11578,2942,17806
17-02-2019,17 - 18,1275,1996,12315,3161,18747
17-02-2019,18 - 19,1228,1907,12487,3259,18881
17-02-2019,19 - 20,1175,1942,12117,3209,18443
17-02-2019,20 - 21,1066,1918,11673,3088,17745
17-02-2019,21 - 22,1111,1821,11163,2944,17039
17-02-2019,22 - 23,1073,1829,10703,2843,16448
17-02-2019,23 - 00,1001,1850,10200,2695,15746
18-02-2019,00 - 01,1026,1816,9922,2627,15391
18-02-2019,01 - 02,1011,1726,9747,2595,15079
18-02-2019,02 - 03,1078,1827,9632,2567,15104
18-02-2019,03 - 04,1102,1817,9627,2619,15165
18-02-2019,04 - 05,1133,1854,9785,2683,15455
18-02-2019,05 - 06,1162,1944,10259,2869,16234
18-02-2019,06 - 07,1156,2123,11630,3335,18244
18-02-2019,07 - 08,1195,2237,12544,3623,19599
18-02-2019,08 - 09,1338,2121,12701,3695,19855
18-02-2019,09 - 10,1344,2198,12836,3702,20080
18-02-2019,10 - 11,1335,2236,12944,3681,20196
18-02-2019,11 - 12,1424,2293,12943,3549,20209
18-02-2019,12 - 13,1298,2200,12657,3438,19593
18-02-2019,13 - 14,1330,2273,12318,3402,19323
18-02-2019,14 - 15,1359,2363,12295,3370,19387
18-02-2019,15 - 16,1301,2241,12253,3368,19163
18-02-2019,16 - 17,1352,2293,12356,3449,19450
18-02-2019,17 - 18,1314,2165,13068,3581,20128
18-02-2019,18 - 19,1298,1999,13057,3632,19986
18-02-2019,19 - 20,1253,2004,12763,3603,19623
18-02-2019,20 - 21,1221,2019,12248,3456,18944
18-02-2019,21 - 22,1263,1904,11516,3199,17882
18-02-2019,22 - 23,1142,1849,10768,2985,16744
18-02-2019,23 - 00,1214,1669,10058,2806,15747
19-02-2019,00 - 01,1006,1663,9662,2657,14988
19-02-2019,01 - 02,1034,1779,9445,2637,14895
19-02-2019,02 - 03,1208,1794,9375,2640,15017
19-02-2019,03 - 04,1240,1816,9406,2696,15158
19-02-2019,04 - 05,1253,1884,9547,2781,15465
19-02-2019,05 - 06,1334,1984,10077,2936,16331
19-02-2019,06 - 07,1432,2145,11178,3287,18042
19-02-2019,07 - 08,1378,2197,12134,3518,19227
19-02-2019,08 - 09,1394,2206,12199,3662,19461
19-02-2019,09 - 10,1369,2304,12176,3637,19486
19-02-2019,10 - 11,1364,2019,12207,3657,19247
19-02-2019,11 - 12,1287,1954,12328,3567,19136
19-02-2019,12 - 13,1290,2019,12361,3546,19216
19-02-2019,13 - 14,1333,2102,12224,3551,19210
19-02-2019,14 - 15,1471,2160,12101,3549,19281
19-02-2019,15 - 16,1383,2180,12165,3604,19332
19-02-2019,16 - 17,1327,2111,12235,3575,19248
19-02-2019,17 - 18,1295,2263,12928,3675,20161
19-02-2019,18 - 19,1276,2039,12769,3682,19766
19-02-2019,19 - 20,1272,1949,12412,3569,19202
19-02-2019,20 - 21,1321,1969,12020,3415,18725
19-02-2019,21 - 22,1165,1835,11483,3198,17681
19-02-2019,22 - 23,1224,1832,10901,2986,16943
19-02-2019,23 - 00,1196,1779,10273,2803,16051
20-02-2019,00 - 01,1303,1794,9988,2693,15778
20-02-2019,01 - 02,1239,1887,9873,2710,15709
20-02-2019,02 - 03,1259,1976,9855,2668,15758
20-02-2019,03 - 04,1276,2012,9908,2690,15886
20-02-2019,04 - 05,1262,2050,10224,2699,16235
20-02-2019,05 - 06,1287,2211,10903,2826,17227
20-02-2019,06 - 07,1427,2413,12338,3232,19410
20-02-2019,07 - 08,1451,2418,13253,3592,20714
20-02-2019,08 - 09,1477,2384,13417,3770,21048
20-02-2019,09 - 10,1491,2218,13281,3793,20783
20-02-2019,10 - 11,1519,2091,13094,3731,20435
20-02-2019,11 - 12,1493,2149,12865,3641,20148
20-02-2019,12 - 13,1464,2382,12669,3502,20017
20-02-2019,13 - 14,1489,2360,12447,3423,19719
20-02-2019,14 - 15,1486,2411,12297,3371,19565
20-02-2019,15 - 16,1404,2652,12487,3419,19962
20-02-2019,16 - 17,1360,2731,12894,3461,20446
20-02-2019,17 - 18,1384,2666,13661,3625,21336
20-02-2019,18 - 19,1403,2542,13697,3638,21280
20-02-2019,19 - 20,1514,2526,13382,3506,20928
20-02-2019,20 - 21,1533,2468,13061,3382,20444
20-02-2019,21 - 22,1555,2386,12442,3182,19565
20-02-2019,22 - 23,1422,2250,11769,3012,18453
20-02-2019,23 - 00,1513,2083,11139,2797,17532
21-02-2019,00 - 01,1375,2045,10769,2663,16852
21-02-2019,01 - 02,1403,1963,10450,2565,16381
21-02-2019,02 - 03,1461,1957,10330,2554,16302
21-02-2019,03 - 04,1431,1983,10279,2562,16255
21-02-2019,04 - 05,1508,2045,10386,2573,16512
21-02-2019,05 - 06,1617,2181,11186,2743,17727
21-02-2019,06 - 07,1620,2353,12489,3236,19698
21-02-2019,07 - 08,1649,2412,13517,3568,21146
21-02-2019,08 - 09,1606,2497,13741,3599,21443
21-02-2019,09 - 10,1601,2414,13672,3622,21309
21-02-2019,10 - 11,1396,2387,13669,3686,21138
21-02-2019,11 - 12,1451,2525,13637,3687,21300
21-02-2019,12 - 13,1443,2396,13610,3598,21047
21-02-2019,13 - 14,1382,2404,13587,3601,20974
21-02-2019,14 - 15,1365,2391,13606,3639,21001
21-02-2019,15 - 16,1423,2337,13732,3674,21166
21-02-2019,16 - 17,1365,2401,13834,3651,21251
21-02-2019,17 - 18,1577,2412,14335,3778,22102
21-02-2019,18 - 19,1528,2356,14174,3704,21762
21-02-2019,19 - 20,1444,2333,13953,3601,21331
21-02-2019,20 - 21,1444,2314,13506,3392,20656
21-02-2019,21 - 22,1479,2269,13037,3233,20018
21-02-2019,22 - 23,1500,2197,12496,3177,19370
21-02-2019,23 - 00,1420,1928,11850,2938,18136
22-02-2019,00 - 01,1300,1888,11453,2950,17591
22-02-2019,01 - 02,1326,1902,11393,2918,17539
22-02-2019,02 - 03,1365,1901,11364,2945,17575
22-02-2019,03 - 04,1356,1933,11405,2992,17686
22-02-2019,04 - 05,1410,1983,11758,3057,18208
22-02-2019,05 - 06,1476,2151,12416,3254,19297
22-02-2019,06 - 07,1642,2380,13901,3639,21562
22-02-2019,07 - 08,1809,2335,14814,3899,22857
22-02-2019,08 - 09,1734,2473,14997,4045,23249
22-02-2019,09 - 10,1595,2639,14602,4028,22864
22-02-2019,10 - 11,1530,2544,14128,3946,22148
22-02-2019,11 - 12,1468,2612,13759,3838,21677
22-02-2019,12 - 13,1468,2680,13414,3705,21267
22-02-2019,13 - 14,1530,2701,13153,3626,21010
22-02-2019,14 - 15,1603,2581,13020,3536,20740
22-02-2019,15 - 16,1625,2419,12988,3511,20543
22-02-2019,16 - 17,1581,2367,13175,3552,20675
22-02-2019,17 - 18,1551,2383,13759,3811,21504
22-02-2019,18 - 19,1426,2343,13726,3896,21391
22-02-2019,19 - 20,1359,2187,13210,3721,20477
22-02-2019,20 - 21,1348,2099,12571,3555,19573
22-02-2019,21 - 22,1233,1999,12024,3345,18601
22-02-2019,22 - 23,1048,2021,11524,3197,17790
22-02-2019,23 - 00,1147,1892,10931,3055,17025
23-02-2019,00 - 01,1198,1817,10463,2939,16417
23-02-2019,01 - 02,1116,1841,10239,2874,16070
23-02-2019,02 - 03,1214,1839,10095,2871,16019
23-02-2019,03 - 04,1199,1826,9988,2856,15869
23-02-2019,04 - 05,1115,1771,10029,2875,15790
23-02-2019,05 - 06,1189,1744,10111,2870,15914
23-02-2019,06 - 07,1119,1857,10589,2979,16544
23-02-2019,07 - 08,1248,1901,10863,3088,17100
23-02-2019,08 - 09,1288,2129,11282,3218,17917
23-02-2019,09 - 10,1343,2140,11706,3287,18476
23-02-2019,10 - 11,1328,2162,11842,3228,18560
23-02-2019,11 - 12,1318,1974,11745,3160,18197
23-02-2019,12 - 13,1239,1784,11493,3047,17563
23-02-2019,13 - 14,1248,1880,11247,2902,17277
23-02-2019,14 - 15,1307,2145,11215,2840,17507
23-02-2019,15 - 16,1200,2204,11217,2874,17495
23-02-2019,16 - 17,1414,2117,11428,2954,17913
23-02-2019,17 - 18,1266,2018,11998,3214,18496
23-02-2019,18 - 19,1253,1985,12108,3307,18653
23-02-2019,19 - 20,1172,1944,11853,3195,18164
23-02-2019,20 - 21,1066,1864,11366,3100,17396
23-02-2019,21 - 22,1030,1850,10862,2976,16718
23-02-2019,22 - 23,1139,1936,10523,2864,16462
23-02-2019,23 - 00,1120,1916,9966,2790,15792
24-02-2019,00 - 01,1095,1840,9691,2703,15329
24-02-2019,01 - 02,1000,1863,9509,2642,15014
24-02-2019,02 - 03,999,1655,9404,2596,14654
24-02-2019,03 - 04,1015,1697,9345,2590,14647
24-02-2019,04 - 05,1147,1803,9329,2674,14953
24-02-2019,05 - 06,1104,1853,9387,2710,15054
24-02-2019,06 - 07,1065,1949,9652,2733,15399
24-02-2019,07 - 08,1029,1903,9875,2705,15512
24-02-2019,08 - 09,1028,1966,10317,2878,16189
24-02-2019,09 - 10,1171,1937,10640,2974,16722
24-02-2019,10 - 11,1164,1927,10725,2942,16758
24-02-2019,11 - 12,1165,1965,10743,2854,16727
24-02-2019,12 - 13,1144,1930,10528,2720,16322
24-02-2019,13 - 14,1169,1944,10500,2649,16262
24-02-2019,14 - 15,1115,2025,10561,2663,16364
24-02-2019,15 - 16,1162,2031,10417,2670,16280
24-02-2019,16 - 17,1231,2270,10756,2804,17061
24-02-2019,17 - 18,1321,2534,11443,3101,18399
24-02-2019,18 - 19,1284,2520,11771,3318,18893
24-02-2019,19 - 20,1283,2548,11625,3271,18727
24-02-2019,20 - 21,1332,2710,11196,3176,18414
24-02-2019,21 - 22,1292,2602,10732,3050,17676
24-02-2019,22 - 23,1269,2628,10251,2875,17023
24-02-2019,23 - 00,1266,2271,9796,2663,15996
25-02-2019,00 - 01,1257,2366,9531,2562,15716
25-02-2019,01 - 02,1259,2237,9490,2469,15455
25-02-2019,02 - 03,1294,2251,9390,2476,15411
25-02-2019,03 - 04,1225,2319,9363,2537,15444
25-02-2019,04 - 05,1212,2257,9483,2610,15562
25-02-2019,05 - 06,1250,2221,10201,2776,16448
25-02-2019,06 - 07,1320,2448,11629,3315,18712
25-02-2019,07 - 08,1321,2572,12443,3627,19963
25-02-2019,08 - 09,1442,2433,12548,3799,20222
25-02-2019,09 - 10,1407,2284,12493,3773,19957
25-02-2019,10 - 11,1319,2310,12312,3690,19631
25-02-2019,11 - 12,1247,2392,12186,3562,19387
25-02-2019,12 - 13,1213,2350,11952,3416,18931
25-02-2019,13 - 14,1156,2373,11834,3355,18718
25-02-2019,14 - 15,1208,2450,11631,3291,18580
25-02-2019,15 - 16,1288,2217,11723,3291,18519
25-02-2019,16 - 17,1297,2109,11761,3334,18501
25-02-2019,17 - 18,1246,2112,12245,3431,19034
25-02-2019,18 - 19,1233,2122,12295,3475,19125
25-02-2019,19 - 20,1243,2100,11977,3350,18670
25-02-2019,20 - 21,1242,2080,11532,3193,18047
25-02-2019,21 - 22,1252,2042,11136,2946,17376
25-02-2019,22 - 23,1129,2029,10436,2832,16426
25-02-2019,23 - 00,1098,1965,9861,2735,15659
26-02-2019,00 - 01,1054,1945,9792,2713,15504
26-02-2019,01 - 02,1055,1899,9597,2612,15163
26-02-2019,02 - 03,1114,1935,9651,2575,15275
26-02-2019,03 - 04,1006,1858,9623,2596,15083
26-02-2019,04 - 05,992,1959,9508,2641,15100
26-02-2019,05 - 06,1007,2002,9905,2770,15684
26-02-2019,06 - 07,1220,2034,11179,3236,17669
26-02-2019,07 - 08,1283,2058,11998,3480,18819
26-02-2019,08 - 09,1314,1981,12057,3569,18921
26-02-2019,09 - 10,1273,2079,11939,3582,18873
26-02-2019,10 - 11,1297,2145,11928,3590,18960
26-02-2019,11 - 12,1300,2118,11700,3465,18583
26-02-2019,12 - 13,1215,2161,11318,3276,17970
26-02-2019,13 - 14,1206,1971,11109,3168,17454
26-02-2019,14 - 15,1226,2015,11094,3114,17449
26-02-2019,15 - 16,1189,1880,11119,3123,17311
26-02-2019,16 - 17,1153,2026,11202,3176,17557
26-02-2019,17 - 18,1153,2188,11733,3346,18420
26-02-2019,18 - 19,1163,2103,11901,3420,18587
26-02-2019,19 - 20,1092,2173,11590,3266,18121
26-02-2019,20 - 21,1169,1953,11320,3036,17478
26-02-2019,21 - 22,1157,1940,10809,2891,16797
26-02-2019,22 - 23,1074,2006,10040,2737,15857
26-02-2019,23 - 00,1115,1823,9395,2583,14916
27-02-2019,00 - 01,1113,1814,9296,2584,14807
27-02-2019,01 - 02,1094,1805,9096,2525,14520
27-02-2019,02 - 03,1062,1790,9095,2528,14475
27-02-2019,03 - 04,1082,1807,8998,2565,14452
27-02-2019,04 - 05,1079,1978,9310,2623,14990
27-02-2019,05 - 06,1275,2171,10018,2832,16296
27-02-2019,06 - 07,1226,2140,11485,3278,18129
27-02-2019,07 - 08,1193,2160,12277,3534,19164
27-02-2019,08 - 09,1269,2185,12374,3604,19432
27-02-2019,09 - 10,1208,2238,12105,3574,19125
27-02-2019,10 - 11,1215,2283,11953,3548,18999
27-02-2019,11 - 12,1164,2305,11823,3473,18765
27-02-2019,12 - 13,1216,2274,11606,3338,18434
27-02-2019,13 - 14,1292,2379,11367,3285,18323
27-02-2019,14 - 15,1317,2353,11308,3193,18171
27-02-2019,15 - 16,1130,2260,11414,3199,18003
27-02-2019,16 - 17,1158,2251,11542,3227,18178
27-02-2019,17 - 18,1196,2279,11919,3408,18802
27-02-2019,18 - 19,1224,2269,12152,3509,19154
27-02-2019,19 - 20,1211,2255,11883,3362,18711
27-02-2019,20 - 21,1176,2309,11464,3190,18139
27-02-2019,21 - 22,1268,2139,10979,2921,17307
27-02-2019,22 - 23,1179,2029,10279,2729,16216
27-02-2019,23 - 00,1152,1966,9599,2583,15300
28-02-2019,00 - 01,1157,1803,9260,2533,14753
28-02-2019,01 - 02,1098,1850,9031,2550,14529
28-02-2019,02 - 03,1099,1878,8885,2586,14448
28-02-2019,03 - 04,1112,1902,8972,2646,14632
28-02-2019,04 - 05,1033,1827,9211,2680,14751
28-02-2019,05 - 06,1052,1955,9886,2830,15723
28-02-2019,06 - 07,1241,2340,11249,3188,18018
28-02-2019,07 - 08,1322,2434,12307,3509,19572
28-02-2019,08 - 09,1306,2272,12319,3668,19565
28-02-2019,09 - 10,1347,2239,12042,3580,19208
28-02-2019,10 - 11,1380,2358,11857,3459,19054
28-02-2019,11 - 12,1395,2399,11683,3315,18792
28-02-2019,12 - 13,1287,2244,11618,3228,18377
28-02-2019,13 - 14,1171,2264,11486,3106,18027
28-02-2019,14 - 15,1216,2360,11505,3025,18106
28-02-2019,15 - 16,1354,2326,11584,3046,18310
28-02-2019,16 - 17,1378,2431,11899,3106,18814
28-02-2019,17 - 18,1296,2718,12582,3396,19992
28-02-2019,18 - 19,1415,2574,13048,3574,20611
28-02-2019,19 - 20,1379,2442,12898,3541,20260
28-02-2019,20 - 21,1349,2276,12559,3366,19550
28-02-2019,21 - 22,1378,2232,12057,3232,18899
28-02-2019,22 - 23,1300,2125,11482,3059,17966
28-02-2019,23 - 00,1372,2155,10894,2909,17330
01-03-2019,00 - 01,1239,2072,10615,2860,16786
01-03-2019,01 - 02,1250,2077,10416,2849,16592
01-03-2019,02 - 03,1200,2083,10352,2842,16477
01-03-2019,03 - 04,1232,1997,10394,2866,16489
01-03-2019,04 - 05,1231,1941,10572,2924,16668
01-03-2019,05 - 06,1286,2073,11178,3169,17706
01-03-2019,06 - 07,1360,2322,12480,3602,19764
01-03-2019,07 - 08,1478,2419,13368,3832,21097
01-03-2019,08 - 09,1354,2444,13460,3825,21083
01-03-2019,09 - 10,1310,2391,13391,3781,20873
01-03-2019,10 - 11,1351,2378,13201,3729,20659
01-03-2019,11 - 12,1332,2313,12861,3582,20088
01-03-2019,12 - 13,1314,2279,12617,3466,19676
01-03-2019,13 - 14,1289,2200,12306,3374,19169
01-03-2019,14 - 15,1357,2076,12070,3297,18800
01-03-2019,15 - 16,1411,2204,11917,3280,18812
01-03-2019,16 - 17,1357,2331,12070,3292,19050
01-03-2019,17 - 18,1310,2553,12769,3459,20091
01-03-2019,18 - 19,1294,2591,13178,3594,20657
01-03-2019,19 - 20,1339,2475,12935,3470,20219
01-03-2019,20 - 21,1315,2441,12488,3314,19558
01-03-2019,21 - 22,1275,2295,11981,3199,18750
01-03-2019,22 - 23,1243,2156,11466,3034,17899
01-03-2019,23 - 00,1150,1923,10890,2843,16806
02-03-2019,00 - 01,972,2042,10533,2717,16264
02-03-2019,01 - 02,1118,2002,10280,2666,16066
02-03-2019,02 - 03,1117,2051,10220,2638,16026
02-03-2019,03 - 04,1106,1964,10190,2668,15928
02-03-2019,04 - 05,1238,1915,10230,2718,16101
02-03-2019,05 - 06,1257,2076,10328,2835,16496
02-03-2019,06 - 07,1280,2140,10675,2970,17065
02-03-2019,07 - 08,1293,2084,11021,3049,17447
02-03-2019,08 - 09,1333,2101,11522,3238,18194
02-03-2019,09 - 10,1376,2263,11807,3315,18761
02-03-2019,10 - 11,1375,2169,11853,3429,18826
02-03-2019,11 - 12,1268,2032,11622,3382,18304
02-03-2019,12 - 13,1184,2240,11254,3377,18055
02-03-2019,13 - 14,1238,2127,10915,3333,17613
02-03-2019,14 - 15,1229,2006,10730,3233,17198
02-03-2019,15 - 16,1196,2038,10566,3198,16998
02-03-2019,16 - 17,1210,2201,10795,3228,17434
02-03-2019,17 - 18,1161,2340,11298,3299,18098
02-03-2019,18 - 19,1176,2296,11567,3350,18389
02-03-2019,19 - 20,1267,2202,11380,3182,18031
02-03-2019,20 - 21,1295,2014,10973,2954,17236
02-03-2019,21 - 22,1302,1899,10525,2835,16561
02-03-2019,22 - 23,1307,1844,10151,2750,16052
02-03-2019,23 - 00,1313,1951,9832,2576,15672
03-03-2019,00 - 01,1281,1828,9566,2568,15243
03-03-2019,01 - 02,1267,1822,9445,2501,15035
03-03-2019,02 - 03,1294,1838,9283,2485,14900
03-03-2019,03 - 04,1268,1864,9297,2473,14902
03-03-2019,04 - 05,1272,1866,9270,2445,14853
03-03-2019,05 - 06,1299,1897,9416,2421,15033
03-03-2019,06 - 07,1353,1929,9622,2459,15363
03-03-2019,07 - 08,1349,2084,9937,2516,15886
03-03-2019,08 - 09,1332,2128,10466,2635,16561
03-03-2019,09 - 10,1373,2172,10901,2738,17184
03-03-2019,10 - 11,1363,2225,11083,2809,17480
03-03-2019,11 - 12,1269,2281,11221,2857,17628
03-03-2019,12 - 13,1311,2222,11222,2792,17547
03-03-2019,13 - 14,1263,2159,11307,2639,17368
03-03-2019,14 - 15,1302,2107,11149,2617,17175
03-03-2019,15 - 16,1229,2197,11264,2691,17381
03-03-2019,16 - 17,1266,2181,11393,2770,17610
03-03-2019,17 - 18,1303,2203,11913,3032,18451
03-03-2019,18 - 19,1271,2295,12239,3316,19121
03-03-2019,19 - 20,1344,2300,12090,3260,18994
03-03-2019,20 - 21,1317,2242,11780,3137,18476
03-03-2019,21 - 22,1347,2108,11291,2929,17675
03-03-2019,22 - 23,1368,2071,10826,2706,16971
03-03-2019,23 - 00,1267,2017,10266,2679,16229
04-03-2019,00 - 01,1303,2147,10059,2582,16091
04-03-2019,01 - 02,1299,2044,9878,2607,15828
04-03-2019,02 - 03,1352,1966,9881,2560,15759
04-03-2019,03 - 04,1406,2073,9903,2500,15882
04-03-2019,04 - 05,1399,2170,9984,2516,16069
04-03-2019,05 - 06,1498,2317,10471,2774,17060
04-03-2019,06 - 07,1584,2490,11754,3225,19053
04-03-2019,07 - 08,1747,2613,12729,3396,20485
04-03-2019,08 - 09,1578,2633,12755,3579,20545
04-03-2019,09 - 10,1549,2594,12790,3658,20591
04-03-2019,10 - 11,1624,2567,12910,3747,20848
04-03-2019,11 - 12,1438,2509,12931,3712,20590
04-03-2019,12 - 13,1491,2484,12837,3601,20413
04-03-2019,13 - 14,1431,2495,13739,3712,21377
04-03-2019,14 - 15,1330,2542,13970,3761,21603
04-03-2019,15 - 16,1329,2522,12898,3695,20444
04-03-2019,16 - 17,1371,2570,12843,3622,20406
04-03-2019,17 - 18,1390,2676,13177,3661,20904
04-03-2019,18 - 19,1503,2848,13321,3805,21477
04-03-2019,19 - 20,1370,2790,13012,3749,20921
04-03-2019,20 - 21,1290,2612,12488,3611,20001
04-03-2019,21 - 22,1349,2720,11948,3450,19467
04-03-2019,22 - 23,1306,2548,11214,3267,18335
04-03-2019,23 - 00,1249,2480,10688,3092,17509
05-03-2019,00 - 01,1283,2285,10437,2846,16851
05-03-2019,01 - 02,1324,2224,10324,2762,16634
05-03-2019,02 - 03,1376,2278,10396,2722,16772
05-03-2019,03 - 04,1334,2462,10457,2632,16885
05-03-2019,04 - 05,1339,2528,10736,2672,17275
05-03-2019,05 - 06,1352,2609,11248,2857,18066
05-03-2019,06 - 07,1536,2644,12500,3312,19992
05-03-2019,07 - 08,1618,2945,13444,3684,21691
05-03-2019,08 - 09,1682,2983,13793,3837,22295
05-03-2019,09 - 10,1637,2902,13796,3832,22167
05-03-2019,10 - 11,1598,2782,13851,3908,22139
05-03-2019,11 - 12,1569,2658,13691,3926,21844
05-03-2019,12 - 13,1473,2598,13382,3871,21324
05-03-2019,13 - 14,1399,2574,13363,3844,21180
05-03-2019,14 - 15,1448,2599,13432,3803,21282
05-03-2019,15 - 16,1397,2647,13462,3766,21272
05-03-2019,16 - 17,1431,2586,13506,3693,21216
05-03-2019,17 - 18,1371,2652,14087,3783,21893
05-03-2019,18 - 19,1423,2838,14472,3817,22550
05-03-2019,19 - 20,1493,2760,14220,3737,22210
05-03-2019,20 - 21,1488,2828,13839,3648,21803
05-03-2019,21 - 22,1496,2784,13367,3454,21101
05-03-2019,22 - 23,1467,2537,12778,3256,20038
05-03-2019,23 - 00,1278,2394,12145,3010,18827
06-03-2019,00 - 01,1299,2110,11692,2943,18044
06-03-2019,01 - 02,1309,2030,11551,2962,17852
06-03-2019,02 - 03,1316,2074,11519,2960,17869
06-03-2019,03 - 04,1297,2177,11574,2945,17993
06-03-2019,04 - 05,1391,2362,11883,2919,18555
06-03-2019,05 - 06,1358,2452,12507,3065,19382
06-03-2019,06 - 07,1404,2712,13746,3430,21292
06-03-2019,07 - 08,1490,2743,14479,3689,22401
06-03-2019,08 - 09,1370,2864,14706,3808,22748
06-03-2019,09 - 10,1463,3029,14427,3790,22709
06-03-2019,10 - 11,1505,3012,14252,3790,22559
06-03-2019,11 - 12,1437,2852,14047,3754,22090
06-03-2019,12 - 13,1409,2809,13565,3682,21465
06-03-2019,13 - 14,1411,2633,13360,3665,21069
06-03-2019,14 - 15,1373,2649,13529,3646,21197
06-03-2019,15 - 16,1398,2666,13373,3660,21097
06-03-2019,16 - 17,1349,2695,13352,3680,21076
06-03-2019,17 - 18,1280,2682,13589,3717,21268
06-03-2019,18 - 19,1332,2814,13810,3696,21652
06-03-2019,19 - 20,1284,2720,13540,3602,21146
06-03-2019,20 - 21,1301,2598,13124,3483,20506
06-03-2019,21 - 22,1338,2556,12490,3300,19684
06-03-2019,22 - 23,1238,2510,11842,3041,18631
06-03-2019,23 - 00,1332,2433,11187,2815,17767
07-03-2019,00 - 01,1336,2298,10564,2725,16923
07-03-2019,01 - 02,1296,2283,10301,2713,16593
07-03-2019,02 - 03,1299,2291,10213,2666,16469
07-03-2019,03 - 04,1354,2284,10178,2700,16516
07-03-2019,04 - 05,1431,2352,10358,2762,16903
07-03-2019,05 - 06,1552,2379,10794,2945,17670
07-03-2019,06 - 07,1486,2464,11992,3341,19283
07-03-2019,07 - 08,1552,2463,12834,3690,20539
07-03-2019,08 - 09,1474,2474,12998,3763,20709
07-03-2019,09 - 10,1396,2465,13028,3801,20690
07-03-2019,10 - 11,1403,2474,13087,3777,20741
07-03-2019,11 - 12,1398,2551,13070,3775,20794
07-03-2019,12 - 13,1365,2521,12908,3713,20507
07-03-2019,13 - 14,1340,2453,12663,3674,20130
07-03-2019,14 - 15,1380,2407,12600,3660,20047
07-03-2019,15 - 16,1386,2438,12440,3515,19779
07-03-2019,16 - 17,1372,2524,12392,3377,19665
07-03-2019,17 - 18,1373,2433,12678,3471,19955
07-03-2019,18 - 19,1316,2448,12815,3636,20215
07-03-2019,19 - 20,1314,2512,12397,3663,19886
07-03-2019,20 - 21,1288,2427,11999,3577,19291
07-03-2019,21 - 22,1228,2484,11398,3317,18427
07-03-2019,22 - 23,1251,2332,10905,3112,17600
07-03-2019,23 - 00,1269,2282,10311,2881,16743
08-03-2019,00 - 01,1216,2240,10027,2767,16250
08-03-2019,01 - 02,1251,2164,9770,2688,15873
08-03-2019,02 - 03,1250,2160,9592,2580,15582
08-03-2019,03 - 04,1234,2142,9707,2600,15683
08-03-2019,04 - 05,1318,2123,9951,2625,16017
08-03-2019,05 - 06,1377,2218,10435,2748,16778
08-03-2019,06 - 07,1353,2302,11500,3102,18257
08-03-2019,07 - 08,1497,2434,12421,3412,19764
08-03-2019,08 - 09,1530,2406,12669,3538,20143
08-03-2019,09 - 10,1428,2316,12622,3546,19912
08-03-2019,10 - 11,1432,2349,12601,3576,19958
08-03-2019,11 - 12,1430,2341,12483,3611,19865
08-03-2019,12 - 13,1427,2384,12284,3485,19580
08-03-2019,13 - 14,1470,2304,12130,3363,19267
08-03-2019,14 - 15,1415,2317,12082,3232,19046
08-03-2019,15 - 16,1413,2301,12067,3239,19020
08-03-2019,16 - 17,1307,2295,12297,3294,19193
08-03-2019,17 - 18,1446,2462,12765,3471,20144
08-03-2019,18 - 19,1405,2641,13144,3646,20836
08-03-2019,19 - 20,1416,2420,12872,3553,20261
08-03-2019,20 - 21,1347,2267,12259,3467,19340
08-03-2019,21 - 22,1414,2124,11664,3348,18550
08-03-2019,22 - 23,1350,2105,11129,3176,17760
08-03-2019,23 - 00,1382,1916,10777,3054,17129
09-03-2019,00 - 01,1361,1820,10458,2871,16510
09-03-2019,01 - 02,1281,2019,10247,2788,16335
09-03-2019,02 - 03,1263,2040,10225,2750,16278
09-03-2019,03 - 04,1238,1957,10161,2736,16092
09-03-2019,04 - 05,1265,2076,10212,2805,16358
09-03-2019,05 - 06,1274,2158,10458,2862,16752
09-03-2019,06 - 07,1200,2151,10572,2948,16871
09-03-2019,07 - 08,1335,2278,10796,3070,17479
09-03-2019,08 - 09,1417,2284,11253,3314,18268
09-03-2019,09 - 10,1418,2342,11695,3573,19028
09-03-2019,10 - 11,1452,2445,11910,3616,19423
09-03-2019,11 - 12,1452,2299,11855,3482,19088
09-03-2019,12 - 13,1386,2229,11645,3311,18571
09-03-2019,13 - 14,1381,2074,11586,3341,18382
09-03-2019,14 - 15,1360,2068,11552,3241,18221
09-03-2019,15 - 16,1361,2115,11556,3091,18123
09-03-2019,16 - 17,1448,2160,11713,3111,18432
09-03-2019,17 - 18,1264,2354,12007,3219,18844
09-03-2019,18 - 19,1321,2343,12251,3444,19359
09-03-2019,19 - 20,1403,2138,11979,3385,18905
09-03-2019,20 - 21,1263,2109,11564,3202,18138
09-03-2019,21 - 22,1285,2078,11195,2993,17551
09-03-2019,22 - 23,1299,2133,10848,2857,17137
09-03-2019,23 - 00,1330,1984,10611,2735,16660
10-03-2019,00 - 01,1223,2045,10385,2761,16414
10-03-2019,01 - 02,1192,2051,10213,2702,16158
10-03-2019,02 - 03,1222,2080,10096,2702,16100
10-03-2019,03 - 04,1242,2078,10095,2730,16145
10-03-2019,04 - 05,1212,2118,10139,2669,16138
10-03-2019,05 - 06,1214,2152,10458,2684,16508
10-03-2019,06 - 07,1216,2116,10798,2841,16971
10-03-2019,07 - 08,1270,2135,11007,2886,17298
10-03-2019,08 - 09,1282,2220,11342,3075,17919
10-03-2019,09 - 10,1305,2468,11578,3089,18440
10-03-2019,10 - 11,1257,2396,11657,3101,18411
10-03-2019,11 - 12,1255,2444,11683,3141,18523
10-03-2019,12 - 13,1319,2417,11555,3098,18389
10-03-2019,13 - 14,1327,2279,11486,3067,18159
10-03-2019,14 - 15,1291,2382,11457,3024,18154
10-03-2019,15 - 16,1345,2340,11398,3064,18147
10-03-2019,16 - 17,1360,2357,11672,3133,18522
10-03-2019,17 - 18,1408,2276,12356,3294,19334
10-03-2019,18 - 19,1426,2213,12993,3482,20114
10-03-2019,19 - 20,1485,2178,12957,3422,20042
10-03-2019,20 - 21,1365,2095,12473,3287,19220
10-03-2019,21 - 22,1317,2057,11853,3125,18352
10-03-2019,22 - 23,1423,2103,11315,2995,17836
10-03-2019,23 - 00,1398,2123,10918,2912,17351
11-03-2019,00 - 01,1324,2091,10796,2864,17075
11-03-2019,01 - 02,1233,2015,10780,2866,16894
11-03-2019,02 - 03,1233,2075,10901,2852,17061
11-03-2019,03 - 04,1247,2080,11029,2909,17265
11-03-2019,04 - 05,1285,2158,11437,3054,17934
11-03-2019,05 - 06,1434,2211,12051,3241,18937
11-03-2019,06 - 07,1419,2365,13168,3647,20599
11-03-2019,07 - 08,1491,2433,14050,3984,21958
11-03-2019,08 - 09,1438,2533,14138,4035,22144
11-03-2019,09 - 10,1492,2616,13967,3853,21928
11-03-2019,10 - 11,1536,2617,13844,3790,21787
11-03-2019,11 - 12,1469,2544,13493,3703,21209
11-03-2019,12 - 13,1441,2411,13104,3560,20516
11-03-2019,13 - 14,1447,2357,12828,3464,20096
11-03-2019,14 - 15,1349,2374,12608,3388,19719
11-03-2019,15 - 16,1361,2337,12594,3348,19640
11-03-2019,16 - 17,1342,2214,12809,3190,19555
11-03-2019,17 - 18,1347,2451,13516,3454,20768
11-03-2019,18 - 19,1392,2530,13978,3795,21695
11-03-2019,19 - 20,1400,2477,13762,3822,21461
11-03-2019,20 - 21,1397,2323,13345,3752,20817
11-03-2019,21 - 22,1356,2476,12828,3532,20192
11-03-2019,22 - 23,1398,2495,12247,3319,19459
11-03-2019,23 - 00,1302,2318,11648,3112,18380
12-03-2019,00 - 01,1226,2353,11271,2963,17813
12-03-2019,01 - 02,1296,2185,11237,2990,17708
12-03-2019,02 - 03,1333,2195,11186,2988,17702
12-03-2019,03 - 04,1356,2306,11280,2907,17849
12-03-2019,04 - 05,1408,2384,11600,2965,18357
12-03-2019,05 - 06,1426,2422,12362,3142,19352
12-03-2019,06 - 07,1516,2600,13578,3562,21256
12-03-2019,07 - 08,1589,2719,14319,3845,22472
12-03-2019,08 - 09,1524,2620,14366,3939,22449
12-03-2019,09 - 10,1470,2585,14096,3814,21965
12-03-2019,10 - 11,1484,2465,13751,3806,21506
12-03-2019,11 - 12,1381,2359,13324,3752,20816
12-03-2019,12 - 13,1263,2351,13137,3608,20359
12-03-2019,13 - 14,1291,2226,12918,3558,19993
12-03-2019,14 - 15,1257,2164,12864,3517,19802
12-03-2019,15 - 16,1368,2152,12798,3540,19858
12-03-2019,16 - 17,1393,2146,12706,3510,19755
12-03-2019,17 - 18,1382,2094,13188,3683,20347
12-03-2019,18 - 19,1387,2084,13458,3751,20680
12-03-2019,19 - 20,1409,1997,13321,3735,20462
12-03-2019,20 - 21,1412,1973,12884,3602,19871
12-03-2019,21 - 22,1295,2040,12321,3379,19035
12-03-2019,22 - 23,1285,1931,11685,3132,18033
12-03-2019,23 - 00,1270,1929,11221,2943,17363
13-03-2019,00 - 01,1317,1900,10900,2915,17032
13-03-2019,01 - 02,1287,1867,10765,2954,16873
13-03-2019,02 - 03,1329,1965,10687,2905,16886
13-03-2019,03 - 04,1258,1891,10620,2828,16597
13-03-2019,04 - 05,1234,2031,10783,2819,16867
13-03-2019,05 - 06,1413,2224,11285,3010,17932
13-03-2019,06 - 07,1501,2531,12457,3372,19861
13-03-2019,07 - 08,1446,2477,13316,3641,20880
13-03-2019,08 - 09,1406,2412,13426,3685,20929
13-03-2019,09 - 10,1401,2353,13481,3721,20956
13-03-2019,10 - 11,1392,2313,13393,3740,20838
13-03-2019,11 - 12,1345,2482,13347,3725,20899
13-03-2019,12 - 13,1296,2324,13274,3720,20614
13-03-2019,13 - 14,1317,2253,13191,3695,20456
13-03-2019,14 - 15,1281,2227,13111,3686,20305
13-03-2019,15 - 16,1351,2276,13138,3649,20414
13-03-2019,16 - 17,1325,2254,13008,3606,20193
13-03-2019,17 - 18,1291,2294,13255,3627,20467
13-03-2019,18 - 19,1256,2348,13443,3654,20701
13-03-2019,19 - 20,1162,2304,13182,3524,20172
13-03-2019,20 - 21,1234,2199,12552,3306,19291
13-03-2019,21 - 22,1284,2201,11961,3194,18640
13-03-2019,22 - 23,1276,2111,11280,2994,17661
13-03-2019,23 - 00,1300,2136,10817,2888,17141
14-03-2019,00 - 01,1301,2090,10359,2787,16537
14-03-2019,01 - 02,1245,2062,10126,2819,16252
14-03-2019,02 - 03,1278,1989,10056,2809,16132
14-03-2019,03 - 04,1252,1968,10082,2782,16084
14-03-2019,04 - 05,1235,1927,10275,2729,16166
14-03-2019,05 - 06,1337,2033,10725,2766,16861
14-03-2019,06 - 07,1431,2203,11849,3182,18665
14-03-2019,07 - 08,1400,2372,12756,3696,20224
14-03-2019,08 - 09,1384,2420,12941,3817,20562
14-03-2019,09 - 10,1399,2472,12835,3802,20508
14-03-2019,10 - 11,1399,2667,12752,3762,20580
14-03-2019,11 - 12,1445,2508,12715,3682,20350
14-03-2019,12 - 13,1433,2396,12613,3596,20038
14-03-2019,13 - 14,1453,2365,12477,3554,19849
14-03-2019,14 - 15,1396,2385,12403,3555,19739
14-03-2019,15 - 16,1378,2350,12476,3531,19735
14-03-2019,16 - 17,1422,2379,12434,3570,19805
14-03-2019,17 - 18,1430,2418,12726,3683,20257
14-03-2019,18 - 19,1476,2493,13074,3796,20839
14-03-2019,19 - 20,1465,2449,12957,3763,20634
14-03-2019,20 - 21,1455,2383,12484,3592,19914
14-03-2019,21 - 22,1476,2304,11958,3412,19150
14-03-2019,22 - 23,1437,2320,11288,3169,18214
14-03-2019,23 - 00,1347,2188,10795,2955,17285
15-03-2019,00 - 01,1365,2091,10432,2801,16689
15-03-2019,01 - 02,1352,2049,10223,2740,16364
15-03-2019,02 - 03,1342,2038,10123,2714,16217
15-03-2019,03 - 04,1323,2034,10185,2712,16254
15-03-2019,04 - 05,1363,2025,10353,2757,16498
15-03-2019,05 - 06,1389,2084,10916,2934,17323
15-03-2019,06 - 07,1478,2181,11976,3275,18910
15-03-2019,07 - 08,1440,2413,12937,3578,20368
15-03-2019,08 - 09,1452,2439,13206,3652,20749
15-03-2019,09 - 10,1437,2354,13025,3692,20508
15-03-2019,10 - 11,1384,2304,13031,3720,20439
15-03-2019,11 - 12,1436,2298,12895,3720,20349
15-03-2019,12 - 13,1303,2350,12964,3696,20313
15-03-2019,13 - 14,1302,2280,12568,3625,19775
15-03-2019,14 - 15,1348,2220,12137,3563,19268
15-03-2019,15 - 16,1374,2195,12086,3470,19125
15-03-2019,16 - 17,1369,2230,12015,3431,19045
15-03-2019,17 - 18,1498,2311,12342,3542,19693
15-03-2019,18 - 19,1446,2351,12617,3632,20046
15-03-2019,19 - 20,1336,2308,12283,3475,19402
15-03-2019,20 - 21,1288,2232,11692,3264,18476
15-03-2019,21 - 22,1308,2144,11122,3024,17598
15-03-2019,22 - 23,1302,2044,10646,2896,16888
15-03-2019,23 - 00,1240,1943,10295,2857,16335
16-03-2019,00 - 01,1221,1949,9920,2737,15827
16-03-2019,01 - 02,1223,1933,9705,2642,15503
16-03-2019,02 - 03,1210,1932,9548,2637,15327
16-03-2019,03 - 04,1188,2005,9497,2547,15237
16-03-2019,04 - 05,1217,2017,9498,2517,15249
16-03-2019,05 - 06,1222,1982,9654,2589,15447
16-03-2019,06 - 07,1263,1945,9829,2681,15718
16-03-2019,07 - 08,1301,1965,10229,2755,16250
16-03-2019,08 - 09,1272,2095,10736,2910,17013
16-03-2019,09 - 10,1323,2133,11148,3025,17629
16-03-2019,10 - 11,1349,2116,11412,2999,17876
16-03-2019,11 - 12,1367,2101,11501,3015,17984
16-03-2019,12 - 13,1362,2110,11334,2993,17799
16-03-2019,13 - 14,1302,2073,11145,2951,17471
16-03-2019,14 - 15,1297,2094,11035,2937,17363
16-03-2019,15 - 16,1348,2154,11026,2922,17450
16-03-2019,16 - 17,1331,2181,11146,2992,17650
16-03-2019,17 - 18,1365,2219,11497,3094,18175
16-03-2019,18 - 19,1331,2251,11927,3210,18719
16-03-2019,19 - 20,1338,2254,11771,3132,18495
16-03-2019,20 - 21,1340,2150,11235,2974,17699
16-03-2019,21 - 22,1330,2058,10784,2800,16972
16-03-2019,22 - 23,1267,1995,10302,2596,16160
16-03-2019,23 - 00,1230,1972,9994,2465,15661
17-03-2019,00 - 01,1189,1966,9748,2429,15332
17-03-2019,01 - 02,1184,1918,9555,2416,15073
17-03-2019,02 - 03,1165,1877,9395,2373,14810
17-03-2019,03 - 04,1158,1907,9379,2395,14839
17-03-2019,04 - 05,1255,1854,9462,2476,15047
17-03-2019,05 - 06,1156,1910,9507,2498,15071
17-03-2019,06 - 07,1169,1957,9547,2492,15165
17-03-2019,07 - 08,1201,2017,9900,2583,15701
17-03-2019,08 - 09,1308,2093,10367,2752,16520
17-03-2019,09 - 10,1322,2086,10784,2983,17175
17-03-2019,10 - 11,1337,2066,11102,3033,17538
17-03-2019,11 - 12,1336,2012,11078,2984,17410
17-03-2019,12 - 13,1368,1969,11142,2961,17440
17-03-2019,13 - 14,1220,2042,11121,2909,17292
17-03-2019,14 - 15,1177,2111,10946,2862,17096
17-03-2019,15 - 16,1260,2156,10919,2872,17207
17-03-2019,16 - 17,1348,2281,10737,2907,17273
17-03-2019,17 - 18,1278,2311,11176,3061,17826
17-03-2019,18 - 19,1241,2321,11842,3211,18615
17-03-2019,19 - 20,1254,2283,11784,3272,18593
17-03-2019,20 - 21,1230,2294,11455,3148,18127
17-03-2019,21 - 22,1213,2282,10962,3068,17525
17-03-2019,22 - 23,1274,2293,10549,2935,17051
17-03-2019,23 - 00,1223,2180,10235,2814,16452
18-03-2019,00 - 01,1188,2036,9886,2771,15881
18-03-2019,01 - 02,1241,2032,9679,2747,15699
18-03-2019,02 - 03,1244,2048,9637,2759,15688
18-03-2019,03 - 04,1164,1991,9620,2761,15536
18-03-2019,04 - 05,1297,1966,9794,2816,15873
18-03-2019,05 - 06,1351,2048,10332,2882,16613
18-03-2019,06 - 07,1453,2199,11248,3335,18235
18-03-2019,07 - 08,1502,2314,12289,3739,19844
18-03-2019,08 - 09,1457,2232,12382,3786,19857
18-03-2019,09 - 10,1244,2273,12508,3758,19783
18-03-2019,10 - 11,1357,2216,12498,3684,19755
18-03-2019,11 - 12,1319,2306,12433,3619,19677
18-03-2019,12 - 13,1369,2342,12375,3525,19611
18-03-2019,13 - 14,1375,2224,12293,3512,19404
18-03-2019,14 - 15,1310,2106,12240,3485,19141
18-03-2019,15 - 16,1375,2193,12404,3517,19489
18-03-2019,16 - 17,1368,2159,12547,3488,19562
18-03-2019,17 - 18,1409,2236,12998,3521,20164
18-03-2019,18 - 19,1457,2251,13250,3690,20648
18-03-2019,19 - 20,1414,2242,13166,3787,20609
18-03-2019,20 - 21,1354,1986,12579,3668,19587
18-03-2019,21 - 22,1231,1922,11925,3508,18586
18-03-2019,22 - 23,1280,1970,11278,3237,17765
18-03-2019,23 - 00,1183,1853,10598,3083,16717
19-03-2019,00 - 01,1153,1854,10314,2930,16251
19-03-2019,01 - 02,1182,1823,10233,2865,16103
19-03-2019,02 - 03,1168,1760,10299,2889,16116
19-03-2019,03 - 04,1223,1809,10187,2958,16177
19-03-2019,04 - 05,1197,1830,10442,3012,16481
19-03-2019,05 - 06,1204,1912,10966,3177,17259
19-03-2019,06 - 07,1265,2019,12054,3544,18882
19-03-2019,07 - 08,1403,2026,12792,3798,20019
19-03-2019,08 - 09,1475,2077,12832,3755,20139
19-03-2019,09 - 10,1391,2138,12583,3477,19589
19-03-2019,10 - 11,1442,2212,12361,3291,19306
19-03-2019,11 - 12,1441,2271,12151,3317,19180
19-03-2019,12 - 13,1418,2105,11937,3322,18782
19-03-2019,13 - 14,1352,2042,11544,3301,18239
19-03-2019,14 - 15,1326,2074,11297,3230,17927
19-03-2019,15 - 16,1287,2121,11365,3173,17946
19-03-2019,16 - 17,1381,2125,11407,3138,18051
19-03-2019,17 - 18,1342,2238,12067,3368,19015
19-03-2019,18 - 19,1363,2352,12517,3591,19823
19-03-2019,19 - 20,1287,2313,12667,3636,19903
19-03-2019,20 - 21,1275,1991,12342,3550,19158
19-03-2019,21 - 22,1294,1881,11724,3374,18273
19-03-2019,22 - 23,1205,1739,11133,3156,17233
19-03-2019,23 - 00,1106,1564,10632,2879,16181
20-03-2019,00 - 01,1074,1579,10230,2876,15759
20-03-2019,01 - 02,1065,1596,10082,2827,15570
20-03-2019,02 - 03,1138,1518,10109,2757,15522
20-03-2019,03 - 04,1171,1620,10053,2770,15614
20-03-2019,04 - 05,1210,1567,10209,2811,15797
20-03-2019,05 - 06,1236,1785,10665,3059,16745
20-03-2019,06 - 07,1224,1911,11688,3470,18293
20-03-2019,07 - 08,1306,1944,12760,3804,19814
20-03-2019,08 - 09,1264,2039,12897,3855,20055
20-03-2019,09 - 10,1278,2056,12683,3789,19806
20-03-2019,10 - 11,1266,2120,12754,3716,19856
20-03-2019,11 - 12,1287,2067,12744,3665,19763
20-03-2019,12 - 13,1216,1931,12364,3564,19075
20-03-2019,13 - 14,1251,2013,11797,3467,18528
20-03-2019,14 - 15,1287,1872,11554,3445,18158
20-03-2019,15 - 16,1248,1861,11364,3443,17916
20-03-2019,16 - 17,1214,1963,11516,3389,18082
20-03-2019,17 - 18,1192,2108,12038,3478,18816
20-03-2019,18 - 19,1303,2243,12416,3552,19514
20-03-2019,19 - 20,1252,2289,12438,3483,19462
20-03-2019,20 - 21,1159,2202,12045,3305,18711
20-03-2019,21 - 22,1133,2146,11415,3116,17810
20-03-2019,22 - 23,1257,1911,10771,2897,16836
20-03-2019,23 - 00,1188,1719,10096,2702,15705
21-03-2019,00 - 01,1199,1721,9521,2639,15080
21-03-2019,01 - 02,1144,1805,9352,2600,14901
21-03-2019,02 - 03,1164,1778,9291,2538,14771
21-03-2019,03 - 04,1183,1762,9199,2470,14614
21-03-2019,04 - 05,1203,1761,9328,2514,14806
21-03-2019,05 - 06,1197,1646,9792,2695,15330
21-03-2019,06 - 07,1237,1662,10895,2995,16789
21-03-2019,07 - 08,1364,1921,11776,3292,18353
21-03-2019,08 - 09,1322,1996,11866,3383,18567
21-03-2019,09 - 10,1287,1862,11815,3363,18327
21-03-2019,10 - 11,1321,1997,11803,3361,18482
21-03-2019,11 - 12,1149,1990,11681,3384,18204
21-03-2019,12 - 13,1285,1899,11539,3293,18016
21-03-2019,13 - 14,1222,1786,11468,3268,17744
21-03-2019,14 - 15,1187,1810,11567,3323,17887
21-03-2019,15 - 16,1218,1866,11396,3305,17785
21-03-2019,16 - 17,1182,1856,11120,3303,17461
21-03-2019,17 - 18,1202,2020,11491,3413,18126
21-03-2019,18 - 19,1173,2173,11841,3490,18677
21-03-2019,19 - 20,1228,2136,11950,3416,18730
21-03-2019,20 - 21,1208,1982,11407,3215,17812
21-03-2019,21 - 22,1294,1941,10840,3044,17119
21-03-2019,22 - 23,1246,1897,10287,2856,16286
21-03-2019,23 - 00,1178,1760,9782,2663,15383
22-03-2019,00 - 01,1221,1722,9324,2547,14814
22-03-2019,01 - 02,1220,1713,9299,2492,14724
22-03-2019,02 - 03,1245,1709,9392,2525,14871
22-03-2019,03 - 04,1197,1882,9657,2577,15313
22-03-2019,04 - 05,1259,1672,9982,2654,15567
22-03-2019,05 - 06,1124,1533,10642,2831,16130
22-03-2019,06 - 07,1318,1950,11736,3161,18165
22-03-2019,07 - 08,1385,2189,12464,3421,19459
22-03-2019,08 - 09,1441,2262,12395,3478,19576
22-03-2019,09 - 10,1318,2325,12190,3419,19252
22-03-2019,10 - 11,1195,2093,11847,3339,18474
22-03-2019,11 - 12,1219,1929,11448,3258,17854
22-03-2019,12 - 13,1179,1870,11137,3195,17381
22-03-2019,13 - 14,1087,1684,10809,3152,16732
22-03-2019,14 - 15,1102,1853,10546,3067,16568
22-03-2019,15 - 16,1271,1914,10351,2996,16532
22-03-2019,16 - 17,1269,1966,10532,2997,16764
22-03-2019,17 - 18,1185,2026,10988,3152,17351
22-03-2019,18 - 19,1173,2088,11264,3232,17757
22-03-2019,19 - 20,1099,2071,11129,3191,17490
22-03-2019,20 - 21,1191,1937,10731,3005,16864
22-03-2019,21 - 22,1234,1815,10188,2845,16082
22-03-2019,22 - 23,1230,1705,9702,2723,15360
22-03-2019,23 - 00,1088,1715,9170,2600,14573
23-03-2019,00 - 01,1127,1735,8857,2542,14261
23-03-2019,01 - 02,1110,1725,8596,2535,13966
23-03-2019,02 - 03,1087,1783,8429,2523,13822
23-03-2019,03 - 04,1183,1723,8395,2485,13786
23-03-2019,04 - 05,1134,1771,8441,2486,13832
23-03-2019,05 - 06,1198,1761,8557,2507,14023
23-03-2019,06 - 07,1190,1707,8681,2513,14091
23-03-2019,07 - 08,1179,1815,9101,2612,14707
23-03-2019,08 - 09,1181,1968,9636,2731,15516
23-03-2019,09 - 10,1157,1865,9894,2880,15796
23-03-2019,10 - 11,1178,1872,9755,2867,15672
23-03-2019,11 - 12,1156,1902,9662,2804,15524
23-03-2019,12 - 13,1185,1832,9593,2715,15325
23-03-2019,13 - 14,1183,1843,9374,2626,15026
23-03-2019,14 - 15,1173,1819,9310,2617,14919
23-03-2019,15 - 16,1129,1825,9288,2608,14850
23-03-2019,16 - 17,1202,1892,9396,2630,15120
23-03-2019,17 - 18,1224,2040,9906,2441,15611
23-03-2019,18 - 19,1249,2094,10344,2761,16448
23-03-2019,19 - 20,1229,2209,10530,3058,17026
23-03-2019,20 - 21,1272,1996,10284,2959,16511
23-03-2019,21 - 22,1189,1899,9922,2801,15811
23-03-2019,22 - 23,1242,1855,9507,2689,15293
23-03-2019,23 - 00,1214,1865,9294,2611,14984
24-03-2019,00 - 01,1213,1749,8925,2525,14412
24-03-2019,01 - 02,1185,1806,8791,2517,14299
24-03-2019,02 - 03,1171,1846,8616,2525,14158
24-03-2019,03 - 04,1220,1815,8693,2497,14225
24-03-2019,04 - 05,1225,1840,8812,2462,14339
24-03-2019,05 - 06,1227,1817,9014,2576,14634
24-03-2019,06 - 07,1206,1871,9254,2562,14893
24-03-2019,07 - 08,1257,1966,9353,2641,15217
24-03-2019,08 - 09,1303,1958,9537,2794,15592
24-03-2019,09 - 10,1367,1919,9675,2985,15946
24-03-2019,10 - 11,1331,1853,9701,3017,15902
24-03-2019,11 - 12,1399,1813,9828,3034,16074
24-03-2019,12 - 13,1351,1809,9816,2937,15913
24-03-2019,13 - 14,1256,1711,9802,2815,15584
24-03-2019,14 - 15,1175,1659,9646,2751,15231
24-03-2019,15 - 16,1178,1812,9715,2775,15480
24-03-2019,16 - 17,1319,1989,9878,2848,16034
24-03-2019,17 - 18,1379,2017,10325,2906,16627
24-03-2019,18 - 19,1413,2108,10940,3091,17552
24-03-2019,19 - 20,1398,2143,11178,3166,17885
24-03-2019,20 - 21,1323,1942,10891,3146,17302
24-03-2019,21 - 22,1280,1831,10500,3009,16620
24-03-2019,22 - 23,1291,1803,9998,2781,15873
24-03-2019,23 - 00,1236,1713,9529,2634,15112
25-03-2019,00 - 01,1209,1665,9175,2618,14667
25-03-2019,01 - 02,1200,1597,9137,2613,14547
25-03-2019,02 - 03,1223,1600,9129,2590,14542
25-03-2019,03 - 04,1246,1634,9180,2577,14637
25-03-2019,04 - 05,1239,1654,9422,2624,14939
25-03-2019,05 - 06,1210,1732,9955,2805,15702
25-03-2019,06 - 07,1338,1934,10950,3184,17406
25-03-2019,07 - 08,1484,1913,11835,3546,18778
25-03-2019,08 - 09,1536,2174,11962,3660,19332
25-03-2019,09 - 10,1346,2088,11878,3648,18960
25-03-2019,10 - 11,1327,1977,11829,3629,18762
25-03-2019,11 - 12,1283,1980,11689,3572,18524
25-03-2019,12 - 13,1360,2010,11510,3457,18337
25-03-2019,13 - 14,1289,2010,11257,3365,17921
25-03-2019,14 - 15,1261,1855,11075,3278,17469
25-03-2019,15 - 16,1299,1959,11064,3228,17550
25-03-2019,16 - 17,1319,2132,11068,3038,17557
25-03-2019,17 - 18,1319,2318,11585,3097,18319
25-03-2019,18 - 19,1340,2211,12105,3309,18965
25-03-2019,19 - 20,1376,1966,12115,3433,18890
25-03-2019,20 - 21,1329,1969,11587,3308,18193
25-03-2019,21 - 22,1274,2021,10943,3097,17335
25-03-2019,22 - 23,1221,2077,10310,2914,16522
25-03-2019,23 - 00,1189,2064,9698,2711,15662
26-03-2019,00 - 01,955,1800,9468,2560,14783
26-03-2019,01 - 02,1024,1724,9621,2505,14874
26-03-2019,02 - 03,1214,1823,9494,2441,14972
26-03-2019,03 - 04,1227,1852,9534,2456,15069
26-03-2019,04 - 05,1145,1857,9605,2537,15144
26-03-2019,05 - 06,1161,1913,10128,2692,15894
26-03-2019,06 - 07,1383,2081,11141,3108,17713
26-03-2019,07 - 08,1568,2190,11998,3542,19298
26-03-2019,08 - 09,1525,2143,12021,3504,19193
26-03-2019,09 - 10,1472,2169,11819,3258,18718
26-03-2019,10 - 11,1367,1982,11795,3222,18366
26-03-2019,11 - 12,1302,1947,11782,3140,18171
26-03-2019,12 - 13,1331,1924,11566,3045,17866
26-03-2019,13 - 14,1289,1873,11484,3034,17680
26-03-2019,14 - 15,1321,1830,11398,3035,17584
26-03-2019,15 - 16,1293,1895,11234,3106,17528
26-03-2019,16 - 17,1377,1946,11214,3133,17670
26-03-2019,17 - 18,1426,2014,11577,3293,18310
26-03-2019,18 - 19,1486,2088,11963,3442,18979
26-03-2019,19 - 20,1439,2074,12261,3523,19297
26-03-2019,20 - 21,1344,1912,11891,3392,18539
26-03-2019,21 - 22,1256,1902,11348,3221,17727
26-03-2019,22 - 23,1254,1954,10597,3029,16834
26-03-2019,23 - 00,934,1840,9899,2787,15460
27-03-2019,00 - 01,1090,1819,9610,2628,15147
27-03-2019,01 - 02,1098,1724,9456,2532,14810
27-03-2019,02 - 03,1139,1454,9288,2449,14330
27-03-2019,03 - 04,1176,1647,9352,2491,14666
27-03-2019,04 - 05,1184,1601,9547,2509,14841
27-03-2019,05 - 06,1178,1670,9992,2661,15501
27-03-2019,06 - 07,1249,1819,11124,3002,17194
27-03-2019,07 - 08,1225,2079,12039,3317,18660
27-03-2019,08 - 09,1383,2306,12031,3373,19093
27-03-2019,09 - 10,1353,2161,11826,3330,18670
27-03-2019,10 - 11,1297,2038,11575,3327,18237
27-03-2019,11 - 12,1240,2120,11222,3286,17868
27-03-2019,12 - 13,1187,2310,11155,3235,17887
27-03-2019,13 - 14,1132,2099,10768,3284,17283
27-03-2019,14 - 15,1094,1801,10605,3158,16658
27-03-2019,15 - 16,1286,1977,10594,3068,16925
27-03-2019,16 - 17,1278,1938,10601,3019,16836
27-03-2019,17 - 18,1277,2096,10931,3116,17420
27-03-2019,18 - 19,1370,2097,11380,3210,18057
27-03-2019,19 - 20,1331,2119,11559,3262,18271
27-03-2019,20 - 21,1313,2254,11368,3167,18102
27-03-2019,21 - 22,1321,2151,10917,2996,17385
27-03-2019,22 - 23,1197,2079,10395,2819,16490
27-03-2019,23 - 00,1108,1943,9843,2617,15511
28-03-2019,00 - 01,1053,1818,9550,2548,14969
28-03-2019,01 - 02,1092,1653,9369,2530,14644
28-03-2019,02 - 03,1096,1663,9377,2537,14673
28-03-2019,03 - 04,1118,1684,9514,2593,14909
28-03-2019,04 - 05,1145,1674,9612,2632,15063
28-03-2019,05 - 06,1226,1757,9926,2787,15696
28-03-2019,06 - 07,1321,2059,10843,3102,17325
28-03-2019,07 - 08,1385,2097,11459,3379,18320
28-03-2019,08 - 09,1300,2129,11500,3410,18339
28-03-2019,09 - 10,1323,1985,11145,3370,17823
28-03-2019,10 - 11,1303,1968,10925,3303,17499
28-03-2019,11 - 12,1300,1954,10659,3317,17230
28-03-2019,12 - 13,1269,1955,10420,3275,16919
28-03-2019,13 - 14,1214,1955,10272,3255,16696
28-03-2019,14 - 15,1174,1908,10046,3217,16345
28-03-2019,15 - 16,1228,1868,10032,3226,16354
28-03-2019,16 - 17,1255,1956,9960,3178,16349
28-03-2019,17 - 18,1269,1982,10249,3180,16680
28-03-2019,18 - 19,1267,1871,10559,3243,16940
28-03-2019,19 - 20,1237,1961,10842,3240,17280
28-03-2019,20 - 21,1273,1836,10435,3094,16638
28-03-2019,21 - 22,1168,1884,9941,2888,15881
28-03-2019,22 - 23,1217,1891,9281,2611,15000
28-03-2019,23 - 00,1192,1776,8788,2441,14197
29-03-2019,00 - 01,1183,1695,8387,2445,13710
29-03-2019,01 - 02,1170,1743,8207,2436,13556
29-03-2019,02 - 03,1200,1741,8206,2420,13567
29-03-2019,03 - 04,1165,1682,8263,2447,13557
29-03-2019,04 - 05,1156,1647,8382,2534,13719
29-03-2019,05 - 06,1162,1626,8643,2704,14135
29-03-2019,06 - 07,1366,1766,9781,2974,15887
29-03-2019,07 - 08,1530,1955,10713,3213,17411
29-03-2019,08 - 09,1356,1981,10892,3195,17424
29-03-2019,09 - 10,1310,1832,10875,3110,17127
29-03-2019,10 - 11,1355,1879,10822,3080,17136
29-03-2019,11 - 12,1385,1893,10675,2956,16909
29-03-2019,12 - 13,1244,1925,10421,2881,16471
29-03-2019,13 - 14,1302,1979,10057,2808,16146
29-03-2019,14 - 15,1341,1958,9831,2810,15940
29-03-2019,15 - 16,1361,1848,9672,2790,15671
29-03-2019,16 - 17,1346,2034,9625,2772,15777
29-03-2019,17 - 18,1309,2081,9834,2891,16115
29-03-2019,18 - 19,1238,2236,10093,2969,16536
29-03-2019,19 - 20,1290,2455,10275,2946,16966
29-03-2019,20 - 21,1263,2298,9834,2807,16202
29-03-2019,21 - 22,1184,2014,9458,2744,15400
29-03-2019,22 - 23,1251,1924,8974,2605,14754
29-03-2019,23 - 00,1217,1782,8579,2465,14043
30-03-2019,00 - 01,1194,1667,8387,2401,13649
30-03-2019,01 - 02,1194,1866,8229,2364,13653
30-03-2019,02 - 03,1203,1831,8359,2357,13750
30-03-2019,03 - 04,1192,1869,8442,2333,13836
30-03-2019,04 - 05,1229,1904,8370,2376,13879
30-03-2019,05 - 06,1261,1794,8215,2379,13649
30-03-2019,06 - 07,1201,1864,8321,2483,13869
30-03-2019,07 - 08,1301,1874,8685,2580,14440
30-03-2019,08 - 09,1309,1986,9214,2689,15198
30-03-2019,09 - 10,1351,2038,9599,2712,15700
30-03-2019,10 - 11,1273,1928,9481,2667,15349
30-03-2019,11 - 12,1293,1925,9454,2606,15278
30-03-2019,12 - 13,1257,1896,9532,2580,15265
30-03-2019,13 - 14,1296,1862,9345,2503,15006
30-03-2019,14 - 15,1270,1741,9229,2410,14650
30-03-2019,15 - 16,1241,1875,9174,2398,14688
30-03-2019,16 - 17,1249,1862,9211,2373,14695
30-03-2019,17 - 18,1344,2265,9647,2561,15817
30-03-2019,18 - 19,1384,2272,9932,2760,16348
30-03-2019,19 - 20,1390,2161,10106,2878,16535
30-03-2019,20 - 21,1318,2037,9653,2710,15718
30-03-2019,21 - 22,1207,2034,9206,2581,15028
30-03-2019,22 - 23,1309,1842,8901,2429,14481
30-03-2019,23 - 00,1224,1687,8662,2347,13920
31-03-2019,00 - 01,1145,1664,8456,2324,13589
31-03-2019,01 - 02,1195,1620,8304,2288,13407
31-03-2019,02 - 03,,,,,
31-03-2019,03 - 04,1248,1642,8225,2330,13445
31-03-2019,04 - 05,1220,1675,8173,2378,13446
31-03-2019,05 - 06,1193,1757,8189,2376,13515
31-03-2019,06 - 07,1224,1694,8334,2417,13669
31-03-2019,07 - 08,1207,1911,8669,2455,14242
31-03-2019,08 - 09,1150,2039,9103,2474,14766
31-03-2019,09 - 10,1242,1873,9462,2584,15161
31-03-2019,10 - 11,1139,1770,9720,2557,15186
31-03-2019,11 - 12,1135,1713,9803,2591,15242
31-03-2019,12 - 13,1069,1707,9689,2535,15000
31-03-2019,13 - 14,1135,1639,9519,2411,14704
31-03-2019,14 - 15,1200,1746,9333,2328,14607
31-03-2019,15 - 16,1235,1782,9200,2366,14583
31-03-2019,16 - 17,1245,1797,9350,2327,14719
31-03-2019,17 - 18,1197,1819,9626,2429,15071
31-03-2019,18 - 19,1295,1967,9952,2592,15806
31-03-2019,19 - 20,1250,2109,10530,2899,16788
31-03-2019,20 - 21,1256,2230,10954,3135,17575
31-03-2019,21 - 22,1179,1947,10557,3005,16688
31-03-2019,22 - 23,1277,2042,10023,2853,16195
31-03-2019,23 - 00,1302,1829,9589,2665,15385
01-04-2019,00 - 01,1197,1732,9350,2607,14886
01-04-2019,01 - 02,1209,1783,9329,2598,14919
01-04-2019,02 - 03,1118,1919,9425,2621,15083
01-04-2019,03 - 04,1086,1989,9574,2673,15322
01-04-2019,04 - 05,1188,2057,9875,2777,15897
01-04-2019,05 - 06,1255,2063,10486,3040,16844
01-04-2019,06 - 07,1288,2145,11918,3508,18859
01-04-2019,07 - 08,1262,2173,12742,3772,19949
01-04-2019,08 - 09,1346,2011,12642,3754,19753
01-04-2019,09 - 10,1414,2055,12269,3603,19341
01-04-2019,10 - 11,1340,2098,11816,3460,18714
01-04-2019,11 - 12,1339,2091,11205,3281,17916
01-04-2019,12 - 13,1319,2033,10943,3132,17427
01-04-2019,13 - 14,1344,2100,10906,3092,17442
01-04-2019,14 - 15,1291,2099,10700,3030,17120
01-04-2019,15 - 16,1411,1992,10633,2949,16985
01-04-2019,16 - 17,1387,2043,10512,2923,16865
01-04-2019,17 - 18,1302,2123,10797,2964,17186
01-04-2019,18 - 19,1256,2034,11173,3072,17535
01-04-2019,19 - 20,1297,2026,11345,3153,17821
01-04-2019,20 - 21,1267,2144,11532,3206,18149
01-04-2019,21 - 22,1108,2087,11091,2971,17257
01-04-2019,22 - 23,1069,1956,10496,2718,16239
01-04-2019,23 - 00,731,1768,10204,2644,15347
02-04-2019,00 - 01,838,1517,9533,2578,14466
02-04-2019,01 - 02,1105,1554,9320,2489,14468
02-04-2019,02 - 03,1100,1488,9159,2441,14188
02-04-2019,03 - 04,1154,1761,9240,2509,14664
02-04-2019,04 - 05,1145,1826,9570,2604,15145
02-04-2019,05 - 06,1184,1751,10253,2781,15969
02-04-2019,06 - 07,1357,2109,11232,3192,17890
02-04-2019,07 - 08,1265,2021,12154,3488,18928
02-04-2019,08 - 09,1273,2061,12369,3537,19240
02-04-2019,09 - 10,1328,2058,12192,3370,18948
02-04-2019,10 - 11,1247,1999,11684,3198,18128
02-04-2019,11 - 12,1113,2012,11068,3134,17327
02-04-2019,12 - 13,1241,1797,10746,3101,16885
02-04-2019,13 - 14,1205,1677,10687,3046,16615
02-04-2019,14 - 15,1123,1576,10597,3003,16299
02-04-2019,15 - 16,1200,1679,10581,2987,16447
02-04-2019,16 - 17,1145,1846,10396,2921,16308
02-04-2019,17 - 18,1281,1910,10593,2948,16732
02-04-2019,18 - 19,1336,1975,10996,3099,17406
02-04-2019,19 - 20,1259,1979,11226,3249,17713
02-04-2019,20 - 21,1358,1876,11482,3273,17989
02-04-2019,21 - 22,1311,1746,11012,3118,17187
02-04-2019,22 - 23,1268,1707,10228,2860,16063
02-04-2019,23 - 00,1242,1579,9687,2651,15159
03-04-2019,00 - 01,1165,1622,9379,2525,14691
03-04-2019,01 - 02,1063,1609,9179,2494,14345
03-04-2019,02 - 03,1090,1704,9201,2467,14462
03-04-2019,03 - 04,1065,1870,9277,2470,14682
03-04-2019,04 - 05,1171,1866,9494,2565,15096
03-04-2019,05 - 06,1139,1967,10030,2742,15878
03-04-2019,06 - 07,1182,2113,11068,3121,17484
03-04-2019,07 - 08,1169,2146,11885,3486,18686
03-04-2019,08 - 09,1246,2115,12078,3611,19050
03-04-2019,09 - 10,1324,2191,11910,3518,18943
03-04-2019,10 - 11,1199,2118,11639,3489,18445
03-04-2019,11 - 12,1057,1986,11395,3409,17847
03-04-2019,12 - 13,1003,1838,11007,3307,17155
03-04-2019,13 - 14,997,1866,10851,3269,16983
03-04-2019,14 - 15,1145,1851,10867,3196,17059
03-04-2019,15 - 16,1184,1841,10837,3131,16993
03-04-2019,16 - 17,1244,1975,10685,3044,16948
03-04-2019,17 - 18,1245,1988,10825,3105,17163
03-04-2019,18 - 19,1221,1906,10835,3181,17143
03-04-2019,19 - 20,1204,1951,10949,3265,17369
03-04-2019,20 - 21,1167,1960,11010,3259,17396
03-04-2019,21 - 22,1155,1820,10510,3016,16501
03-04-2019,22 - 23,1148,1636,9867,2789,15440
03-04-2019,23 - 00,1184,1665,9271,2599,14719
04-04-2019,00 - 01,1154,1708,8771,2426,14059
04-04-2019,01 - 02,1153,1740,8629,2361,13883
04-04-2019,02 - 03,1113,1785,8607,2357,13862
04-04-2019,03 - 04,1015,1783,8596,2419,13813
04-04-2019,04 - 05,1185,1850,8827,2477,14339
04-04-2019,05 - 06,1244,1958,9297,2656,15155
04-04-2019,06 - 07,1188,2066,10462,2985,16701
04-04-2019,07 - 08,1145,2071,11413,3304,17933
04-04-2019,08 - 09,1284,2148,11498,3460,18390
04-04-2019,09 - 10,1231,2045,11280,3396,17952
04-04-2019,10 - 11,1191,2035,11060,3400,17686
04-04-2019,11 - 12,1220,1973,10713,3325,17231
04-04-2019,12 - 13,1263,1993,10588,3206,17050
04-04-2019,13 - 14,1252,2006,10252,3120,16630
04-04-2019,14 - 15,1214,1994,10184,3042,16434
04-04-2019,15 - 16,1211,2048,10199,2999,16457
04-04-2019,16 - 17,1279,2065,10015,2970,16329
04-04-2019,17 - 18,1206,1959,10150,3011,16326
04-04-2019,18 - 19,1200,2039,10162,3028,16429
04-04-2019,19 - 20,1322,2051,10317,3040,16730
04-04-2019,20 - 21,1207,1922,10398,3026,16553
04-04-2019,21 - 22,1167,1864,10087,2883,16001
04-04-2019,22 - 23,1142,1896,9539,2682,15259
04-04-2019,23 - 00,1132,1766,8965,2447,14310
05-04-2019,00 - 01,1096,1780,8632,2285,13793
05-04-2019,01 - 02,1028,1769,8498,2272,13567
05-04-2019,02 - 03,1180,1706,8592,2298,13776
05-04-2019,03 - 04,1164,1751,8551,2344,13810
05-04-2019,04 - 05,1162,1698,8640,2412,13912
05-04-2019,05 - 06,1241,1809,9211,2598,14859
05-04-2019,06 - 07,1265,2129,10336,2963,16693
05-04-2019,07 - 08,1334,2150,11368,3295,18147
05-04-2019,08 - 09,1368,2180,11502,3388,18438
05-04-2019,09 - 10,1305,2239,11254,3258,18056
05-04-2019,10 - 11,1200,2244,11092,3115,17651
05-04-2019,11 - 12,1196,2219,10796,2956,17167
05-04-2019,12 - 13,1196,2218,10507,2792,16713
05-04-2019,13 - 14,1248,2073,10275,2726,16322
05-04-2019,14 - 15,1154,2071,10142,2682,16049
05-04-2019,15 - 16,1174,1998,10034,2700,15906
05-04-2019,16 - 17,1266,2039,10023,2712,16040
05-04-2019,17 - 18,1199,2079,10203,2810,16291
05-04-2019,18 - 19,1171,1994,10255,2816,16236
05-04-2019,19 - 20,1228,1956,10225,2871,16280
05-04-2019,20 - 21,1208,2028,10157,2816,16209
05-04-2019,21 - 22,1142,1961,9701,2659,15463
05-04-2019,22 - 23,1154,1993,9271,2554,14972
05-04-2019,23 - 00,1132,1883,8935,2419,14369
06-04-2019,00 - 01,1053,1819,8596,2206,13674
06-04-2019,01 - 02,1112,1755,8521,2205,13593
06-04-2019,02 - 03,1140,1671,8488,2172,13471
06-04-2019,03 - 04,1046,1690,8438,2189,13363
06-04-2019,04 - 05,1035,1652,8441,2217,13345
06-04-2019,05 - 06,1134,1692,8647,2296,13769
06-04-2019,06 - 07,1173,1801,8772,2343,14089
06-04-2019,07 - 08,1216,1875,9042,2480,14613
06-04-2019,08 - 09,1376,2010,9407,2719,15512
06-04-2019,09 - 10,1297,2153,9602,2810,15862
06-04-2019,10 - 11,1218,1997,9666,2755,15636
06-04-2019,11 - 12,1277,1774,9362,2739,15152
06-04-2019,12 - 13,1259,1760,9048,2626,14693
06-04-2019,13 - 14,1198,1952,8879,2505,14534
06-04-2019,14 - 15,1296,1955,8646,2408,14305
06-04-2019,15 - 16,1278,2030,8636,2368,14312
06-04-2019,16 - 17,1335,1996,8731,2388,14450
06-04-2019,17 - 18,1322,1932,8932,2479,14665
06-04-2019,18 - 19,1334,2088,9193,2556,15171
06-04-2019,19 - 20,1281,2087,9376,2578,15322
06-04-2019,20 - 21,1298,2043,9590,2668,15599
06-04-2019,21 - 22,1226,1847,9180,2569,14822
06-04-2019,22 - 23,1171,1765,8806,2430,14172
06-04-2019,23 - 00,1178,1747,8451,2297,13673
07-04-2019,00 - 01,1183,1790,8113,2180,13266
07-04-2019,01 - 02,1171,1835,7968,2142,13116
07-04-2019,02 - 03,1125,1854,7794,2141,12914
07-04-2019,03 - 04,1114,1764,7749,2176,12803
07-04-2019,04 - 05,1144,1804,7810,2225,12983
07-04-2019,05 - 06,1096,1777,7934,2271,13078
07-04-2019,06 - 07,1192,1867,7915,2285,13259
07-04-2019,07 - 08,1130,2004,8273,2362,13769
07-04-2019,08 - 09,1125,2013,8685,2515,14338
07-04-2019,09 - 10,1102,2080,9145,2560,14887
07-04-2019,10 - 11,1102,2062,9392,2541,15097
07-04-2019,11 - 12,1134,2024,9469,2505,15132
07-04-2019,12 - 13,1156,2032,9331,2477,14996
07-04-2019,13 - 14,1288,1966,9172,2432,14858
07-04-2019,14 - 15,1263,1891,9039,2352,14545
07-04-2019,15 - 16,1250,1809,8986,2253,14298
07-04-2019,16 - 17,1230,1866,9161,2235,14492
07-04-2019,17 - 18,1260,1918,9473,2306,14957
07-04-2019,18 - 19,1315,1950,9802,2461,15528
07-04-2019,19 - 20,1235,1885,10027,2567,15714
07-04-2019,20 - 21,1204,1953,10297,2639,16093
07-04-2019,21 - 22,1251,1971,10004,2542,15768
07-04-2019,22 - 23,1234,1962,9365,2353,14914
07-04-2019,23 - 00,1205,1882,8977,2189,14253
08-04-2019,00 - 01,1275,1896,8695,2182,14048
08-04-2019,01 - 02,1256,1823,8664,2207,13950
08-04-2019,02 - 03,1270,1828,8644,2224,13966
08-04-2019,03 - 04,1230,1826,8838,2213,14107
08-04-2019,04 - 05,1264,1822,8991,2209,14286
08-04-2019,05 - 06,1262,1859,9676,2468,15265
08-04-2019,06 - 07,1395,2022,10689,2888,16994
08-04-2019,07 - 08,1412,2101,11822,3262,18597
08-04-2019,08 - 09,1455,2139,12072,3327,18993
08-04-2019,09 - 10,1427,2117,12081,3267,18892
08-04-2019,10 - 11,1372,2036,12174,3254,18836
08-04-2019,11 - 12,1331,2036,12055,3237,18659
08-04-2019,12 - 13,1301,1940,11921,3172,18334
08-04-2019,13 - 14,1302,1924,11571,3158,17955
08-04-2019,14 - 15,1275,1981,11434,3069,17759
08-04-2019,15 - 16,1266,2024,11295,3048,17633
08-04-2019,16 - 17,1312,1969,11340,2985,17606
08-04-2019,17 - 18,1319,2028,11455,3059,17861
08-04-2019,18 - 19,1289,2075,11309,3041,17714
08-04-2019,19 - 20,1283,2110,11334,3058,17785
08-04-2019,20 - 21,1223,2271,11548,3125,18167
08-04-2019,21 - 22,1207,2200,11195,3022,17624
08-04-2019,22 - 23,1114,2008,10532,2784,16438
08-04-2019,23 - 00,1111,1921,9993,2550,15575
09-04-2019,00 - 01,1310,1992,9682,2455,15439
09-04-2019,01 - 02,1179,1825,9651,2497,15152
09-04-2019,02 - 03,1192,1905,9632,2537,15266
09-04-2019,03 - 04,932,1777,9749,2594,15052
09-04-2019,04 - 05,966,1369,10082,2725,15142
09-04-2019,05 - 06,603,1132,11037,3039,15811
09-04-2019,06 - 07,949,1733,12221,3460,18363
09-04-2019,07 - 08,1391,2113,12576,3652,19732
09-04-2019,08 - 09,1361,2121,12572,3560,19614
09-04-2019,09 - 10,1396,2053,12527,3474,19450
09-04-2019,10 - 11,1270,2153,12408,3495,19326
09-04-2019,11 - 12,1459,2138,12246,3386,19229
09-04-2019,12 - 13,1416,2044,12080,3279,18819
09-04-2019,13 - 14,1419,2135,11886,3161,18601
09-04-2019,14 - 15,1278,1972,11712,3059,18021
09-04-2019,15 - 16,1203,1877,11566,2952,17598
09-04-2019,16 - 17,1251,1917,11837,2968,17973
09-04-2019,17 - 18,1285,2042,11965,3007,18299
09-04-2019,18 - 19,1304,2077,11984,3043,18408
09-04-2019,19 - 20,1143,2195,12087,3168,18593
09-04-2019,20 - 21,1452,2156,11854,3114,18576
09-04-2019,21 - 22,1591,2208,11094,2988,17881
09-04-2019,22 - 23,1439,2332,10342,2800,16913
09-04-2019,23 - 00,1468,3182,10381,2198,17229
10-04-2019,00 - 01,1159,1834,9848,2660,15501
10-04-2019,01 - 02,1129,1728,9714,2612,15183
10-04-2019,02 - 03,1157,1700,9642,2639,15138
10-04-2019,03 - 04,1179,1635,9699,2701,15214
10-04-2019,04 - 05,1147,1592,9918,2786,15443
10-04-2019,05 - 06,1047,1686,10502,2965,16200
10-04-2019,06 - 07,1286,1939,11612,3314,18151
10-04-2019,07 - 08,1414,2191,12698,3625,19928
10-04-2019,08 - 09,1553,2316,13025,3687,20581
10-04-2019,09 - 10,1340,2159,12950,3581,20030
10-04-2019,10 - 11,1231,1877,12925,3601,19634
10-04-2019,11 - 12,1233,2083,12931,3595,19842
10-04-2019,12 - 13,1320,2117,12869,3498,19804
10-04-2019,13 - 14,1213,2108,12717,3498,19536
10-04-2019,14 - 15,1250,2090,12521,3442,19303
10-04-2019,15 - 16,1148,2124,12498,3444,19214
10-04-2019,16 - 17,1179,2126,12259,3425,18989
10-04-2019,17 - 18,1204,2214,12424,3469,19311
10-04-2019,18 - 19,1233,2132,12334,3462,19161
10-04-2019,19 - 20,1243,2116,12370,3440,19169
10-04-2019,20 - 21,1189,2247,12528,3485,19449
10-04-2019,21 - 22,1160,2105,12087,3345,18697
10-04-2019,22 - 23,1238,1934,11455,3160,17787
10-04-2019,23 - 00,1224,1913,10938,2948,17023
11-04-2019,00 - 01,1236,1960,10599,2854,16649
11-04-2019,01 - 02,1333,1927,10416,2775,16451
11-04-2019,02 - 03,1354,2029,10266,2770,16419
11-04-2019,03 - 04,1296,2109,10273,2748,16426
11-04-2019,04 - 05,1183,2124,10439,2759,16505
11-04-2019,05 - 06,1282,2164,10902,2937,17285
11-04-2019,06 - 07,1436,2287,11903,3362,18988
11-04-2019,07 - 08,1382,2349,12744,3750,20225
11-04-2019,08 - 09,1443,2344,12833,3833,20453
11-04-2019,09 - 10,1353,2341,12490,3713,19897
11-04-2019,10 - 11,1375,2166,12213,3693,19447
11-04-2019,11 - 12,1274,2025,12024,3582,18905
11-04-2019,12 - 13,1224,2055,12003,3462,18744
11-04-2019,13 - 14,1243,1999,11892,3411,18545
11-04-2019,14 - 15,1159,1975,11699,3335,18168
11-04-2019,15 - 16,1247,1921,11636,3274,18078
11-04-2019,16 - 17,1206,2002,11496,3222,17926
11-04-2019,17 - 18,1183,2041,11696,3187,18107
11-04-2019,18 - 19,1249,2089,11634,3209,18181
11-04-2019,19 - 20,1502,2109,11676,3239,18526
11-04-2019,20 - 21,1435,2143,12074,3322,18974
11-04-2019,21 - 22,1361,2184,11950,3241,18736
11-04-2019,22 - 23,1268,2167,11378,3079,17892
11-04-2019,23 - 00,1250,2027,10817,2928,17022
12-04-2019,00 - 01,1226,1996,10507,2814,16543
12-04-2019,01 - 02,1281,2031,10387,2796,16495
12-04-2019,02 - 03,1330,2040,10471,2786,16627
12-04-2019,03 - 04,1302,2076,10601,2803,16782
12-04-2019,04 - 05,1185,2110,10792,2860,16947
12-04-2019,05 - 06,1133,2185,11349,3081,17748
12-04-2019,06 - 07,1303,2327,12458,3444,19532
12-04-2019,07 - 08,1371,2371,13109,3743,20594
12-04-2019,08 - 09,1276,2273,12844,3761,20154
12-04-2019,09 - 10,1301,2247,12382,3674,19604
12-04-2019,10 - 11,1308,2254,12107,3618,19287
12-04-2019,11 - 12,1343,2194,11696,3516,18749
12-04-2019,12 - 13,1298,2209,11537,3419,18463
12-04-2019,13 - 14,1273,2065,11159,3312,17809
12-04-2019,14 - 15,1210,1965,10783,3204,17162
12-04-2019,15 - 16,1223,1897,10516,3094,16730
12-04-2019,16 - 17,1187,1923,10395,3016,16521
12-04-2019,17 - 18,1229,2000,10512,3063,16804
12-04-2019,18 - 19,1225,2003,10519,3113,16860
12-04-2019,19 - 20,1282,2083,10616,3090,17071
12-04-2019,20 - 21,1265,2102,10871,3153,17391
12-04-2019,21 - 22,1294,2108,10735,3037,17174
12-04-2019,22 - 23,1178,2076,10443,2994,16691
12-04-2019,23 - 00,1105,1985,10101,2863,16054
13-04-2019,00 - 01,1157,1942,9918,2722,15739
13-04-2019,01 - 02,1150,1932,9731,2648,15461
13-04-2019,02 - 03,1177,1955,9685,2622,15439
13-04-2019,03 - 04,1185,1956,9782,2600,15523
13-04-2019,04 - 05,1185,1972,9839,2641,15637
13-04-2019,05 - 06,1179,1967,9914,2732,15792
13-04-2019,06 - 07,1199,2103,9940,2771,16013
13-04-2019,07 - 08,1170,2080,10163,2911,16324
13-04-2019,08 - 09,1198,2044,10398,3048,16688
13-04-2019,09 - 10,1164,2021,10374,3021,16580
13-04-2019,10 - 11,1116,1996,10247,3033,16392
13-04-2019,11 - 12,1166,1870,10135,3032,16203
13-04-2019,12 - 13,1153,1760,10078,2950,15941
13-04-2019,13 - 14,1152,1696,9856,2854,15558
13-04-2019,14 - 15,1104,1634,9634,2734,15106
13-04-2019,15 - 16,1098,1687,9458,2652,14895
13-04-2019,16 - 17,1115,1709,9393,2598,14815
13-04-2019,17 - 18,1187,1795,9602,2650,15234
13-04-2019,18 - 19,1213,1785,9753,2681,15432
13-04-2019,19 - 20,1233,1754,9968,2780,15735
13-04-2019,20 - 21,1228,1909,10295,2912,16344
13-04-2019,21 - 22,1206,1847,10200,2812,16065
13-04-2019,22 - 23,1165,1808,9844,2700,15517
13-04-2019,23 - 00,1183,1807,9553,2587,15130
14-04-2019,00 - 01,1151,1731,9478,2591,14951
14-04-2019,01 - 02,1196,1816,9356,2572,14940
14-04-2019,02 - 03,1185,1828,9351,2576,14940
14-04-2019,03 - 04,1179,1904,9354,2642,15079
14-04-2019,04 - 05,1185,1889,9423,2697,15194
14-04-2019,05 - 06,1158,1953,9401,2719,15231
14-04-2019,06 - 07,1108,1924,9373,2670,15075
14-04-2019,07 - 08,1109,1919,9602,2782,15412
14-04-2019,08 - 09,1174,1928,10018,2850,15970
14-04-2019,09 - 10,1140,1882,10051,2837,15910
14-04-2019,10 - 11,1146,1819,9846,2746,15557
14-04-2019,11 - 12,1097,1815,9910,2697,15519
14-04-2019,12 - 13,1073,1792,10001,2640,15506
14-04-2019,13 - 14,1192,1830,9671,2550,15243
14-04-2019,14 - 15,1176,1807,9569,2455,15007
14-04-2019,15 - 16,1038,1783,9446,2422,14689
14-04-2019,16 - 17,1169,1760,9443,2493,14865
14-04-2019,17 - 18,1168,1890,9694,2562,15314
14-04-2019,18 - 19,1202,1881,9847,2675,15605
14-04-2019,19 - 20,1165,1894,10181,2814,16054
14-04-2019,20 - 21,1130,1911,10619,2902,16562
14-04-2019,21 - 22,1179,1880,10461,2793,16313
14-04-2019,22 - 23,1181,1870,10095,2759,15905
14-04-2019,23 - 00,1143,1832,9781,2692,15448
15-04-2019,00 - 01,1104,1825,9530,2639,15098
15-04-2019,01 - 02,1146,1833,9569,2536,15084
15-04-2019,02 - 03,1136,1841,9673,2585,15235
15-04-2019,03 - 04,1162,1806,9725,2650,15343
15-04-2019,04 - 05,1164,1845,10028,2754,15791
15-04-2019,05 - 06,1134,1950,10548,2950,16582
15-04-2019,06 - 07,1294,2070,11671,3340,18375
15-04-2019,07 - 08,1351,2157,12349,3632,19489
15-04-2019,08 - 09,1368,2149,12237,3708,19462
15-04-2019,09 - 10,1413,2172,11870,3604,19059
15-04-2019,10 - 11,1275,2060,11560,3403,18298
15-04-2019,11 - 12,1220,2002,11358,3206,17786
15-04-2019,12 - 13,1221,2111,11021,3110,17463
15-04-2019,13 - 14,1203,2007,10799,3135,17144
15-04-2019,14 - 15,1141,1877,10638,3066,16722
15-04-2019,15 - 16,1168,1853,10461,2991,16473
15-04-2019,16 - 17,1234,1887,10257,2864,16242
15-04-2019,17 - 18,1186,1930,10309,2874,16299
15-04-2019,18 - 19,1273,1890,10458,2912,16533
15-04-2019,19 - 20,1327,1915,10587,3007,16836
15-04-2019,20 - 21,1216,1905,10811,3113,17045
15-04-2019,21 - 22,1136,1889,10660,3025,16710
15-04-2019,22 - 23,1160,1827,10052,2897,15936
15-04-2019,23 - 00,1169,1819,9600,2740,15328
16-04-2019,00 - 01,1056,1800,9406,2675,14937
16-04-2019,01 - 02,1120,1730,9246,2684,14780
16-04-2019,02 - 03,1163,1719,9355,2617,14854
16-04-2019,03 - 04,1131,1791,9413,2616,14951
16-04-2019,04 - 05,1038,1768,9707,2705,15218
16-04-2019,05 - 06,1123,1842,10074,2965,16004
16-04-2019,06 - 07,1170,1982,10964,3273,17389
16-04-2019,07 - 08,1203,1998,11711,3614,18526
16-04-2019,08 - 09,1188,1990,11867,3671,18716
16-04-2019,09 - 10,1151,1887,11678,3492,18208
16-04-2019,10 - 11,1189,1934,11428,3281,17832
16-04-2019,11 - 12,1216,1933,11120,3118,17387
16-04-2019,12 - 13,1219,1867,10872,3049,17007
16-04-2019,13 - 14,1128,1789,10613,3144,16674
16-04-2019,14 - 15,1167,1796,10533,3055,16551
16-04-2019,15 - 16,1090,1775,10474,2977,16316
16-04-2019,16 - 17,1113,1824,10344,2837,16118
16-04-2019,17 - 18,1150,1802,10411,2863,16226
16-04-2019,18 - 19,1244,1942,10442,2790,16418
16-04-2019,19 - 20,1257,1923,10432,2872,16484
16-04-2019,20 - 21,1220,1986,10587,3054,16847
16-04-2019,21 - 22,1196,1954,10451,2960,16561
16-04-2019,22 - 23,1151,1946,9911,2703,15711
16-04-2019,23 - 00,1094,1828,9485,2440,14847
17-04-2019,00 - 01,1156,1731,9395,2395,14677
17-04-2019,01 - 02,1146,1689,9280,2344,14459
17-04-2019,02 - 03,1134,1784,9323,2362,14603
17-04-2019,03 - 04,1158,1744,9441,2467,14810
17-04-2019,04 - 05,1219,1723,9634,2544,15120
17-04-2019,05 - 06,1214,1842,10026,2748,15830
17-04-2019,06 - 07,1221,1949,10984,3093,17247
17-04-2019,07 - 08,1233,2071,11638,3420,18362
17-04-2019,08 - 09,1199,2084,11591,3517,18391
17-04-2019,09 - 10,1290,2142,11262,3387,18081
17-04-2019,10 - 11,1257,2045,10960,3258,17520
17-04-2019,11 - 12,1277,1962,10832,3109,17180
17-04-2019,12 - 13,1257,1840,10526,2950,16573
17-04-2019,13 - 14,1244,1806,10326,2905,16281
17-04-2019,14 - 15,1219,1763,10115,2870,15967
17-04-2019,15 - 16,1225,1716,10001,2832,15774
17-04-2019,16 - 17,1214,1729,9857,2751,15551
17-04-2019,17 - 18,1201,1733,9918,2751,15603
17-04-2019,18 - 19,1215,1860,9933,2740,15748
17-04-2019,19 - 20,1250,1891,9911,2762,15814
17-04-2019,20 - 21,1270,1851,10083,2802,16006
17-04-2019,21 - 22,1252,1716,9931,2731,15630
17-04-2019,22 - 23,1211,1611,9489,2510,14821
17-04-2019,23 - 00,1150,1671,8997,2350,14168
18-04-2019,00 - 01,1091,1560,8647,2288,13586
18-04-2019,01 - 02,1134,1529,8535,2275,13473
18-04-2019,02 - 03,1147,1598,8520,2270,13535
18-04-2019,03 - 04,1116,1604,8646,2292,13658
18-04-2019,04 - 05,1161,1657,8950,2395,14163
18-04-2019,05 - 06,1158,1721,9397,2543,14819
18-04-2019,06 - 07,1308,1927,10247,2825,16307
18-04-2019,07 - 08,1360,2096,10892,3078,17426
18-04-2019,08 - 09,1310,2062,10801,3163,17336
18-04-2019,09 - 10,1282,1998,10593,3087,16960
18-04-2019,10 - 11,1243,1816,10314,2926,16299
18-04-2019,11 - 12,1227,1652,9959,2793,15631
18-04-2019,12 - 13,1198,1631,9741,2692,15262
18-04-2019,13 - 14,1224,1702,9527,2651,15104
18-04-2019,14 - 15,1140,1659,9215,2573,14587
18-04-2019,15 - 16,1133,1633,9045,2512,14323
18-04-2019,16 - 17,1144,1717,8900,2451,14212
18-04-2019,17 - 18,1131,1755,8940,2461,14287
18-04-2019,18 - 19,1232,1800,9030,2502,14564
18-04-2019,19 - 20,1185,1921,8935,2521,14562
18-04-2019,20 - 21,1130,1999,8992,2555,14676
18-04-2019,21 - 22,1107,1889,8869,2528,14393
18-04-2019,22 - 23,1036,1828,8426,2380,13670
18-04-2019,23 - 00,1111,1819,7990,2232,13152
19-04-2019,00 - 01,1023,1802,7687,2124,12636
19-04-2019,01 - 02,1004,1792,7672,2104,12572
19-04-2019,02 - 03,1027,1875,7630,2108,12640
19-04-2019,03 - 04,979,1901,7704,2163,12747
19-04-2019,04 - 05,1073,1757,7874,2236,12940
19-04-2019,05 - 06,1063,1688,8030,2321,13102
19-04-2019,06 - 07,1082,1839,8326,2403,13650
19-04-2019,07 - 08,1181,1829,8410,2463,13883
19-04-2019,08 - 09,1246,1778,8533,2509,14066
19-04-2019,09 - 10,1105,1847,8647,2510,14109
19-04-2019,10 - 11,1125,1812,8632,2434,14003
19-04-2019,11 - 12,1132,1654,8520,2357,13663
19-04-2019,12 - 13,1120,1666,8439,2323,13548
19-04-2019,13 - 14,1110,1713,8254,2266,13343
19-04-2019,14 - 15,1040,1695,8099,2169,13003
19-04-2019,15 - 16,1100,1694,8017,2174,12985
19-04-2019,16 - 17,1177,1767,8019,2200,13163
19-04-2019,17 - 18,1187,1720,8110,2248,13265
19-04-2019,18 - 19,1121,1755,8064,2247,13187
19-04-2019,19 - 20,1125,1780,8034,2242,13181
19-04-2019,20 - 21,1090,1798,8221,2276,13385
19-04-2019,21 - 22,1060,1799,8312,2311,13482
19-04-2019,22 - 23,1037,1855,8052,2195,13139
19-04-2019,23 - 00,1052,1732,7739,2095,12618
20-04-2019,00 - 01,1089,1703,7545,2007,12344
20-04-2019,01 - 02,1136,1620,7392,1989,12137
20-04-2019,02 - 03,1080,1673,7378,1999,12130
20-04-2019,03 - 04,1018,1716,7464,2064,12262
20-04-2019,04 - 05,1036,1659,7596,2120,12411
20-04-2019,05 - 06,1103,1587,7643,2148,12481
20-04-2019,06 - 07,1099,1629,7681,2151,12560
20-04-2019,07 - 08,1117,1714,7796,2181,12808
20-04-2019,08 - 09,1166,1764,8004,2257,13191
20-04-2019,09 - 10,1172,1746,8161,2291,13370
20-04-2019,10 - 11,1162,1684,8166,2304,13316
20-04-2019,11 - 12,1139,1653,8028,2222,13042
20-04-2019,12 - 13,1059,1577,7827,2179,12642
20-04-2019,13 - 14,1101,1549,7652,2122,12424
20-04-2019,14 - 15,1050,1552,7498,2003,12103
20-04-2019,15 - 16,1054,1641,7370,1955,12020
20-04-2019,16 - 17,1090,1685,7357,1964,12096
20-04-2019,17 - 18,1131,1724,7438,1995,12288
20-04-2019,18 - 19,1181,1753,7474,2035,12443
20-04-2019,19 - 20,1091,1866,7537,2102,12596
20-04-2019,20 - 21,1114,2000,7648,2161,12923
20-04-2019,21 - 22,1158,1869,7768,2108,12903
20-04-2019,22 - 23,1045,1747,7464,2047,12303
20-04-2019,23 - 00,1058,1761,7256,2011,12086
21-04-2019,00 - 01,1060,1707,7169,2030,11966
21-04-2019,01 - 02,1014,1689,7181,1984,11868
21-04-2019,02 - 03,1048,1775,7128,1938,11889
21-04-2019,03 - 04,1046,1721,7234,1913,11914
21-04-2019,04 - 05,1018,1581,7432,1954,11985
21-04-2019,05 - 06,1090,1578,7340,1986,11994
21-04-2019,06 - 07,1064,1631,7301,1997,11993
21-04-2019,07 - 08,1057,1852,7357,2049,12315
21-04-2019,08 - 09,1273,1804,7672,2151,12900
21-04-2019,09 - 10,1150,1763,7918,2217,13048
21-04-2019,10 - 11,1155,1749,7960,2162,13026
21-04-2019,11 - 12,955,1796,7889,2082,12722
21-04-2019,12 - 13,1131,1826,7772,2017,12746
21-04-2019,13 - 14,1194,1679,7588,1994,12455
21-04-2019,14 - 15,1084,1710,7493,1989,12276
21-04-2019,15 - 16,1020,1696,7457,1995,12168
21-04-2019,16 - 17,1065,1705,7459,2022,12251
21-04-2019,17 - 18,1159,1765,7635,2075,12634
21-04-2019,18 - 19,1104,1758,7843,2119,12824
21-04-2019,19 - 20,1059,1795,8004,2185,13043
21-04-2019,20 - 21,1011,1815,8074,2192,13092
21-04-2019,21 - 22,1031,1787,8102,2229,13149
21-04-2019,22 - 23,1058,1577,7724,2141,12500
21-04-2019,23 - 00,1052,1671,7399,2017,12139
22-04-2019,00 - 01,1036,1615,7123,1827,11601
22-04-2019,01 - 02,1085,1578,6938,1713,11314
22-04-2019,02 - 03,1133,1547,6861,1719,11260
22-04-2019,03 - 04,1121,1560,6893,1740,11314
22-04-2019,04 - 05,1062,1500,7049,1842,11453
22-04-2019,05 - 06,998,1457,7108,1894,11457
22-04-2019,06 - 07,1094,1447,7041,1929,11511
22-04-2019,07 - 08,1100,1490,7499,2080,12169
22-04-2019,08 - 09,1158,1343,7845,2207,12553
22-04-2019,09 - 10,1280,1566,8244,2195,13285
22-04-2019,10 - 11,1143,1613,8423,2179,13358
22-04-2019,11 - 12,1100,1623,8343,2192,13258
22-04-2019,12 - 13,1068,1618,8298,2189,13173
22-04-2019,13 - 14,1109,1600,8196,2175,13080
22-04-2019,14 - 15,1047,1548,7979,2115,12689
22-04-2019,15 - 16,1005,1632,7840,2039,12516
22-04-2019,16 - 17,1074,1679,7928,2039,12720
22-04-2019,17 - 18,1140,1735,8012,2063,12950
22-04-2019,18 - 19,1089,1738,8178,2120,13125
22-04-2019,19 - 20,1126,1767,8255,2189,13337
22-04-2019,20 - 21,1023,1667,8244,2242,13176
22-04-2019,21 - 22,1004,1572,8015,2235,12826
22-04-2019,22 - 23,1047,1508,7702,2005,12262
22-04-2019,23 - 00,1028,1589,7517,1906,12040
23-04-2019,00 - 01,964,1590,7375,1892,11821
23-04-2019,01 - 02,1007,1516,7278,1899,11700
23-04-2019,02 - 03,1064,1513,7333,1893,11803
23-04-2019,03 - 04,1208,1516,7345,1939,12008
23-04-2019,04 - 05,1131,1569,7555,1995,12250
23-04-2019,05 - 06,1179,1690,7928,2131,12928
23-04-2019,06 - 07,1152,1788,8865,2380,14185
23-04-2019,07 - 08,1263,1740,9709,2685,15397
23-04-2019,08 - 09,1228,1883,9936,2888,15935
23-04-2019,09 - 10,1252,1988,9847,2842,15929
23-04-2019,10 - 11,1233,1875,9624,2626,15358
23-04-2019,11 - 12,1055,1747,9314,2584,14700
23-04-2019,12 - 13,1188,1530,9157,2549,14424
23-04-2019,13 - 14,1142,1709,9272,2617,14740
23-04-2019,14 - 15,1071,1636,9238,2553,14498
23-04-2019,15 - 16,1152,1662,9172,2516,14502
23-04-2019,16 - 17,1134,1798,9058,2545,14535
23-04-2019,17 - 18,1152,1766,9106,2569,14593
23-04-2019,18 - 19,1104,1872,9009,2583,14568
23-04-2019,19 - 20,1172,1989,9032,2645,14838
23-04-2019,20 - 21,1123,1951,9092,2646,14812
23-04-2019,21 - 22,1051,1815,8853,2586,14305
23-04-2019,22 - 23,993,1735,8505,2407,13640
23-04-2019,23 - 00,921,1607,7868,2244,12640
24-04-2019,00 - 01,994,1589,7421,2127,12131
24-04-2019,01 - 02,992,1588,7199,2092,11871
24-04-2019,02 - 03,1064,1575,7197,2015,11851
24-04-2019,03 - 04,1060,1582,7216,1979,11837
24-04-2019,04 - 05,964,1431,7376,2053,11824
24-04-2019,05 - 06,987,1509,7700,2191,12387
24-04-2019,06 - 07,972,1652,8730,2473,13827
24-04-2019,07 - 08,1117,1686,9592,2827,15222
24-04-2019,08 - 09,1152,1840,9854,2901,15747
24-04-2019,09 - 10,1015,1976,9746,2838,15575
24-04-2019,10 - 11,1023,1792,9592,2821,15228
24-04-2019,11 - 12,1128,1613,9256,2795,14792
24-04-2019,12 - 13,1150,1414,9100,2709,14373
24-04-2019,13 - 14,1015,1447,8966,2683,14111
24-04-2019,14 - 15,1048,1548,9041,2741,14378
24-04-2019,15 - 16,1051,1672,9117,2749,14589
24-04-2019,16 - 17,1080,1711,9028,2668,14487
24-04-2019,17 - 18,1099,1815,9150,2681,14745
24-04-2019,18 - 19,1197,1852,9100,2759,14908
24-04-2019,19 - 20,1172,1794,9169,2793,14928
24-04-2019,20 - 21,1133,1590,9254,2740,14717
24-04-2019,21 - 22,1092,1507,9019,2655,14273
24-04-2019,22 - 23,1107,1435,8452,2524,13518
24-04-2019,23 - 00,1022,1404,7885,2359,12670
25-04-2019,00 - 01,991,1342,7502,2208,12043
25-04-2019,01 - 02,1046,1133,7239,2154,11572
25-04-2019,02 - 03,977,1009,7248,2046,11280
25-04-2019,03 - 04,1056,1407,7263,1995,11721
25-04-2019,04 - 05,1016,1290,7426,2085,11817
25-04-2019,05 - 06,1089,1305,7651,2172,12217
25-04-2019,06 - 07,1147,1447,8690,2545,13829
25-04-2019,07 - 08,1104,1457,9612,2855,15028
25-04-2019,08 - 09,1142,1627,10010,2934,15713
25-04-2019,09 - 10,1162,1766,9884,2930,15742
25-04-2019,10 - 11,1113,1658,9530,2858,15159
25-04-2019,11 - 12,1156,1728,9338,2842,15064
25-04-2019,12 - 13,1131,1684,9317,2815,14947
25-04-2019,13 - 14,1183,1558,9334,2829,14904
25-04-2019,14 - 15,1145,1539,9420,2781,14885
25-04-2019,15 - 16,1086,1551,9420,2737,14794
25-04-2019,16 - 17,1168,1557,9255,2630,14610
25-04-2019,17 - 18,1072,1631,9357,2666,14726
25-04-2019,18 - 19,1295,1676,9237,2625,14833
25-04-2019,19 - 20,1227,1651,9130,2598,14606
25-04-2019,20 - 21,1149,1580,9090,2567,14386
25-04-2019,21 - 22,1137,1514,8968,2528,14147
25-04-2019,22 - 23,977,1447,8467,2338,13229
25-04-2019,23 - 00,1103,1340,7988,2141,12572
26-04-2019,00 - 01,1038,1315,7566,2068,11987
26-04-2019,01 - 02,1011,1264,7275,1974,11524
26-04-2019,02 - 03,1033,1366,7281,1962,11642
26-04-2019,03 - 04,973,1197,7326,2019,11515
26-04-2019,04 - 05,1025,1477,7645,2067,12214
26-04-2019,05 - 06,1090,1528,7964,2174,12756
26-04-2019,06 - 07,1298,1633,8723,2476,14130
26-04-2019,07 - 08,1240,1738,9721,2768,15467
26-04-2019,08 - 09,1294,1847,9983,2936,16060
26-04-2019,09 - 10,1262,1898,9958,2962,16080
26-04-2019,10 - 11,1177,1878,9915,2880,15850
26-04-2019,11 - 12,1110,1796,9636,2822,15364
26-04-2019,12 - 13,1165,1811,9285,2734,14995
26-04-2019,13 - 14,1185,1699,9192,2648,14724
26-04-2019,14 - 15,983,1622,9056,2571,14232
26-04-2019,15 - 16,1121,1601,8944,2560,14226
26-04-2019,16 - 17,1116,1648,8990,2516,14270
26-04-2019,17 - 18,1166,1681,8983,2523,14353
26-04-2019,18 - 19,1116,1678,8817,2487,14098
26-04-2019,19 - 20,1134,1677,8660,2413,13884
26-04-2019,20 - 21,1109,1577,8594,2423,13703
26-04-2019,21 - 22,1154,1518,8452,2360,13484
26-04-2019,22 - 23,915,1636,8091,2154,12796
26-04-2019,23 - 00,1024,1509,7833,1984,12350
27-04-2019,00 - 01,1147,1502,7499,1892,12040
27-04-2019,01 - 02,1125,1547,7195,1806,11673
27-04-2019,02 - 03,1062,1529,7045,1749,11385
27-04-2019,03 - 04,1081,1526,6902,1764,11273
27-04-2019,04 - 05,1152,1521,6915,1725,11313
27-04-2019,05 - 06,1100,1545,6765,1675,11085
27-04-2019,06 - 07,1102,1517,6773,1789,11181
27-04-2019,07 - 08,1145,1581,7132,2074,11932
27-04-2019,08 - 09,1176,1688,7698,2213,12775
27-04-2019,09 - 10,1231,1604,8175,2309,13319
27-04-2019,10 - 11,1317,1618,8278,2413,13626
27-04-2019,11 - 12,1251,1539,8371,2449,13610
27-04-2019,12 - 13,1159,1441,8302,2455,13357
27-04-2019,13 - 14,1039,1511,8232,2433,13215
27-04-2019,14 - 15,1115,1477,8320,2337,13249
27-04-2019,15 - 16,1142,1443,8251,2265,13101
27-04-2019,16 - 17,1117,1510,8307,2286,13220
27-04-2019,17 - 18,1054,1559,8509,2371,13493
27-04-2019,18 - 19,1116,1622,8667,2407,13812
27-04-2019,19 - 20,1134,1575,8582,2369,13660
27-04-2019,20 - 21,1095,1665,8437,2350,13547
27-04-2019,21 - 22,1083,1608,8267,2301,13259
27-04-2019,22 - 23,1020,1531,7935,2191,12677
27-04-2019,23 - 00,1032,1452,7535,2107,12126
28-04-2019,00 - 01,1095,1475,7291,2079,11940
28-04-2019,01 - 02,1118,1636,7120,2003,11877
28-04-2019,02 - 03,1075,1514,6914,1926,11429
28-04-2019,03 - 04,1085,1630,6913,1930,11558
28-04-2019,04 - 05,1056,1584,6847,1938,11425
28-04-2019,05 - 06,1029,1597,6581,1924,11131
28-04-2019,06 - 07,1074,1577,6736,1954,11341
28-04-2019,07 - 08,1129,1723,7042,2134,12028
28-04-2019,08 - 09,1163,1808,7719,2283,12973
28-04-2019,09 - 10,1238,1810,8157,2423,13628
28-04-2019,10 - 11,1267,1798,8378,2464,13907
28-04-2019,11 - 12,1224,1649,8366,2467,13706
28-04-2019,12 - 13,1162,1699,8325,2461,13647
28-04-2019,13 - 14,1195,1734,8183,2485,13597
28-04-2019,14 - 15,1217,1690,8050,2453,13410
28-04-2019,15 - 16,1218,1736,8020,2391,13365
28-04-2019,16 - 17,1274,1755,8189,2381,13599
28-04-2019,17 - 18,1259,1785,8380,2475,13899
28-04-2019,18 - 19,1195,1818,8649,2526,14188
28-04-2019,19 - 20,1141,1821,8868,2522,14352
28-04-2019,20 - 21,1212,1817,9043,2570,14642
28-04-2019,21 - 22,1111,1839,9053,2588,14591
28-04-2019,22 - 23,1094,1818,8526,2417,13855
28-04-2019,23 - 00,1096,1760,8072,2224,13152
29-04-2019,00 - 01,1086,1693,7876,2052,12707
29-04-2019,01 - 02,1116,1671,7766,2064,12617
29-04-2019,02 - 03,1040,1708,7857,2051,12656
29-04-2019,03 - 04,1009,1583,7927,2059,12578
29-04-2019,04 - 05,1030,1675,8044,2164,12913
29-04-2019,05 - 06,1130,1782,8333,2246,13491
29-04-2019,06 - 07,1301,1848,9267,2608,15024
29-04-2019,07 - 08,1075,1911,10159,3006,16151
29-04-2019,08 - 09,1022,1915,10227,3090,16254
29-04-2019,09 - 10,1185,1920,10082,2970,16157
29-04-2019,10 - 11,1129,1907,9953,2749,15738
29-04-2019,11 - 12,1188,1902,9777,2738,15605
29-04-2019,12 - 13,1203,1912,9608,2713,15436
29-04-2019,13 - 14,1168,1789,9541,2754,15252
29-04-2019,14 - 15,1101,1708,9407,2752,14968
29-04-2019,15 - 16,1036,1774,9391,2630,14831
29-04-2019,16 - 17,1072,1752,9274,2546,14644
29-04-2019,17 - 18,1118,1695,9344,2602,14759
29-04-2019,18 - 19,1054,1735,9269,2540,14598
29-04-2019,19 - 20,1123,1855,9224,2534,14736
29-04-2019,20 - 21,1151,1752,9236,2521,14660
29-04-2019,21 - 22,1098,1779,9156,2548,14581
29-04-2019,22 - 23,1105,1787,8678,2412,13982
29-04-2019,23 - 00,1134,1716,8241,2282,13373
30-04-2019,00 - 01,1081,1560,7880,2180,12701
30-04-2019,01 - 02,978,1519,7682,2140,12319
30-04-2019,02 - 03,1027,1558,7616,2104,12305
30-04-2019,03 - 04,1000,1477,7603,2130,12210
30-04-2019,04 - 05,992,1465,7603,2204,12264
30-04-2019,05 - 06,1057,1538,7739,2308,12642
30-04-2019,06 - 07,957,1590,8716,2602,13865
30-04-2019,07 - 08,986,1890,9585,2843,15304
30-04-2019,08 - 09,1102,1978,9870,2883,15833
30-04-2019,09 - 10,1101,1949,9823,2865,15738
30-04-2019,10 - 11,1078,1861,9751,2856,15546
30-04-2019,11 - 12,971,1825,9683,2811,15290
30-04-2019,12 - 13,895,1809,9559,2757,15020
30-04-2019,13 - 14,955,1747,9535,2727,14964
30-04-2019,14 - 15,988,1716,9493,2676,14873
30-04-2019,15 - 16,1013,1658,9441,2622,14734
30-04-2019,16 - 17,1027,1687,9330,2516,14560
30-04-2019,17 - 18,1089,1681,9485,2525,14780
30-04-2019,18 - 19,1016,1672,9334,2465,14487
30-04-2019,19 - 20,1070,1606,8933,2379,13988
30-04-2019,20 - 21,1007,1409,8725,2342,13483
30-04-2019,21 - 22,900,1425,8749,2389,13463
30-04-2019,22 - 23,774,1568,8347,2239,12928
30-04-2019,23 - 00,715,1437,7881,2077,12110
01-05-2019,00 - 01,1076,1503,7535,1958,12072
01-05-2019,01 - 02,986,1575,7336,1880,11777
01-05-2019,02 - 03,1069,1466,7212,1861,11608
01-05-2019,03 - 04,1026,1358,7168,1865,11417
01-05-2019,04 - 05,1022,1344,7259,1862,11487
01-05-2019,05 - 06,1044,1320,7115,1825,11304
01-05-2019,06 - 07,989,1422,7137,1829,11377
01-05-2019,07 - 08,839,1671,7412,1961,11883
01-05-2019,08 - 09,934,1929,7864,2156,12883
01-05-2019,09 - 10,876,1904,8285,2271,13336
01-05-2019,10 - 11,1129,1998,8580,2348,14055
01-05-2019,11 - 12,1115,2033,8714,2459,14321
01-05-2019,12 - 13,1162,1940,8674,2485,14261
01-05-2019,13 - 14,995,1926,8470,2425,13816
01-05-2019,14 - 15,1126,1909,8318,2367,13720
01-05-2019,15 - 16,1123,1868,8304,2348,13643
01-05-2019,16 - 17,1178,1911,8342,2287,13718
01-05-2019,17 - 18,1188,1946,8501,2281,13916
01-05-2019,18 - 19,1210,1986,8728,2245,14169
01-05-2019,19 - 20,1247,2089,8682,2414,14432
01-05-2019,20 - 21,1150,2066,8669,2494,14379
01-05-2019,21 - 22,1173,2027,8613,2413,14226
01-05-2019,22 - 23,971,1974,8174,2232,13351
01-05-2019,23 - 00,1018,1921,7889,2103,12931
02-05-2019,00 - 01,1126,1854,7765,2026,12771
02-05-2019,01 - 02,1127,1939,7724,1995,12785
02-05-2019,02 - 03,1137,1840,7617,1939,12533
02-05-2019,03 - 04,1090,1673,7569,1955,12287
02-05-2019,04 - 05,1096,1575,7547,2037,12255
02-05-2019,05 - 06,1222,1636,7811,2158,12827
02-05-2019,06 - 07,1243,1807,8944,2549,14543
02-05-2019,07 - 08,1266,1958,10040,2873,16137
02-05-2019,08 - 09,1215,2043,10402,2963,16623
02-05-2019,09 - 10,1277,2072,10546,2909,16804
02-05-2019,10 - 11,1158,1995,10678,3040,16871
02-05-2019,11 - 12,1203,1899,10637,2964,16703
02-05-2019,12 - 13,1172,2033,10503,3047,16755
02-05-2019,13 - 14,1239,1888,10298,2946,16371
02-05-2019,14 - 15,1200,1977,10165,2789,16131
02-05-2019,15 - 16,1240,2075,10136,2653,16104
02-05-2019,16 - 17,1201,2161,10388,2577,16327
02-05-2019,17 - 18,1159,2201,10559,2716,16635
02-05-2019,18 - 19,1180,1998,10566,2764,16508
02-05-2019,19 - 20,1207,1922,10466,2787,16382
02-05-2019,20 - 21,1191,1907,10455,2742,16295
02-05-2019,21 - 22,1188,1897,10300,2716,16101
02-05-2019,22 - 23,1106,1827,9722,2534,15189
02-05-2019,23 - 00,955,1647,9102,2394,14098
03-05-2019,00 - 01,982,1602,8754,2182,13520
03-05-2019,01 - 02,1040,1727,8658,2090,13515
03-05-2019,02 - 03,985,1813,8630,2154,13582
03-05-2019,03 - 04,1076,1685,8708,2228,13697
03-05-2019,04 - 05,1013,1745,8816,2376,13950
03-05-2019,05 - 06,987,1892,9045,2469,14393
03-05-2019,06 - 07,1125,2064,10226,2681,16096
03-05-2019,07 - 08,1343,2157,11036,2952,17488
03-05-2019,08 - 09,1366,1941,11082,2988,17377
03-05-2019,09 - 10,1313,1915,10893,2890,17011
03-05-2019,10 - 11,1257,1950,10806,2827,16840
03-05-2019,11 - 12,1223,1985,10701,2810,16719
03-05-2019,12 - 13,1221,2052,10582,2773,16628
03-05-2019,13 - 14,1228,2019,10355,2672,16274
03-05-2019,14 - 15,1217,1844,10084,2607,15752
03-05-2019,15 - 16,1183,1853,9969,2665,15670
03-05-2019,16 - 17,1204,1851,9812,2686,15553
03-05-2019,17 - 18,1186,1794,9829,2660,15469
03-05-2019,18 - 19,1232,1732,9879,2596,15439
03-05-2019,19 - 20,1191,1704,9758,2706,15359
03-05-2019,20 - 21,1221,1673,9718,2703,15315
03-05-2019,21 - 22,1165,1781,9672,2550,15168
03-05-2019,22 - 23,1004,1704,9346,2354,14408
03-05-2019,23 - 00,880,1742,8961,2298,13881
04-05-2019,00 - 01,1119,1597,8736,2168,13620
04-05-2019,01 - 02,1122,1659,8569,2139,13489
04-05-2019,02 - 03,1144,1670,8539,2071,13424
04-05-2019,03 - 04,1111,1593,8507,2088,13299
04-05-2019,04 - 05,1112,1577,8480,2106,13275
04-05-2019,05 - 06,1161,1510,8279,2093,13043
04-05-2019,06 - 07,1178,1523,8426,2161,13288
04-05-2019,07 - 08,1146,1654,8854,2290,13944
04-05-2019,08 - 09,1045,1777,9298,2404,14524
04-05-2019,09 - 10,1098,1906,9494,2433,14931
04-05-2019,10 - 11,1096,1830,9609,2468,15003
04-05-2019,11 - 12,1047,1794,9642,2446,14929
04-05-2019,12 - 13,1043,1757,9537,2413,14750
04-05-2019,13 - 14,1052,1700,9334,2389,14475
04-05-2019,14 - 15,1042,1742,9134,2357,14275
04-05-2019,15 - 16,1079,1871,9089,2292,14331
04-05-2019,16 - 17,1083,1778,9125,2265,14251
04-05-2019,17 - 18,1068,1915,9153,2303,14439
04-05-2019,18 - 19,1127,1888,9177,2352,14544
04-05-2019,19 - 20,1112,1990,9136,2335,14573
04-05-2019,20 - 21,1188,1912,9275,2389,14764
04-05-2019,21 - 22,1158,2007,9483,2403,15051
04-05-2019,22 - 23,1029,1990,9314,2319,14652
04-05-2019,23 - 00,1019,1796,8941,2200,13956
05-05-2019,00 - 01,911,1816,8724,2133,13584
05-05-2019,01 - 02,1013,1791,8556,2138,13498
05-05-2019,02 - 03,986,1817,8511,2149,13463
05-05-2019,03 - 04,979,1733,8609,2191,13512
05-05-2019,04 - 05,941,1620,8604,2292,13457
05-05-2019,05 - 06,950,1639,8448,2218,13255
05-05-2019,06 - 07,1035,1565,8387,2150,13137
05-05-2019,07 - 08,1055,1614,8438,2149,13256
05-05-2019,08 - 09,1050,1728,8657,2223,13658
05-05-2019,09 - 10,1029,1684,8793,2257,13763
05-05-2019,10 - 11,998,1707,8967,2262,13934
05-05-2019,11 - 12,1003,1752,8912,2267,13934
05-05-2019,12 - 13,1060,1586,8799,2198,13643
05-05-2019,13 - 14,981,1689,8752,2165,13587
05-05-2019,14 - 15,988,1653,8766,2123,13530
05-05-2019,15 - 16,1109,1809,8662,2096,13676
05-05-2019,16 - 17,1090,1774,8613,2120,13597
05-05-2019,17 - 18,1065,1753,8783,2196,13797
05-05-2019,18 - 19,1061,1789,9005,2151,14006
05-05-2019,19 - 20,1028,1805,9059,2299,14191
05-05-2019,20 - 21,1086,1830,9126,2339,14381
05-05-2019,21 - 22,1006,1854,9019,2381,14260
05-05-2019,22 - 23,1060,1881,8677,2302,13920
05-05-2019,23 - 00,1023,1794,8268,2088,13173
06-05-2019,00 - 01,1044,1717,8226,2092,13079
06-05-2019,01 - 02,1032,1769,8179,2083,13063
06-05-2019,02 - 03,1027,1806,8208,2103,13144
06-05-2019,03 - 04,978,1759,8304,2138,13179
06-05-2019,04 - 05,1008,1769,8326,2227,13330
06-05-2019,05 - 06,1004,1744,8733,2317,13798
06-05-2019,06 - 07,1152,1902,9770,2682,15506
06-05-2019,07 - 08,1316,1976,10613,3125,17030
06-05-2019,08 - 09,1195,1986,10770,3111,17062
06-05-2019,09 - 10,1178,1918,10605,2997,16698
06-05-2019,10 - 11,1175,1954,10558,2993,16680
06-05-2019,11 - 12,1174,1925,10534,2955,16588
06-05-2019,12 - 13,1088,2030,10390,2943,16451
06-05-2019,13 - 14,1150,2026,10301,2941,16418
06-05-2019,14 - 15,1123,1869,10260,2935,16187
06-05-2019,15 - 16,1138,1776,10196,2956,16066
06-05-2019,16 - 17,1087,1932,10223,2840,16082
06-05-2019,17 - 18,1148,1898,10417,2905,16368
06-05-2019,18 - 19,1158,1864,10340,2755,16117
06-05-2019,19 - 20,1129,1919,10203,2784,16035
06-05-2019,20 - 21,1087,1803,10174,2853,15917
06-05-2019,21 - 22,1048,1824,10199,2751,15822
06-05-2019,22 - 23,1066,1893,9683,2643,15285
06-05-2019,23 - 00,994,1817,9175,2439,14425
07-05-2019,00 - 01,875,1752,8912,2393,13932
07-05-2019,01 - 02,1072,1837,8715,2393,14017
07-05-2019,02 - 03,1069,1719,8806,2375,13969
07-05-2019,03 - 04,1012,1712,8787,2412,13923
07-05-2019,04 - 05,1050,1558,8816,2412,13836
07-05-2019,05 - 06,1028,1766,9098,2511,14403
07-05-2019,06 - 07,1329,1911,10177,2845,16262
07-05-2019,07 - 08,1251,1949,10989,3103,17292
07-05-2019,08 - 09,1287,1940,11084,3097,17408
07-05-2019,09 - 10,1218,1901,10997,3069,17185
07-05-2019,10 - 11,1166,1844,11110,3120,17240
07-05-2019,11 - 12,1081,1903,10899,3124,17007
07-05-2019,12 - 13,1095,1860,10803,3029,16787
07-05-2019,13 - 14,1069,1804,10610,2999,16482
07-05-2019,14 - 15,1076,1928,10561,3029,16594
07-05-2019,15 - 16,986,1793,10486,2988,16253
07-05-2019,16 - 17,1114,1737,10399,2973,16223
07-05-2019,17 - 18,1212,1905,10312,3017,16446
07-05-2019,18 - 19,1074,1928,10139,2967,16108
07-05-2019,19 - 20,1093,1968,10222,2960,16243
07-05-2019,20 - 21,1071,1954,10424,2932,16381
07-05-2019,21 - 22,1018,1832,10367,2804,16021
07-05-2019,22 - 23,1041,1771,9720,2754,15286
07-05-2019,23 - 00,1119,1648,9184,2591,14542
08-05-2019,00 - 01,1068,1657,8729,2433,13887
08-05-2019,01 - 02,1055,1617,8628,2389,13689
08-05-2019,02 - 03,1044,1730,8702,2406,13882
08-05-2019,03 - 04,1036,1803,8800,2417,14056
08-05-2019,04 - 05,1129,1689,8870,2460,14148
08-05-2019,05 - 06,983,1791,9105,2482,14361
08-05-2019,06 - 07,1200,1961,10209,2819,16189
08-05-2019,07 - 08,1160,2102,10895,3223,17380
08-05-2019,08 - 09,1075,2070,10877,3291,17313
08-05-2019,09 - 10,1160,1988,10667,3123,16938
08-05-2019,10 - 11,1162,2040,10553,3103,16858
08-05-2019,11 - 12,1110,1973,10572,3000,16655
08-05-2019,12 - 13,1061,1843,10439,2912,16255
08-05-2019,13 - 14,1072,1831,10374,2884,16161
08-05-2019,14 - 15,1107,1795,10345,2787,16034
08-05-2019,15 - 16,964,1845,10240,2739,15788
08-05-2019,16 - 17,1042,1795,10084,2722,15643
08-05-2019,17 - 18,1267,1929,10145,2768,16109
08-05-2019,18 - 19,1337,1940,10053,2706,16036
08-05-2019,19 - 20,1136,1912,10152,2815,16015
08-05-2019,20 - 21,1147,1921,10128,2791,15987
08-05-2019,21 - 22,1202,1891,9999,2809,15901
08-05-2019,22 - 23,1085,1888,9555,2680,15208
08-05-2019,23 - 00,1105,1687,8942,2440,14174
09-05-2019,00 - 01,1046,1696,8510,2281,13533
09-05-2019,01 - 02,960,1712,8304,2191,13167
09-05-2019,02 - 03,989,1778,8252,2217,13236
09-05-2019,03 - 04,1024,1620,8154,2293,13091
09-05-2019,04 - 05,1038,1545,8172,2369,13124
09-05-2019,05 - 06,1008,1631,8330,2424,13393
09-05-2019,06 - 07,1064,1826,9392,2751,15033
09-05-2019,07 - 08,1082,1863,10393,3068,16406
09-05-2019,08 - 09,1057,1935,10577,3120,16689
09-05-2019,09 - 10,1167,1885,10563,3208,16823
09-05-2019,10 - 11,1143,1922,10587,3282,16934
09-05-2019,11 - 12,1058,1926,10477,3302,16763
09-05-2019,12 - 13,1048,1807,10432,3284,16571
09-05-2019,13 - 14,1078,1710,10293,3269,16350
09-05-2019,14 - 15,1096,1709,10203,3174,16182
09-05-2019,15 - 16,1101,1772,10127,3082,16082
09-05-2019,16 - 17,1096,1810,10232,3028,16166
09-05-2019,17 - 18,1024,1889,10230,3031,16174
09-05-2019,18 - 19,1039,1739,10090,2996,15864
09-05-2019,19 - 20,1153,1736,10070,2960,15919
09-05-2019,20 - 21,1119,1639,10002,2829,15589
09-05-2019,21 - 22,966,1661,9872,2786,15285
09-05-2019,22 - 23,909,1563,9320,2623,14415
09-05-2019,23 - 00,913,1524,8803,2460,13700
10-05-2019,00 - 01,888,1540,8378,2352,13158
10-05-2019,01 - 02,931,1610,8106,2296,12943
10-05-2019,02 - 03,903,1511,7975,2265,12654
10-05-2019,03 - 04,846,1501,7887,2246,12480
10-05-2019,04 - 05,903,1573,7947,2255,12678
10-05-2019,05 - 06,1028,1561,8207,2364,13160
10-05-2019,06 - 07,1169,1803,9214,2680,14866
10-05-2019,07 - 08,1298,2007,10127,3003,16435
10-05-2019,08 - 09,1137,1988,10340,3063,16528
10-05-2019,09 - 10,1050,1899,10280,3023,16252
10-05-2019,10 - 11,896,1819,10211,2966,15892
10-05-2019,11 - 12,912,1704,10129,2910,15655
10-05-2019,12 - 13,1013,1626,9945,2808,15392
10-05-2019,13 - 14,1039,1751,9659,2752,15201
10-05-2019,14 - 15,1029,1805,9499,2650,14983
10-05-2019,15 - 16,989,1728,9332,2610,14659
10-05-2019,16 - 17,1013,1766,9269,2586,14634
10-05-2019,17 - 18,934,1804,9410,2591,14739
10-05-2019,18 - 19,902,1769,9247,2580,14498
10-05-2019,19 - 20,957,1711,9058,2528,14254
10-05-2019,20 - 21,1083,1730,8807,2512,14132
10-05-2019,21 - 22,1099,1631,8800,2489,14019
10-05-2019,22 - 23,1017,1653,8561,2440,13671
10-05-2019,23 - 00,1043,1591,8167,2306,13107
11-05-2019,00 - 01,1002,1574,7821,2148,12545
11-05-2019,01 - 02,973,1581,7576,2021,12151
11-05-2019,02 - 03,960,1568,7506,2023,12057
11-05-2019,03 - 04,955,1577,7460,1993,11985
11-05-2019,04 - 05,958,1552,7342,2037,11889
11-05-2019,05 - 06,938,1467,7294,2040,11739
11-05-2019,06 - 07,949,1395,7627,2128,12099
11-05-2019,07 - 08,1023,1468,7929,2268,12688
11-05-2019,08 - 09,1030,1608,8252,2368,13258
11-05-2019,09 - 10,1048,1693,8580,2441,13762
11-05-2019,10 - 11,1064,1622,8634,2417,13737
11-05-2019,11 - 12,1030,1587,8622,2375,13614
11-05-2019,12 - 13,1061,1563,8533,2306,13463
11-05-2019,13 - 14,1031,1600,8330,2220,13181
11-05-2019,14 - 15,940,1584,8166,2169,12859
11-05-2019,15 - 16,862,1511,8089,2141,12603
11-05-2019,16 - 17,1037,1600,8173,2119,12929
11-05-2019,17 - 18,1019,1600,8275,2164,13058
11-05-2019,18 - 19,1040,1543,8295,2200,13078
11-05-2019,19 - 20,982,1515,8200,2212,12909
11-05-2019,20 - 21,986,1473,8218,2236,12913
11-05-2019,21 - 22,999,1563,8262,2282,13106
11-05-2019,22 - 23,982,1501,8100,2226,12809
11-05-2019,23 - 00,896,1423,7772,2100,12191
12-05-2019,00 - 01,890,1516,7497,2033,11936
12-05-2019,01 - 02,890,1412,7408,1977,11687
12-05-2019,02 - 03,948,1369,7483,2003,11803
12-05-2019,03 - 04,889,1273,7469,1991,11622
12-05-2019,04 - 05,880,1370,7372,2036,11658
12-05-2019,05 - 06,908,1379,7377,1997,11661
12-05-2019,06 - 07,948,1410,7482,2029,11869
12-05-2019,07 - 08,985,1445,7703,2085,12218
12-05-2019,08 - 09,993,1563,8118,2166,12840
12-05-2019,09 - 10,1029,1681,8598,2255,13563
12-05-2019,10 - 11,1071,1727,8878,2188,13864
12-05-2019,11 - 12,1089,1729,8935,2235,13988
12-05-2019,12 - 13,1106,1771,8943,2280,14100
12-05-2019,13 - 14,1073,1718,8845,2259,13895
12-05-2019,14 - 15,1074,1718,8782,2223,13797
12-05-2019,15 - 16,1115,1764,8638,2219,13736
12-05-2019,16 - 17,1139,1765,8610,2246,13760
12-05-2019,17 - 18,1074,1819,8862,2335,14090
12-05-2019,18 - 19,1050,1876,8958,2399,14283
12-05-2019,19 - 20,1077,1864,9011,2400,14352
12-05-2019,20 - 21,1058,1917,9067,2513,14555
12-05-2019,21 - 22,1102,1891,9098,2556,14647
12-05-2019,22 - 23,1126,1790,8693,2525,14134
12-05-2019,23 - 00,1106,1786,8132,2353,13377
13-05-2019,00 - 01,1084,1566,7872,2150,12672
13-05-2019,01 - 02,1036,1621,7945,2145,12747
13-05-2019,02 - 03,1061,1662,8010,2147,12880
13-05-2019,03 - 04,1124,1616,8005,2144,12889
13-05-2019,04 - 05,1093,1642,7943,2119,12797
13-05-2019,05 - 06,1047,1704,8226,2218,13195
13-05-2019,06 - 07,1065,2017,9391,2590,15063
13-05-2019,07 - 08,1164,1961,10450,3003,16578
13-05-2019,08 - 09,1263,2051,10643,3022,16979
13-05-2019,09 - 10,1239,1933,10460,2877,16509
13-05-2019,10 - 11,1217,1958,10305,2851,16331
13-05-2019,11 - 12,1146,1885,10215,2901,16147
13-05-2019,12 - 13,1101,1881,10034,2841,15857
13-05-2019,13 - 14,1117,1872,9932,2718,15639
13-05-2019,14 - 15,1102,1853,9856,2637,15448
13-05-2019,15 - 16,977,1882,9675,2623,15157
13-05-2019,16 - 17,1048,1773,9753,2628,15202
13-05-2019,17 - 18,1119,1705,9768,2631,15223
13-05-2019,18 - 19,1138,1600,9636,2611,14985
13-05-2019,19 - 20,1025,1744,9565,2620,14954
13-05-2019,20 - 21,1085,1789,9571,2601,15046
13-05-2019,21 - 22,1143,1708,9567,2568,14986
13-05-2019,22 - 23,1132,1639,9343,2536,14650
13-05-2019,23 - 00,1071,1661,8747,2420,13899
14-05-2019,00 - 01,980,1637,8481,2284,13382
14-05-2019,01 - 02,998,1684,8247,2232,13161
14-05-2019,02 - 03,964,1705,8334,2285,13288
14-05-2019,03 - 04,1011,1610,8429,2352,13402
14-05-2019,04 - 05,981,1608,8510,2376,13475
14-05-2019,05 - 06,1074,1639,8716,2458,13887
14-05-2019,06 - 07,1118,1801,9641,2698,15258
14-05-2019,07 - 08,1208,1811,10302,2957,16278
14-05-2019,08 - 09,1167,1756,10113,2981,16017
14-05-2019,09 - 10,1172,1683,9909,2906,15670
14-05-2019,10 - 11,1190,1563,9883,2891,15527
14-05-2019,11 - 12,1163,1594,9822,2850,15429
14-05-2019,12 - 13,1195,1637,9694,2784,15310
14-05-2019,13 - 14,1010,1685,9588,2753,15036
14-05-2019,14 - 15,917,1634,9485,2708,14744
14-05-2019,15 - 16,1118,1647,9421,2657,14843
14-05-2019,16 - 17,1139,1727,9440,2636,14942
14-05-2019,17 - 18,1055,1785,9392,2677,14909
14-05-2019,18 - 19,1029,1680,9298,2655,14662
14-05-2019,19 - 20,1042,1711,9325,2671,14749
14-05-2019,20 - 21,942,1702,9177,2639,14460
14-05-2019,21 - 22,1014,1637,9216,2594,14461
14-05-2019,22 - 23,964,1626,8902,2494,13986
14-05-2019,23 - 00,928,1598,8344,2313,13183
15-05-2019,00 - 01,1043,1558,8056,2227,12884
15-05-2019,01 - 02,1021,1488,7934,2215,12658
15-05-2019,02 - 03,999,1510,7927,2225,12661
15-05-2019,03 - 04,1064,1482,8080,2236,12862
15-05-2019,04 - 05,1044,1471,8076,2213,12804
15-05-2019,05 - 06,1022,1453,8367,2237,13079
15-05-2019,06 - 07,1076,1681,9286,2565,14608
15-05-2019,07 - 08,1124,1811,10028,2873,15836
15-05-2019,08 - 09,997,1804,10201,2956,15958
15-05-2019,09 - 10,937,1714,10127,2886,15664
15-05-2019,10 - 11,977,1680,9923,2827,15407
15-05-2019,11 - 12,980,1631,9822,2848,15281
15-05-2019,12 - 13,1020,1649,9685,2753,15107
15-05-2019,13 - 14,1001,1662,9503,2706,14872
15-05-2019,14 - 15,956,1585,9413,2625,14579
15-05-2019,15 - 16,997,1595,9348,2623,14563
15-05-2019,16 - 17,991,1475,9227,2593,14286
15-05-2019,17 - 18,978,1549,9357,2618,14502
15-05-2019,18 - 19,1056,1538,9222,2542,14358
15-05-2019,19 - 20,932,1532,9186,2564,14214
15-05-2019,20 - 21,893,1483,9192,2556,14124
15-05-2019,21 - 22,857,1441,9158,2558,14014
15-05-2019,22 - 23,800,1515,8919,2498,13732
15-05-2019,23 - 00,838,1490,8411,2301,13040
16-05-2019,00 - 01,1031,1404,8016,2193,12644
16-05-2019,01 - 02,1064,1369,7840,2138,12411
16-05-2019,02 - 03,1039,1387,7813,2074,12313
16-05-2019,03 - 04,976,1335,7919,2044,12274
16-05-2019,04 - 05,1023,1346,7859,2090,12318
16-05-2019,05 - 06,986,1291,8116,2191,12584
16-05-2019,06 - 07,1073,1530,8918,2616,14137
16-05-2019,07 - 08,1123,1706,9625,3041,15495
16-05-2019,08 - 09,1082,1643,10124,3083,15932
16-05-2019,09 - 10,1092,1562,9572,2931,15157
16-05-2019,10 - 11,1062,1565,9343,2738,14708
16-05-2019,11 - 12,1091,1454,9357,2675,14577
16-05-2019,12 - 13,1014,1371,9361,2665,14411
16-05-2019,13 - 14,994,1406,9303,2689,14392
16-05-2019,14 - 15,924,1465,9138,2659,14186
16-05-2019,15 - 16,942,1410,9142,2598,14092
16-05-2019,16 - 17,1006,1446,9382,2569,14403
16-05-2019,17 - 18,1017,1457,9386,2621,14481
16-05-2019,18 - 19,987,1478,8976,2550,13991
16-05-2019,19 - 20,1025,1510,8911,2570,14016
16-05-2019,20 - 21,1054,1487,8938,2623,14102
16-05-2019,21 - 22,1004,1352,8725,2566,13647
16-05-2019,22 - 23,970,1361,8410,2403,13144
16-05-2019,23 - 00,1001,1398,8014,2267,12680
17-05-2019,00 - 01,998,1317,7500,2136,11951
17-05-2019,01 - 02,862,1345,7373,2052,11632
17-05-2019,02 - 03,932,1349,7421,2041,11743
17-05-2019,03 - 04,898,1327,7519,2078,11822
17-05-2019,04 - 05,966,1472,7461,2115,12014
17-05-2019,05 - 06,890,1378,7625,2238,12131
17-05-2019,06 - 07,983,1542,8550,2686,13761
17-05-2019,07 - 08,1023,1680,9411,3028,15142
17-05-2019,08 - 09,1112,1573,9519,3062,15266
17-05-2019,09 - 10,1065,1726,9424,3072,15287
17-05-2019,10 - 11,1055,1679,9342,3103,15179
17-05-2019,11 - 12,1033,1607,9200,3020,14860
17-05-2019,12 - 13,1081,1531,9096,2889,14597
17-05-2019,13 - 14,1027,1573,8925,2854,14379
17-05-2019,14 - 15,982,1422,8767,2918,14089
17-05-2019,15 - 16,962,1487,8639,2863,13951
17-05-2019,16 - 17,936,1500,8601,2739,13776
17-05-2019,17 - 18,1001,1461,8741,2733,13936
17-05-2019,18 - 19,856,1381,8838,2744,13819
17-05-2019,19 - 20,915,1470,8645,2680,13710
17-05-2019,20 - 21,912,1451,8531,2647,13541
17-05-2019,21 - 22,893,1447,8310,2599,13249
17-05-2019,22 - 23,831,1478,7856,2520,12685
17-05-2019,23 - 00,872,1385,7471,2379,12107
18-05-2019,00 - 01,858,1345,7121,2139,11463
18-05-2019,01 - 02,884,1336,6874,2080,11174
18-05-2019,02 - 03,934,1273,6741,2045,10993
18-05-2019,03 - 04,931,1199,6665,2041,10836
18-05-2019,04 - 05,898,1262,6529,2015,10704
18-05-2019,05 - 06,864,1272,6511,1979,10626
18-05-2019,06 - 07,898,1327,6786,2018,11029
18-05-2019,07 - 08,927,1393,7177,2137,11634
18-05-2019,08 - 09,955,1493,7688,2249,12385
18-05-2019,09 - 10,1001,1449,8138,2343,12931
18-05-2019,10 - 11,958,1432,8352,2393,13135
18-05-2019,11 - 12,954,1377,8288,2366,12985
18-05-2019,12 - 13,983,1358,8180,2293,12814
18-05-2019,13 - 14,976,1437,8077,2257,12747
18-05-2019,14 - 15,935,1426,7989,2210,12560
18-05-2019,15 - 16,928,1375,7871,2167,12341
18-05-2019,16 - 17,938,1394,7906,2107,12345
18-05-2019,17 - 18,927,1558,8022,2163,12670
18-05-2019,18 - 19,966,1516,8051,2236,12769
18-05-2019,19 - 20,957,1501,7952,2217,12627
18-05-2019,20 - 21,902,1489,7841,2230,12462
18-05-2019,21 - 22,808,1450,7744,2219,12221
18-05-2019,22 - 23,925,1447,7515,2132,12019
18-05-2019,23 - 00,964,1362,7145,1961,11432
19-05-2019,00 - 01,890,1636,6938,1895,11359
19-05-2019,01 - 02,822,1553,6738,1812,10925
19-05-2019,02 - 03,817,1521,6451,1728,10517
19-05-2019,03 - 04,825,1387,6382,1664,10258
19-05-2019,04 - 05,872,1392,6185,1635,10084
19-05-2019,05 - 06,914,1314,6110,1620,9958
19-05-2019,06 - 07,867,1216,6398,1675,10156
19-05-2019,07 - 08,859,1308,6859,1757,10783
19-05-2019,08 - 09,892,1409,7326,1923,11550
19-05-2019,09 - 10,929,1432,7689,2020,12070
19-05-2019,10 - 11,952,1424,7950,2105,12431
19-05-2019,11 - 12,969,1411,8188,2130,12698
19-05-2019,12 - 13,930,1417,8284,2133,12764
19-05-2019,13 - 14,969,1367,8199,2126,12661
19-05-2019,14 - 15,955,1379,8079,2059,12472
19-05-2019,15 - 16,975,1422,8012,2061,12470
19-05-2019,16 - 17,971,1442,8086,2125,12624
19-05-2019,17 - 18,947,1482,8151,2152,12732
19-05-2019,18 - 19,901,1444,8217,2134,12696
19-05-2019,19 - 20,914,1393,8232,2177,12716
19-05-2019,20 - 21,912,1493,8072,2198,12675
19-05-2019,21 - 22,857,1538,7936,2221,12552
19-05-2019,22 - 23,869,1429,7675,2123,12096
19-05-2019,23 - 00,937,1362,7183,1917,11399
20-05-2019,00 - 01,962,1490,6890,1820,11162
20-05-2019,01 - 02,935,1416,6731,1804,10886
20-05-2019,02 - 03,871,1351,6691,1777,10690
20-05-2019,03 - 04,716,1278,6644,1800,10438
20-05-2019,04 - 05,833,1154,6557,1836,10380
20-05-2019,05 - 06,846,1263,6900,1918,10927
20-05-2019,06 - 07,888,1394,7950,2317,12549
20-05-2019,07 - 08,969,1539,8915,2674,14097
20-05-2019,08 - 09,1023,1701,9370,2799,14893
20-05-2019,09 - 10,1009,1630,9545,2784,14968
20-05-2019,10 - 11,967,1609,9619,2824,15019
20-05-2019,11 - 12,954,1591,9642,2789,14976
20-05-2019,12 - 13,960,1530,9662,2763,14915
20-05-2019,13 - 14,953,1479,9710,2759,14901
20-05-2019,14 - 15,946,1654,9605,2691,14896
20-05-2019,15 - 16,875,1624,9581,2665,14745
20-05-2019,16 - 17,915,1591,9504,2573,14583
20-05-2019,17 - 18,982,1520,9570,2596,14668
20-05-2019,18 - 19,926,1541,9309,2506,14282
20-05-2019,19 - 20,920,1537,9135,2491,14083
20-05-2019,20 - 21,807,1508,8919,2422,13656
20-05-2019,21 - 22,865,1431,8661,2317,13274
20-05-2019,22 - 23,883,1347,8278,2201,12709
20-05-2019,23 - 00,810,1293,7637,1970,11710
21-05-2019,00 - 01,813,1290,7138,1876,11117
21-05-2019,01 - 02,839,1270,7004,1792,10905
21-05-2019,02 - 03,808,1103,6891,1797,10599
21-05-2019,03 - 04,771,1195,6745,1795,10506
21-05-2019,04 - 05,690,1038,6578,1859,10165
21-05-2019,05 - 06,754,1080,6758,1932,10524
21-05-2019,06 - 07,924,1327,7926,2269,12446
21-05-2019,07 - 08,1014,1523,8931,2597,14065
21-05-2019,08 - 09,1084,1477,9183,2737,14481
21-05-2019,09 - 10,1257,1540,9274,2776,14847
21-05-2019,10 - 11,1097,1577,9331,2803,14808
21-05-2019,11 - 12,1052,1558,9311,2785,14706
21-05-2019,12 - 13,1076,1566,9374,2650,14666
21-05-2019,13 - 14,1003,1510,9226,2702,14441
21-05-2019,14 - 15,914,1478,9093,2691,14176
21-05-2019,15 - 16,937,1539,9233,2694,14403
21-05-2019,16 - 17,986,1470,8888,2681,14025
21-05-2019,17 - 18,1003,1474,8926,2721,14124
21-05-2019,18 - 19,978,1454,8858,2710,14000
21-05-2019,19 - 20,965,1440,8731,2636,13772
21-05-2019,20 - 21,938,1403,8638,2547,13526
21-05-2019,21 - 22,857,1393,8366,2475,13091
21-05-2019,22 - 23,872,1247,7899,2340,12358
21-05-2019,23 - 00,784,1233,7249,2107,11373
22-05-2019,00 - 01,703,1205,6963,1911,10782
22-05-2019,01 - 02,762,1239,6812,1898,10711
22-05-2019,02 - 03,726,1101,6745,1880,10452
22-05-2019,03 - 04,751,1099,6816,1871,10537
22-05-2019,04 - 05,783,1057,6616,1824,10280
22-05-2019,05 - 06,842,1083,6842,1849,10616
22-05-2019,06 - 07,932,1331,7796,2192,12251
22-05-2019,07 - 08,936,1525,8964,2556,13981
22-05-2019,08 - 09,950,1574,9429,2694,14647
22-05-2019,09 - 10,926,1582,9320,2687,14515
22-05-2019,10 - 11,917,1547,9543,2686,14693
22-05-2019,11 - 12,918,1587,9534,2682,14721
22-05-2019,12 - 13,971,1623,9508,2629,14731
22-05-2019,13 - 14,908,1640,9543,2555,14646
22-05-2019,14 - 15,890,1411,9373,2489,14163
22-05-2019,15 - 16,818,1311,9243,2424,13796
22-05-2019,16 - 17,841,1414,9104,2402,13761
22-05-2019,17 - 18,957,1390,8882,2400,13629
22-05-2019,18 - 19,890,1452,8737,2457,13536
22-05-2019,19 - 20,960,1398,8886,2473,13717
22-05-2019,20 - 21,972,1290,8821,2361,13444
22-05-2019,21 - 22,900,1360,8575,2319,13154
22-05-2019,22 - 23,811,1247,8130,2279,12467
22-05-2019,23 - 00,861,1185,7607,2075,11728
23-05-2019,00 - 01,860,1133,7293,2043,11329
23-05-2019,01 - 02,872,1028,7082,1943,10925
23-05-2019,02 - 03,883,1081,6856,1866,10686
23-05-2019,03 - 04,870,1201,6848,1818,10737
23-05-2019,04 - 05,904,1170,6792,1866,10732
23-05-2019,05 - 06,933,1300,7217,1926,11376
23-05-2019,06 - 07,1046,1365,8355,2276,13042
23-05-2019,07 - 08,1100,1353,9384,2581,14418
23-05-2019,08 - 09,1082,1422,9688,2581,14773
23-05-2019,09 - 10,1061,1645,9671,2565,14942
23-05-2019,10 - 11,890,1600,9715,2632,14837
23-05-2019,11 - 12,1001,1546,9579,2689,14815
23-05-2019,12 - 13,970,1672,9477,2676,14795
23-05-2019,13 - 14,921,1773,9629,2679,15002
23-05-2019,14 - 15,896,1731,9521,2624,14772
23-05-2019,15 - 16,977,1774,9514,2606,14871
23-05-2019,16 - 17,1030,1753,9413,2576,14772
23-05-2019,17 - 18,1019,1720,9457,2595,14791
23-05-2019,18 - 19,1092,1809,9213,2551,14665
23-05-2019,19 - 20,1049,1706,9112,2531,14398
23-05-2019,20 - 21,1064,1706,9040,2519,14329
23-05-2019,21 - 22,1050,1615,8806,2402,13873
23-05-2019,22 - 23,961,1571,8445,2269,13246
23-05-2019,23 - 00,918,1550,7835,2076,12379
24-05-2019,00 - 01,853,1421,7413,1923,11610
24-05-2019,01 - 02,898,1407,7146,1849,11300
24-05-2019,02 - 03,913,1461,7119,1825,11318
24-05-2019,03 - 04,891,1582,7107,1825,11405
24-05-2019,04 - 05,918,1512,7084,1829,11343
24-05-2019,05 - 06,944,1583,7480,1868,11875
24-05-2019,06 - 07,1126,1726,8490,2217,13559
24-05-2019,07 - 08,1120,1771,9473,2627,14991
24-05-2019,08 - 09,1120,1799,9723,2680,15322
24-05-2019,09 - 10,1034,1813,9743,2625,15215
24-05-2019,10 - 11,1015,1801,9845,2650,15311
24-05-2019,11 - 12,1037,1712,9639,2661,15049
24-05-2019,12 - 13,1013,1593,9512,2629,14747
24-05-2019,13 - 14,1076,1624,9280,2553,14533
24-05-2019,14 - 15,1124,1517,9142,2594,14377
24-05-2019,15 - 16,1098,1539,9082,2425,14144
24-05-2019,16 - 17,1030,1478,8983,2384,13875
24-05-2019,17 - 18,990,1548,9035,2463,14036
24-05-2019,18 - 19,1035,1576,8996,2470,14077
24-05-2019,19 - 20,1122,1613,8807,2443,13985
24-05-2019,20 - 21,1093,1565,8620,2349,13627
24-05-2019,21 - 22,1041,1510,8404,2246,13201
24-05-2019,22 - 23,998,1484,8127,2122,12731
24-05-2019,23 - 00,997,1420,7694,1992,12103
25-05-2019,00 - 01,935,1351,7353,1954,11593
25-05-2019,01 - 02,1027,1369,7223,1893,11512
25-05-2019,02 - 03,893,1379,7184,1880,11336
25-05-2019,03 - 04,935,1367,7067,1879,11248
25-05-2019,04 - 05,958,1363,6815,1856,10992
25-05-2019,05 - 06,954,1347,6925,1823,11049
25-05-2019,06 - 07,974,1371,7238,1924,11507
25-05-2019,07 - 08,1001,1338,7566,2034,11939
25-05-2019,08 - 09,1004,1490,8145,2190,12829
25-05-2019,09 - 10,1038,1484,8499,2248,13269
25-05-2019,10 - 11,1024,1449,8620,2286,13379
25-05-2019,11 - 12,1041,1524,8612,2289,13466
25-05-2019,12 - 13,971,1514,8505,2282,13272
25-05-2019,13 - 14,1050,1530,8280,2240,13100
25-05-2019,14 - 15,994,1515,8053,2168,12730
25-05-2019,15 - 16,1032,1444,7805,2182,12463
25-05-2019,16 - 17,1037,1512,7769,2112,12430
25-05-2019,17 - 18,1163,1500,7881,2119,12663
25-05-2019,18 - 19,1075,1567,7971,2114,12727
25-05-2019,19 - 20,954,1594,7984,2145,12677
25-05-2019,20 - 21,985,1522,7977,2165,12649
25-05-2019,21 - 22,964,1493,7828,2193,12478
25-05-2019,22 - 23,892,1462,7657,2155,12166
25-05-2019,23 - 00,982,1411,7486,2017,11896
26-05-2019,00 - 01,984,1426,7205,1849,11464
26-05-2019,01 - 02,925,1368,7043,1787,11123
26-05-2019,02 - 03,938,1362,6927,1785,11012
26-05-2019,03 - 04,949,1271,6847,1783,10850
26-05-2019,04 - 05,945,1303,6657,1854,10759
26-05-2019,05 - 06,952,1397,6658,1805,10812
26-05-2019,06 - 07,990,1449,6975,1834,11248
26-05-2019,07 - 08,1030,1488,7319,1901,11738
26-05-2019,08 - 09,999,1510,7787,2054,12350
26-05-2019,09 - 10,1056,1498,8126,2136,12816
26-05-2019,10 - 11,1058,1503,8399,2322,13282
26-05-2019,11 - 12,1047,1514,8597,2353,13511
26-05-2019,12 - 13,1065,1544,8696,2378,13683
26-05-2019,13 - 14,1053,1510,8730,2349,13642
26-05-2019,14 - 15,1020,1504,8503,2276,13303
26-05-2019,15 - 16,1105,1482,8267,2201,13055
26-05-2019,16 - 17,1103,1553,8310,2187,13153
26-05-2019,17 - 18,1098,1610,8464,2258,13430
26-05-2019,18 - 19,1043,1643,8561,2352,13599
26-05-2019,19 - 20,1047,1646,8755,2402,13850
26-05-2019,20 - 21,1002,1660,8614,2364,13640
26-05-2019,21 - 22,1032,1513,8535,2356,13436
26-05-2019,22 - 23,1033,1450,8373,2232,13088
26-05-2019,23 - 00,1070,1352,8014,2076,12512
27-05-2019,00 - 01,1003,1364,7771,1937,12075
27-05-2019,01 - 02,1024,1376,7684,1874,11958
27-05-2019,02 - 03,1024,1491,7657,1824,11996
27-05-2019,03 - 04,1015,1485,7561,1758,11819
27-05-2019,04 - 05,1049,1485,7552,1747,11833
27-05-2019,05 - 06,1001,1490,7864,1751,12106
27-05-2019,06 - 07,1072,1696,8867,2127,13762
27-05-2019,07 - 08,1079,1770,9890,2564,15303
27-05-2019,08 - 09,1093,1950,10121,2722,15886
27-05-2019,09 - 10,1084,1923,10057,2791,15855
27-05-2019,10 - 11,1007,1610,10264,2813,15694
27-05-2019,11 - 12,1074,1489,10366,2840,15769
27-05-2019,12 - 13,1041,1669,10321,2752,15783
27-05-2019,13 - 14,1016,1582,10211,2660,15469
27-05-2019,14 - 15,1094,1597,10134,2620,15445
27-05-2019,15 - 16,998,1579,10203,2517,15297
27-05-2019,16 - 17,1007,1567,10018,2519,15111
27-05-2019,17 - 18,1095,1620,10187,2622,15524
27-05-2019,18 - 19,1106,1566,10151,2581,15404
27-05-2019,19 - 20,1072,1613,10004,2576,15265
27-05-2019,20 - 21,1119,1606,9683,2556,14964
27-05-2019,21 - 22,1103,1581,9377,2503,14564
27-05-2019,22 - 23,1162,1489,8840,2432,13923
27-05-2019,23 - 00,1061,1577,8368,2192,13198
28-05-2019,00 - 01,986,1564,8037,2112,12699
28-05-2019,01 - 02,961,1495,7882,2089,12427
28-05-2019,02 - 03,1017,1411,7837,2024,12289
28-05-2019,03 - 04,950,1377,7809,2069,12205
28-05-2019,04 - 05,982,1336,7759,2041,12118
28-05-2019,05 - 06,931,1418,8099,2180,12628
28-05-2019,06 - 07,1060,1437,9090,2572,14159
28-05-2019,07 - 08,1077,1582,10010,2888,15557
28-05-2019,08 - 09,1070,1649,10192,2943,15854
28-05-2019,09 - 10,1087,1800,10043,2894,15824
28-05-2019,10 - 11,1093,1828,10054,2943,15918
28-05-2019,11 - 12,1025,1841,9865,2892,15623
28-05-2019,12 - 13,1084,1817,9843,2821,15565
28-05-2019,13 - 14,1131,1807,9734,2752,15424
28-05-2019,14 - 15,1073,1794,9565,2732,15164
28-05-2019,15 - 16,1061,1739,9442,2653,14895
28-05-2019,16 - 17,1116,1711,9348,2598,14773
28-05-2019,17 - 18,1105,1678,9376,2563,14722
28-05-2019,18 - 19,1138,1627,9213,2523,14501
28-05-2019,19 - 20,1197,1663,9037,2577,14474
28-05-2019,20 - 21,1152,1649,9048,2689,14538
28-05-2019,21 - 22,1061,1622,8877,2710,14270
28-05-2019,22 - 23,985,1566,8536,2578,13665
28-05-2019,23 - 00,1054,1549,8157,2334,13094
29-05-2019,00 - 01,893,1485,7964,2109,12451
29-05-2019,01 - 02,902,1349,7800,2092,12143
29-05-2019,02 - 03,979,1342,7832,2092,12245
29-05-2019,03 - 04,921,1377,7692,2149,12139
29-05-2019,04 - 05,1028,1397,7695,2109,12229
29-05-2019,05 - 06,993,1498,8199,2244,12934
29-05-2019,06 - 07,1050,1717,9159,2681,14607
29-05-2019,07 - 08,1077,1717,9950,2822,15566
29-05-2019,08 - 09,1048,1461,9983,2815,15307
29-05-2019,09 - 10,1031,1679,9946,2859,15515
29-05-2019,10 - 11,1071,1859,9927,2935,15792
29-05-2019,11 - 12,1122,1601,9910,2856,15489
29-05-2019,12 - 13,1137,1595,9809,2818,15359
29-05-2019,13 - 14,1051,1823,9713,2760,15347
29-05-2019,14 - 15,1093,1837,9683,2739,15352
29-05-2019,15 - 16,1031,1597,9636,2670,14934
29-05-2019,16 - 17,1127,1523,9506,2629,14785
29-05-2019,17 - 18,1234,1714,9576,2657,15181
29-05-2019,18 - 19,1226,1647,9471,2642,14986
29-05-2019,19 - 20,1068,1633,9239,2610,14550
29-05-2019,20 - 21,990,1702,9147,2528,14367
29-05-2019,21 - 22,1068,1778,9167,2493,14506
29-05-2019,22 - 23,1060,1581,8903,2380,13924
29-05-2019,23 - 00,1091,1630,8542,2267,13530
30-05-2019,00 - 01,1095,1503,8071,2180,12849
30-05-2019,01 - 02,1047,1369,7751,2078,12245
30-05-2019,02 - 03,1043,1274,7684,2044,12045
30-05-2019,03 - 04,1055,1138,7594,2057,11844
30-05-2019,04 - 05,1125,1182,7307,2035,11649
30-05-2019,05 - 06,1062,1276,7366,2013,11717
30-05-2019,06 - 07,1051,1417,7644,2015,12127
30-05-2019,07 - 08,1073,1550,8114,2130,12867
30-05-2019,08 - 09,1007,1328,8283,2195,12813
30-05-2019,09 - 10,1043,1489,8688,2249,13469
30-05-2019,10 - 11,1001,1574,8907,2332,13814
30-05-2019,11 - 12,966,1548,9019,2354,13887
30-05-2019,12 - 13,973,1505,9155,2361,13994
30-05-2019,13 - 14,987,1352,9104,2360,13803
30-05-2019,14 - 15,984,1445,9046,2330,13805
30-05-2019,15 - 16,1030,1699,8980,2264,13973
30-05-2019,16 - 17,1064,1716,9033,2328,14141
30-05-2019,17 - 18,991,1810,9106,2466,14373
30-05-2019,18 - 19,1064,1645,9188,2485,14382
30-05-2019,19 - 20,1204,1640,9023,2420,14287
30-05-2019,20 - 21,1220,1596,8792,2360,13968
30-05-2019,21 - 22,981,1637,8641,2306,13565
30-05-2019,22 - 23,1016,1450,8432,2173,13071
30-05-2019,23 - 00,1090,1550,8027,2080,12747
31-05-2019,00 - 01,1008,1605,7645,2031,12289
31-05-2019,01 - 02,983,1536,7613,1976,12108
31-05-2019,02 - 03,1094,1584,7630,1977,12285
31-05-2019,03 - 04,1063,1393,7479,1956,11891
31-05-2019,04 - 05,1005,1249,7244,1971,11469
31-05-2019,05 - 06,991,1432,7467,2078,11968
31-05-2019,06 - 07,993,1711,8213,2318,13235
31-05-2019,07 - 08,1079,1714,8910,2544,14247
31-05-2019,08 - 09,1087,1733,9357,2716,14893
31-05-2019,09 - 10,1077,1666,9520,2748,15011
31-05-2019,10 - 11,1259,1660,9439,2697,15055
31-05-2019,11 - 12,1265,1703,9131,2654,14753
31-05-2019,12 - 13,1150,1732,8994,2596,14472
31-05-2019,13 - 14,1079,1754,8820,2434,14087
31-05-2019,14 - 15,1054,1797,8702,2371,13924
31-05-2019,15 - 16,992,1630,8643,2360,13625
31-05-2019,16 - 17,1003,1577,8504,2387,13471
31-05-2019,17 - 18,1087,1706,8579,2460,13832
31-05-2019,18 - 19,1045,1698,8485,2424,13652
31-05-2019,19 - 20,1035,1571,8346,2405,13357
31-05-2019,20 - 21,1115,1627,8281,2333,13356
31-05-2019,21 - 22,999,1551,8127,2270,12947
31-05-2019,22 - 23,930,1697,7951,2230,12808
31-05-2019,23 - 00,957,1695,7679,2105,12436
01-06-2019,00 - 01,1035,1615,7477,1947,12074
01-06-2019,01 - 02,1046,1573,7285,1858,11762
01-06-2019,02 - 03,1083,1554,7106,1849,11592
01-06-2019,03 - 04,1068,1590,6900,1883,11441
01-06-2019,04 - 05,1012,1660,6713,1832,11217
01-06-2019,05 - 06,979,1683,6681,1842,11185
01-06-2019,06 - 07,992,1565,6801,1874,11232
01-06-2019,07 - 08,944,1546,7342,1994,11826
01-06-2019,08 - 09,991,1545,7804,2116,12456
01-06-2019,09 - 10,996,1665,8197,2189,13047
01-06-2019,10 - 11,1065,1684,8385,2275,13409
01-06-2019,11 - 12,1082,1622,8406,2364,13474
01-06-2019,12 - 13,1035,1539,8490,2310,13374
01-06-2019,13 - 14,1089,1620,8498,2239,13446
01-06-2019,14 - 15,1090,1704,8394,2185,13373
01-06-2019,15 - 16,989,1719,8336,2058,13102
01-06-2019,16 - 17,1026,1635,8344,2082,13087
01-06-2019,17 - 18,1068,1672,8443,2146,13329
01-06-2019,18 - 19,1022,1533,8392,2216,13163
01-06-2019,19 - 20,1091,1493,8367,2197,13148
01-06-2019,20 - 21,1040,1476,8234,2228,12978
01-06-2019,21 - 22,1024,1498,8038,2175,12735
01-06-2019,22 - 23,1010,1469,7922,2193,12594
01-06-2019,23 - 00,968,1367,7555,2078,11968
02-06-2019,00 - 01,1028,1408,7294,1956,11686
02-06-2019,01 - 02,1113,1465,6980,1877,11435
02-06-2019,02 - 03,1150,1370,6758,1811,11089
02-06-2019,03 - 04,996,1411,6758,1806,10971
02-06-2019,04 - 05,940,1193,6607,1770,10510
02-06-2019,05 - 06,925,1374,6471,1752,10522
02-06-2019,06 - 07,891,1484,6785,1766,10926
02-06-2019,07 - 08,942,1565,7141,1832,11480
02-06-2019,08 - 09,1031,1651,7474,1889,12045
02-06-2019,09 - 10,1096,1663,7812,2065,12636
02-06-2019,10 - 11,988,1621,7999,2161,12769
02-06-2019,11 - 12,1012,1567,8117,2161,12857
02-06-2019,12 - 13,1022,1582,8127,2151,12882
02-06-2019,13 - 14,1053,1615,7894,2117,12679
02-06-2019,14 - 15,940,1544,7877,2075,12436
02-06-2019,15 - 16,1015,1629,7795,2022,12461
02-06-2019,16 - 17,1050,1611,7858,2046,12565
02-06-2019,17 - 18,1096,1690,8051,2114,12951
02-06-2019,18 - 19,1079,1672,8149,2200,13100
02-06-2019,19 - 20,1063,1669,8267,2318,13317
02-06-2019,20 - 21,1099,1605,8202,2297,13203
02-06-2019,21 - 22,1042,1497,7911,2188,12638
02-06-2019,22 - 23,1010,1487,7599,2106,12202
02-06-2019,23 - 00,970,1365,7256,1895,11486
03-06-2019,00 - 01,981,1307,7055,1835,11178
03-06-2019,01 - 02,968,1263,7051,1731,11013
03-06-2019,02 - 03,945,1183,7029,1593,10750
03-06-2019,03 - 04,922,1081,6698,1699,10400
03-06-2019,04 - 05,1088,1141,6566,1807,10602
03-06-2019,05 - 06,1019,1311,7024,1942,11296
03-06-2019,06 - 07,972,1428,8332,2301,13033
03-06-2019,07 - 08,996,1756,9330,2749,14831
03-06-2019,08 - 09,995,1725,9625,2857,15202
03-06-2019,09 - 10,1000,1813,9859,2811,15483
03-06-2019,10 - 11,1020,1852,9909,2848,15629
03-06-2019,11 - 12,1028,1802,9865,2849,15544
03-06-2019,12 - 13,1113,1764,9844,2743,15464
03-06-2019,13 - 14,1115,1784,9850,2722,15471
03-06-2019,14 - 15,1016,1771,9850,2781,15418
03-06-2019,15 - 16,1025,1612,9601,2544,14782
03-06-2019,16 - 17,1073,1519,9521,2614,14727
03-06-2019,17 - 18,1190,1691,9577,2765,15223
03-06-2019,18 - 19,1210,1620,9535,2614,14979
03-06-2019,19 - 20,1198,1717,9402,2521,14838
03-06-2019,20 - 21,1040,1516,9134,2303,13993
03-06-2019,21 - 22,1196,2652,8950,1882,14680
03-06-2019,22 - 23,1656,6154,9552,455,17817
03-06-2019,23 - 00,1446,5790,9480,428,17144
04-06-2019,00 - 01,736,1925,7430,1915,12006
04-06-2019,01 - 02,884,1638,7188,1817,11527
04-06-2019,02 - 03,934,1457,7132,1808,11331
04-06-2019,03 - 04,961,1473,6942,1914,11290
04-06-2019,04 - 05,907,1393,6838,1896,11034
04-06-2019,05 - 06,899,1639,7215,1928,11681
04-06-2019,06 - 07,1048,1739,8101,2185,13073
04-06-2019,07 - 08,985,1819,8957,2543,14304
04-06-2019,08 - 09,1005,1858,9360,2696,14919
04-06-2019,09 - 10,1044,1893,9583,2693,15213
04-06-2019,10 - 11,1088,1961,9557,2735,15341
04-06-2019,11 - 12,932,1880,9761,2704,15277
04-06-2019,12 - 13,1022,1764,9211,2712,14709
04-06-2019,13 - 14,1047,1785,9112,2665,14609
04-06-2019,14 - 15,1047,1781,8962,2666,14456
04-06-2019,15 - 16,1235,1617,8694,2668,14214
04-06-2019,16 - 17,1036,1729,9155,2581,14501
04-06-2019,17 - 18,1068,1760,9082,2591,14501
04-06-2019,18 - 19,1036,1618,8834,2512,14000
04-06-2019,19 - 20,1148,1630,8676,2448,13902
04-06-2019,20 - 21,1083,1632,8669,2374,13758
04-06-2019,21 - 22,1042,1569,8379,2254,13244
04-06-2019,22 - 23,1018,1556,8059,2235,12868
04-06-2019,23 - 00,1012,1563,7554,2085,12214
05-06-2019,00 - 01,885,1535,7258,1959,11637
05-06-2019,01 - 02,967,1464,6945,1816,11192
05-06-2019,02 - 03,987,1381,6805,1786,10959
05-06-2019,03 - 04,914,1418,6793,1753,10878
05-06-2019,04 - 05,810,1470,6525,1637,10442
05-06-2019,05 - 06,877,1503,6719,1729,10828
05-06-2019,06 - 07,983,1669,7668,2078,12398
05-06-2019,07 - 08,1074,1683,8805,2513,14075
05-06-2019,08 - 09,1067,1675,9066,2681,14489
05-06-2019,09 - 10,999,1619,9226,2747,14591
05-06-2019,10 - 11,1026,1654,9289,2828,14797
05-06-2019,11 - 12,1057,1585,9458,2810,14910
05-06-2019,12 - 13,1038,1655,9288,2738,14719
05-06-2019,13 - 14,1075,1700,9173,2717,14665
05-06-2019,14 - 15,983,1642,9175,2668,14468
05-06-2019,15 - 16,1023,1685,8849,2597,14154
05-06-2019,16 - 17,1001,1733,8612,2511,13857
05-06-2019,17 - 18,949,1648,8842,2525,13964
05-06-2019,18 - 19,1007,1743,8592,2444,13786
05-06-2019,19 - 20,966,1718,8522,2410,13616
05-06-2019,20 - 21,977,1532,8228,2344,13081
05-06-2019,21 - 22,959,1526,7800,2295,12580
05-06-2019,22 - 23,1014,1435,7628,2248,12325
05-06-2019,23 - 00,907,1339,7345,2047,11638
06-06-2019,00 - 01,687,1161,6815,1853,10516
06-06-2019,01 - 02,746,1059,6409,1759,9973
06-06-2019,02 - 03,806,1075,6314,1714,9909
06-06-2019,03 - 04,765,1149,6032,1708,9654
06-06-2019,04 - 05,747,1183,5838,1632,9400
06-06-2019,05 - 06,846,1422,5921,1648,9837
06-06-2019,06 - 07,866,1473,6264,1857,10460
06-06-2019,07 - 08,904,1569,6833,2065,11371
06-06-2019,08 - 09,1016,1538,7436,2231,12221
06-06-2019,09 - 10,971,1602,7743,2364,12680
06-06-2019,10 - 11,1019,1562,8102,2334,13017
06-06-2019,11 - 12,990,1519,8005,2253,12767
06-06-2019,12 - 13,987,1547,8042,2205,12781
06-06-2019,13 - 14,992,1526,7898,2141,12557
06-06-2019,14 - 15,983,1490,7832,2137,12442
06-06-2019,15 - 16,983,1375,7768,2167,12293
06-06-2019,16 - 17,986,1397,7686,2214,12283
06-06-2019,17 - 18,975,1460,7799,2247,12481
06-06-2019,18 - 19,976,1669,7827,2249,12721
06-06-2019,19 - 20,942,1600,7806,2260,12608
06-06-2019,20 - 21,819,1616,7720,2259,12414
06-06-2019,21 - 22,739,1560,7570,2201,12070
06-06-2019,22 - 23,754,1511,7326,2108,11699
06-06-2019,23 - 00,708,1414,6947,1989,11058
07-06-2019,00 - 01,752,1347,6482,1891,10472
07-06-2019,01 - 02,678,1422,6286,1814,10200
07-06-2019,02 - 03,782,1313,6189,1785,10069
07-06-2019,03 - 04,765,1205,6138,1686,9794
07-06-2019,04 - 05,771,1268,6084,1665,9788
07-06-2019,05 - 06,842,1346,6311,1770,10269
07-06-2019,06 - 07,1021,1583,7139,1973,11716
07-06-2019,07 - 08,1085,1786,7854,2261,12986
07-06-2019,08 - 09,745,1854,8397,2457,13453
07-06-2019,09 - 10,696,1678,8585,2453,13412
07-06-2019,10 - 11,901,1452,8709,2511,13573
07-06-2019,11 - 12,951,1444,8794,2511,13700
07-06-2019,12 - 13,1024,1483,8718,2465,13690
07-06-2019,13 - 14,980,1431,8692,2407,13510
07-06-2019,14 - 15,1040,1502,8461,2347,13350
07-06-2019,15 - 16,1037,1537,8446,2289,13309
07-06-2019,16 - 17,896,1658,8468,2302,13324
07-06-2019,17 - 18,1016,1708,8350,2336,13410
07-06-2019,18 - 19,1007,1656,8060,2272,12995
07-06-2019,19 - 20,1092,1590,7986,2171,12839
07-06-2019,20 - 21,1212,1692,7800,2095,12799
07-06-2019,21 - 22,985,1793,7441,2043,12262
07-06-2019,22 - 23,981,1747,7235,2006,11969
07-06-2019,23 - 00,867,1618,7150,1915,11550
08-06-2019,00 - 01,808,1543,6721,1766,10838
08-06-2019,01 - 02,956,1384,6423,1680,10443
08-06-2019,02 - 03,855,1308,6264,1551,9978
08-06-2019,03 - 04,776,1298,6131,1538,9743
08-06-2019,04 - 05,746,1143,5888,1498,9275
08-06-2019,05 - 06,873,1127,5877,1563,9440
08-06-2019,06 - 07,986,1496,6035,1723,10240
08-06-2019,07 - 08,926,1638,6439,1875,10878
08-06-2019,08 - 09,965,1668,6933,2044,11610
08-06-2019,09 - 10,1068,1671,7394,2184,12317
08-06-2019,10 - 11,965,1630,7674,2174,12443
08-06-2019,11 - 12,966,1588,7783,2101,12438
08-06-2019,12 - 13,1002,1469,7682,2093,12246
08-06-2019,13 - 14,1013,1466,7709,2015,12203
08-06-2019,14 - 15,959,1458,7571,1936,11924
08-06-2019,15 - 16,1044,1510,7543,1934,12031
08-06-2019,16 - 17,1082,1616,7561,2025,12284
08-06-2019,17 - 18,1028,1655,7568,1912,12163
08-06-2019,18 - 19,1024,1471,7481,1923,11899
08-06-2019,19 - 20,992,1385,7303,1940,11620
08-06-2019,20 - 21,1009,1288,7153,2029,11479
08-06-2019,21 - 22,996,1294,7136,2032,11458
08-06-2019,22 - 23,879,1284,6968,1901,11032
08-06-2019,23 - 00,910,1268,6721,1880,10779
09-06-2019,00 - 01,928,1264,6450,1862,10504
09-06-2019,01 - 02,800,1278,6259,1733,10070
09-06-2019,02 - 03,783,1288,6187,1617,9875
09-06-2019,03 - 04,767,1164,6069,1545,9545
09-06-2019,04 - 05,850,953,5834,1521,9158
09-06-2019,05 - 06,884,890,5915,1526,9215
09-06-2019,06 - 07,926,1262,6055,1610,9853
09-06-2019,07 - 08,893,1483,6410,1763,10549
09-06-2019,08 - 09,911,1460,6833,1849,11053
09-06-2019,09 - 10,971,1452,7142,1922,11487
09-06-2019,10 - 11,1003,1512,7701,1964,12180
09-06-2019,11 - 12,973,1390,7926,2007,12296
09-06-2019,12 - 13,996,1438,7861,2016,12311
09-06-2019,13 - 14,1016,1437,7829,2036,12318
09-06-2019,14 - 15,981,1521,7849,1982,12333
09-06-2019,15 - 16,1005,1522,7825,2011,12363
09-06-2019,16 - 17,986,1603,7875,2061,12525
09-06-2019,17 - 18,1022,1627,7996,2132,12777
09-06-2019,18 - 19,971,1639,8100,2160,12870
09-06-2019,19 - 20,1037,1586,7970,2200,12793
09-06-2019,20 - 21,1012,1491,7862,2229,12594
09-06-2019,21 - 22,1063,1424,7702,2151,12340
09-06-2019,22 - 23,1004,1259,7489,2100,11852
09-06-2019,23 - 00,948,1411,7148,1973,11480
10-06-2019,00 - 01,939,1340,6890,1855,11024
10-06-2019,01 - 02,918,1386,6692,1803,10799
10-06-2019,02 - 03,873,1378,6722,1790,10763
10-06-2019,03 - 04,843,1277,6622,1787,10529
10-06-2019,04 - 05,902,1275,6539,1748,10464
10-06-2019,05 - 06,1105,1446,6895,1866,11312
10-06-2019,06 - 07,1058,1618,8048,2187,12911
10-06-2019,07 - 08,896,1556,8946,2515,13913
10-06-2019,08 - 09,960,1616,9261,2654,14491
10-06-2019,09 - 10,890,1666,9361,2696,14613
10-06-2019,10 - 11,1118,1747,9417,2734,15016
10-06-2019,11 - 12,1088,1777,9317,2684,14866
10-06-2019,12 - 13,1128,1693,9307,2660,14788
10-06-2019,13 - 14,1110,1720,9363,2623,14816
10-06-2019,14 - 15,1094,1658,9321,2606,14679
10-06-2019,15 - 16,1064,1653,9376,2652,14745
10-06-2019,16 - 17,1072,1641,9274,2552,14539
10-06-2019,17 - 18,1039,1732,9326,2525,14622
10-06-2019,18 - 19,1100,1716,9032,2491,14339
10-06-2019,19 - 20,1109,1656,8854,2434,14053
10-06-2019,20 - 21,1077,1635,8645,2427,13784
10-06-2019,21 - 22,1069,1664,8359,2371,13463
10-06-2019,22 - 23,1054,1567,8090,2279,12990
10-06-2019,23 - 00,1036,1488,7694,2053,12271
11-06-2019,00 - 01,893,1365,7177,1956,11391
11-06-2019,01 - 02,840,1329,6997,1905,11071
11-06-2019,02 - 03,898,1313,6811,1824,10846
11-06-2019,03 - 04,896,1254,6610,1768,10528
11-06-2019,04 - 05,955,1269,6479,1759,10462
11-06-2019,05 - 06,974,1461,6770,1818,11023
11-06-2019,06 - 07,1034,1617,7813,2274,12738
11-06-2019,07 - 08,1018,1543,8810,2716,14087
11-06-2019,08 - 09,1079,1445,9296,2900,14720
11-06-2019,09 - 10,1030,1532,9550,3027,15139
11-06-2019,10 - 11,968,1755,9534,3019,15276
11-06-2019,11 - 12,903,1731,9637,2941,15212
11-06-2019,12 - 13,858,1710,9692,2931,15191
11-06-2019,13 - 14,998,1813,9528,2947,15286
11-06-2019,14 - 15,1043,1592,9536,2890,15061
11-06-2019,15 - 16,1030,1551,9483,2761,14825
11-06-2019,16 - 17,1115,1546,9398,2615,14674
11-06-2019,17 - 18,1048,1573,9526,2612,14759
11-06-2019,18 - 19,1048,1526,9222,2633,14429
11-06-2019,19 - 20,1012,1586,8992,2710,14300
11-06-2019,20 - 21,1080,1562,8839,2637,14118
11-06-2019,21 - 22,1021,1524,8553,2523,13621
11-06-2019,22 - 23,1027,1360,8349,2432,13168
11-06-2019,23 - 00,977,1283,8047,2332,12639
12-06-2019,00 - 01,842,1131,7609,2125,11707
12-06-2019,01 - 02,914,1186,7273,2040,11413
12-06-2019,02 - 03,889,1239,7177,2031,11336
12-06-2019,03 - 04,856,1259,7119,2049,11283
12-06-2019,04 - 05,787,1356,7076,2061,11280
12-06-2019,05 - 06,903,1480,7355,2259,11997
12-06-2019,06 - 07,1053,1514,8481,2481,13529
12-06-2019,07 - 08,1040,1613,9518,2564,14735
12-06-2019,08 - 09,1028,1596,9872,2767,15263
12-06-2019,09 - 10,968,1565,9824,2820,15177
12-06-2019,10 - 11,1078,1610,9970,2938,15596
12-06-2019,11 - 12,1018,1645,9959,2935,15557
12-06-2019,12 - 13,996,1730,10040,2870,15636
12-06-2019,13 - 14,972,1666,10242,3037,15917
12-06-2019,14 - 15,986,1626,10084,3017,15713
12-06-2019,15 - 16,1015,1566,9839,2859,15279
12-06-2019,16 - 17,1005,1650,9762,2776,15193
12-06-2019,17 - 18,1002,1716,9837,2755,15310
12-06-2019,18 - 19,1001,1648,9551,2594,14794
12-06-2019,19 - 20,939,1601,9416,2544,14500
12-06-2019,20 - 21,901,1532,9197,2537,14167
12-06-2019,21 - 22,843,1510,8994,2504,13851
12-06-2019,22 - 23,774,1345,8543,2372,13034
12-06-2019,23 - 00,904,1293,8043,2278,12518
13-06-2019,00 - 01,895,1162,7668,2162,11887
13-06-2019,01 - 02,932,1283,7576,2129,11920
13-06-2019,02 - 03,919,1274,7467,2003,11663
13-06-2019,03 - 04,873,1279,7347,1974,11473
13-06-2019,04 - 05,945,1305,7128,1970,11348
13-06-2019,05 - 06,920,1454,7435,2116,11925
13-06-2019,06 - 07,1038,1626,8452,2457,13573
13-06-2019,07 - 08,1125,1714,9451,2655,14945
13-06-2019,08 - 09,1061,1784,9797,2695,15337
13-06-2019,09 - 10,1081,1730,9834,2770,15415
13-06-2019,10 - 11,1057,1641,9751,2827,15276
13-06-2019,11 - 12,1043,1513,9968,2850,15374
13-06-2019,12 - 13,1025,1380,10048,2793,15246
13-06-2019,13 - 14,1098,1522,9842,2746,15208
13-06-2019,14 - 15,1088,1540,9770,2716,15114
13-06-2019,15 - 16,1060,1845,9831,2728,15464
13-06-2019,16 - 17,1056,1924,9720,2612,15312
13-06-2019,17 - 18,1056,1884,9628,2641,15209
13-06-2019,18 - 19,1045,1787,9315,2531,14678
13-06-2019,19 - 20,1019,1681,9213,2495,14408
13-06-2019,20 - 21,995,1697,9044,2477,14213
13-06-2019,21 - 22,1012,1610,8650,2383,13655
13-06-2019,22 - 23,1020,1578,8382,2294,13274
13-06-2019,23 - 00,948,1576,7945,2153,12622
14-06-2019,00 - 01,941,1504,7516,2022,11983
14-06-2019,01 - 02,903,1429,7142,1879,11353
14-06-2019,02 - 03,928,1486,6965,1764,11143
14-06-2019,03 - 04,832,1345,6841,1728,10746
14-06-2019,04 - 05,825,1299,6782,1863,10769
14-06-2019,05 - 06,858,1395,7133,2021,11407
14-06-2019,06 - 07,957,1552,8161,2298,12968
14-06-2019,07 - 08,1048,1669,9143,2587,14447
14-06-2019,08 - 09,1005,1739,9489,2655,14888
14-06-2019,09 - 10,1014,1771,9473,2624,14882
14-06-2019,10 - 11,1041,1854,9458,2612,14965
14-06-2019,11 - 12,1043,1940,9481,2772,15236
14-06-2019,12 - 13,1012,1816,9387,2646,14861
14-06-2019,13 - 14,1077,1761,9174,2525,14537
14-06-2019,14 - 15,1069,1723,9012,2466,14270
14-06-2019,15 - 16,1024,1710,8830,2504,14068
14-06-2019,16 - 17,1004,1666,8612,2427,13709
14-06-2019,17 - 18,980,1719,8570,2403,13672
14-06-2019,18 - 19,1023,1619,8387,2337,13366
14-06-2019,19 - 20,1034,1592,8187,2256,13069
14-06-2019,20 - 21,957,1544,7969,2154,12624
14-06-2019,21 - 22,876,1520,7785,2118,12299
14-06-2019,22 - 23,717,1497,7682,2154,12050
14-06-2019,23 - 00,781,1424,7465,2131,11801
15-06-2019,00 - 01,825,1241,7081,1892,11039
15-06-2019,01 - 02,769,1348,6852,1766,10735
15-06-2019,02 - 03,825,1311,6688,1665,10489
15-06-2019,03 - 04,845,1225,6507,1659,10236
15-06-2019,04 - 05,806,1225,6382,1609,10022
15-06-2019,05 - 06,874,1218,6325,1616,10033
15-06-2019,06 - 07,925,1218,6576,1754,10473
15-06-2019,07 - 08,952,1227,6990,1939,11108
15-06-2019,08 - 09,967,1466,7453,2101,11987
15-06-2019,09 - 10,972,1453,7890,2220,12535
15-06-2019,10 - 11,1000,1470,8021,2225,12716
15-06-2019,11 - 12,974,1426,7964,2193,12557
15-06-2019,12 - 13,995,1504,7869,2213,12581
15-06-2019,13 - 14,920,1552,7901,2387,12760
15-06-2019,14 - 15,961,1495,7773,2392,12621
15-06-2019,15 - 16,948,1458,7690,2253,12349
15-06-2019,16 - 17,1002,1400,7621,2043,12066
15-06-2019,17 - 18,957,1517,7787,2085,12346
15-06-2019,18 - 19,964,1543,7799,2212,12518
15-06-2019,19 - 20,1027,1439,7737,2158,12361
15-06-2019,20 - 21,968,1425,7699,2081,12173
15-06-2019,21 - 22,962,1391,7567,2057,11977
15-06-2019,22 - 23,838,1434,7490,2216,11978
15-06-2019,23 - 00,774,1464,7275,2187,11700
16-06-2019,00 - 01,857,1400,6897,2080,11234
16-06-2019,01 - 02,931,1270,6640,1933,10774
16-06-2019,02 - 03,1020,1344,6509,1849,10722
16-06-2019,03 - 04,988,1344,6334,1820,10486
16-06-2019,04 - 05,875,1336,6185,1796,10192
16-06-2019,05 - 06,944,1315,6162,1771,10192
16-06-2019,06 - 07,1041,1352,6217,1837,10447
16-06-2019,07 - 08,941,1402,6624,1973,10940
16-06-2019,08 - 09,967,1371,7078,2065,11481
16-06-2019,09 - 10,965,1391,7501,2194,12051
16-06-2019,10 - 11,969,1511,7842,2255,12577
16-06-2019,11 - 12,957,1499,8083,2261,12800
16-06-2019,12 - 13,950,1442,8107,2269,12768
16-06-2019,13 - 14,920,1491,8044,2247,12702
16-06-2019,14 - 15,948,1516,7998,2258,12720
16-06-2019,15 - 16,1009,1416,7933,2206,12564
16-06-2019,16 - 17,980,1332,7852,2129,12293
16-06-2019,17 - 18,1016,1489,7967,2201,12673
16-06-2019,18 - 19,1034,1437,8012,2280,12763
16-06-2019,19 - 20,978,1531,8065,2293,12867
16-06-2019,20 - 21,1012,1516,8038,2263,12829
16-06-2019,21 - 22,1013,1388,7814,2208,12423
16-06-2019,22 - 23,944,1325,7605,2196,12070
16-06-2019,23 - 00,916,1284,7313,2068,11581
17-06-2019,00 - 01,909,1275,7044,1877,11105
17-06-2019,01 - 02,855,1383,6882,1798,10918
17-06-2019,02 - 03,887,1378,6704,1812,10781
17-06-2019,03 - 04,870,1367,6584,1809,10630
17-06-2019,04 - 05,844,1308,6595,1715,10462
17-06-2019,05 - 06,976,1297,6893,1847,11013
17-06-2019,06 - 07,1057,1444,8010,2226,12737
17-06-2019,07 - 08,1023,1659,8961,2575,14218
17-06-2019,08 - 09,1045,1688,9236,2651,14620
17-06-2019,09 - 10,1044,1662,9359,2626,14691
17-06-2019,10 - 11,1005,1732,9542,2654,14933
17-06-2019,11 - 12,1004,1647,9605,2705,14961
17-06-2019,12 - 13,1045,1637,9648,2721,15051
17-06-2019,13 - 14,997,1633,9601,2714,14945
17-06-2019,14 - 15,950,1629,9457,2723,14759
17-06-2019,15 - 16,933,1657,9489,2770,14849
17-06-2019,16 - 17,896,1580,9373,2662,14511
17-06-2019,17 - 18,963,1675,9227,2627,14492
17-06-2019,18 - 19,940,1596,9073,2548,14157
17-06-2019,19 - 20,934,1549,8837,2474,13794
17-06-2019,20 - 21,923,1623,8679,2406,13631
17-06-2019,21 - 22,979,1584,8401,2365,13329
17-06-2019,22 - 23,954,1589,8038,2319,12900
17-06-2019,23 - 00,934,1429,7718,2089,12170
18-06-2019,00 - 01,877,1263,7203,1920,11263
18-06-2019,01 - 02,927,1218,7046,1901,11092
18-06-2019,02 - 03,876,1309,6964,1967,11116
18-06-2019,03 - 04,746,1329,6703,1951,10729
18-06-2019,04 - 05,798,1355,6597,1915,10665
18-06-2019,05 - 06,927,1365,6887,1964,11143
18-06-2019,06 - 07,994,1373,7888,2211,12466
18-06-2019,07 - 08,1038,1536,8797,2566,13937
18-06-2019,08 - 09,781,1610,9141,2690,14222
18-06-2019,09 - 10,774,1753,9299,2685,14511
18-06-2019,10 - 11,983,1741,9525,2710,14959
18-06-2019,11 - 12,980,1716,9564,2751,15011
18-06-2019,12 - 13,980,1589,9454,2733,14756
18-06-2019,13 - 14,914,1527,9388,2783,14612
18-06-2019,14 - 15,883,1457,9392,2767,14499
18-06-2019,15 - 16,1065,1450,9297,2731,14543
18-06-2019,16 - 17,919,1436,9235,2635,14225
18-06-2019,17 - 18,885,1638,9279,2612,14414
18-06-2019,18 - 19,809,1562,9198,2588,14157
18-06-2019,19 - 20,820,1509,8995,2607,13931
18-06-2019,20 - 21,948,1745,8733,2498,13924
18-06-2019,21 - 22,942,1691,8382,2376,13391
18-06-2019,22 - 23,863,1508,8073,2296,12740
18-06-2019,23 - 00,741,1354,7578,2149,11822
19-06-2019,00 - 01,724,1226,7097,2000,11047
19-06-2019,01 - 02,696,1212,6866,1950,10724
19-06-2019,02 - 03,825,1129,6749,1921,10624
19-06-2019,03 - 04,874,1128,6573,1923,10498
19-06-2019,04 - 05,867,1282,6642,1966,10757
19-06-2019,05 - 06,868,1476,7059,2089,11492
19-06-2019,06 - 07,979,1614,8026,2393,13012
19-06-2019,07 - 08,963,1697,9003,2690,14353
19-06-2019,08 - 09,1056,1770,9363,2800,14989
19-06-2019,09 - 10,960,1753,9472,2814,14999
19-06-2019,10 - 11,992,1754,9541,2885,15172
19-06-2019,11 - 12,1011,1767,9634,2855,15267
19-06-2019,12 - 13,1003,1763,9611,2815,15192
19-06-2019,13 - 14,1006,1682,9548,2812,15048
19-06-2019,14 - 15,996,1699,9590,2747,15032
19-06-2019,15 - 16,923,1715,9529,2726,14893
19-06-2019,16 - 17,962,1660,9398,2654,14674
19-06-2019,17 - 18,989,1669,9304,2706,14668
19-06-2019,18 - 19,997,1607,9124,2708,14436
19-06-2019,19 - 20,1003,1587,8935,2673,14198
19-06-2019,20 - 21,969,1562,8740,2641,13912
19-06-2019,21 - 22,978,1462,8399,2475,13314
19-06-2019,22 - 23,873,1417,7906,2349,12545
19-06-2019,23 - 00,878,1305,7228,2244,11655
20-06-2019,00 - 01,963,1143,6735,2187,11028
20-06-2019,01 - 02,867,1264,6431,2054,10616
20-06-2019,02 - 03,869,1292,6393,2000,10554
20-06-2019,03 - 04,891,1210,6327,1935,10363
20-06-2019,04 - 05,930,1135,6399,1873,10337
20-06-2019,05 - 06,915,1267,6724,2001,10907
20-06-2019,06 - 07,977,1468,7633,2301,12379
20-06-2019,07 - 08,1072,1552,8763,2687,14074
20-06-2019,08 - 09,1121,1604,9307,2804,14836
20-06-2019,09 - 10,1040,1919,9505,2883,15347
20-06-2019,10 - 11,1037,1988,9570,2922,15517
20-06-2019,11 - 12,974,1841,9605,2856,15276
20-06-2019,12 - 13,1052,1811,9519,2817,15199
20-06-2019,13 - 14,1071,1849,9913,2734,15567
20-06-2019,14 - 15,1076,1868,9562,2715,15221
20-06-2019,15 - 16,963,1834,8447,2618,13862
20-06-2019,16 - 17,1118,1920,8213,2474,13725
20-06-2019,17 - 18,962,1777,8468,2420,13627
20-06-2019,18 - 19,1128,1456,8627,2443,13654
20-06-2019,19 - 20,1023,1509,8530,2383,13445
20-06-2019,20 - 21,1008,1655,8347,2238,13248
20-06-2019,21 - 22,886,1697,8132,2117,12832
20-06-2019,22 - 23,709,1521,7916,2111,12257
20-06-2019,23 - 00,826,1397,7348,1961,11532
21-06-2019,00 - 01,992,1237,6755,1803,10787
21-06-2019,01 - 02,951,1279,6441,1704,10375
21-06-2019,02 - 03,944,1260,6212,1682,10098
21-06-2019,03 - 04,835,1159,6065,1641,9700
21-06-2019,04 - 05,1044,1238,5930,1581,9793
21-06-2019,05 - 06,1005,1275,5978,1570,9828
21-06-2019,06 - 07,958,1382,6223,1712,10275
21-06-2019,07 - 08,978,1370,6616,1852,10816
21-06-2019,08 - 09,1005,1398,7110,2003,11516
21-06-2019,09 - 10,996,1453,7368,2111,11928
21-06-2019,10 - 11,1100,1456,7630,2161,12347
21-06-2019,11 - 12,1113,1435,7731,2203,12482
21-06-2019,12 - 13,1107,1440,7607,2220,12374
21-06-2019,13 - 14,1077,1410,7398,2163,12048
21-06-2019,14 - 15,1015,1432,7324,2112,11883
21-06-2019,15 - 16,1040,1350,7226,2012,11628
21-06-2019,16 - 17,964,1364,7138,1955,11421
21-06-2019,17 - 18,975,1403,7171,1966,11515
21-06-2019,18 - 19,1032,1373,7004,1919,11328
21-06-2019,19 - 20,1016,1328,6952,1840,11136
21-06-2019,20 - 21,958,1271,6786,1801,10816
21-06-2019,21 - 22,983,1284,6733,1749,10749
21-06-2019,22 - 23,973,1346,6709,1798,10826
21-06-2019,23 - 00,972,1301,6614,1804,10691
22-06-2019,00 - 01,879,1431,6412,1738,10460
22-06-2019,01 - 02,935,1482,6305,1633,10355
22-06-2019,02 - 03,998,1378,6092,1592,10060
22-06-2019,03 - 04,937,1273,5892,1512,9614
22-06-2019,04 - 05,918,1250,5826,1466,9460
22-06-2019,05 - 06,924,1428,5857,1512,9721
22-06-2019,06 - 07,929,1224,5977,1630,9760
22-06-2019,07 - 08,925,1366,6071,1662,10024
22-06-2019,08 - 09,896,1475,6337,1667,10375
22-06-2019,09 - 10,920,1558,6711,1761,10950
22-06-2019,10 - 11,923,1653,6958,1893,11427
22-06-2019,11 - 12,940,1559,7059,2013,11571
22-06-2019,12 - 13,1073,1545,6989,2034,11641
22-06-2019,13 - 14,979,1562,6988,1990,11519
22-06-2019,14 - 15,935,1657,6927,1972,11491
22-06-2019,15 - 16,1039,1509,6842,1960,11350
22-06-2019,16 - 17,1049,1668,6938,1968,11623
22-06-2019,17 - 18,1038,1583,7184,2012,11817
22-06-2019,18 - 19,1122,1508,7242,2051,11923
22-06-2019,19 - 20,1081,1436,7138,2013,11668
22-06-2019,20 - 21,1053,1490,7084,1990,11617
22-06-2019,21 - 22,1025,1589,7027,1968,11609
22-06-2019,22 - 23,998,1455,6903,1929,11285
22-06-2019,23 - 00,967,1518,6781,1827,11093
23-06-2019,00 - 01,968,1603,6528,1681,10780
23-06-2019,01 - 02,985,1524,6325,1568,10402
23-06-2019,02 - 03,993,1513,6233,1566,10305
23-06-2019,03 - 04,921,1471,6143,1638,10173
23-06-2019,04 - 05,930,1516,5921,1621,9988
23-06-2019,05 - 06,945,1631,5844,1555,9975
23-06-2019,06 - 07,981,1650,5923,1614,10168
23-06-2019,07 - 08,980,1567,6178,1694,10419
23-06-2019,08 - 09,1007,1567,6548,1802,10924
23-06-2019,09 - 10,966,1451,6846,1902,11165
23-06-2019,10 - 11,975,1498,7075,1959,11507
23-06-2019,11 - 12,1018,1627,7182,1976,11803
23-06-2019,12 - 13,1103,1626,7201,1983,11913
23-06-2019,13 - 14,1171,1586,7247,1963,11967
23-06-2019,14 - 15,1107,1461,7274,1922,11764
23-06-2019,15 - 16,1082,1437,7256,1915,11690
23-06-2019,16 - 17,1095,1473,7365,1935,11868
23-06-2019,17 - 18,1003,1346,7545,1970,11864
23-06-2019,18 - 19,1047,1476,7608,2045,12176
23-06-2019,19 - 20,1056,1550,7604,2097,12307
23-06-2019,20 - 21,1008,1462,7500,2111,12081
23-06-2019,21 - 22,1043,1560,7309,2040,11952
23-06-2019,22 - 23,1007,1362,7151,2037,11557
23-06-2019,23 - 00,973,1425,6970,1918,11286
24-06-2019,00 - 01,965,1313,6601,1776,10655
24-06-2019,01 - 02,929,1276,6485,1678,10368
24-06-2019,02 - 03,931,1451,6475,1632,10489
24-06-2019,03 - 04,882,1517,6385,1642,10426
24-06-2019,04 - 05,901,1505,6322,1612,10340
24-06-2019,05 - 06,923,1562,6541,1752,10778
24-06-2019,06 - 07,1100,1628,7582,2116,12426
24-06-2019,07 - 08,1218,1575,8669,2500,13962
24-06-2019,08 - 09,1234,1631,8951,2666,14482
24-06-2019,09 - 10,1091,1771,9109,2720,14691
24-06-2019,10 - 11,1177,1682,9323,2731,14913
24-06-2019,11 - 12,1064,1633,9266,2736,14699
24-06-2019,12 - 13,1011,1577,9277,2687,14552
24-06-2019,13 - 14,985,1821,9289,2661,14756
24-06-2019,14 - 15,1073,1741,9338,2621,14773
24-06-2019,15 - 16,1077,1794,9320,2663,14854
24-06-2019,16 - 17,1176,1724,9187,2602,14689
24-06-2019,17 - 18,1236,1711,9170,2523,14640
24-06-2019,18 - 19,1197,1676,8825,2405,14103
24-06-2019,19 - 20,1067,1586,8695,2406,13754
24-06-2019,20 - 21,1057,1505,8494,2354,13410
24-06-2019,21 - 22,1037,1527,8085,2261,12910
24-06-2019,22 - 23,999,1433,7780,2220,12432
24-06-2019,23 - 00,970,1278,7417,1973,11638
25-06-2019,00 - 01,970,1265,7103,1784,11122
25-06-2019,01 - 02,915,1273,6925,1773,10886
25-06-2019,02 - 03,905,1269,6804,1784,10762
25-06-2019,03 - 04,845,1323,6607,1775,10550
25-06-2019,04 - 05,916,1384,6521,1711,10532
25-06-2019,05 - 06,1072,1519,6911,1807,11309
25-06-2019,06 - 07,1051,1637,7904,2246,12838
25-06-2019,07 - 08,1004,1640,8817,2643,14104
25-06-2019,08 - 09,1077,1668,9209,2786,14740
25-06-2019,09 - 10,1045,1683,9289,2794,14811
25-06-2019,10 - 11,1170,1634,9355,2833,14992
25-06-2019,11 - 12,1100,1650,9431,2853,15034
25-06-2019,12 - 13,1127,1728,9602,2807,15264
25-06-2019,13 - 14,1136,1763,9524,2805,15228
25-06-2019,14 - 15,1139,1686,9471,2765,15061
25-06-2019,15 - 16,1073,1694,9375,2696,14838
25-06-2019,16 - 17,1048,1640,9197,2578,14463
25-06-2019,17 - 18,1079,1670,9130,2588,14467
25-06-2019,18 - 19,1061,1611,8860,2565,14097
25-06-2019,19 - 20,1038,1598,8692,2532,13860
25-06-2019,20 - 21,1077,1583,8464,2444,13568
25-06-2019,21 - 22,1015,1491,8241,2344,13091
25-06-2019,22 - 23,922,1505,7946,2276,12649
25-06-2019,23 - 00,824,1480,7591,2026,11921
26-06-2019,00 - 01,854,1415,7127,1861,11257
26-06-2019,01 - 02,941,1477,6849,1759,11026
26-06-2019,02 - 03,989,1450,6801,1721,10961
26-06-2019,03 - 04,956,1371,6680,1776,10783
26-06-2019,04 - 05,952,1365,6608,1737,10662
26-06-2019,05 - 06,990,1367,6942,1817,11116
26-06-2019,06 - 07,1057,1538,7819,2116,12530
26-06-2019,07 - 08,1020,1648,8841,2462,13971
26-06-2019,08 - 09,1068,1642,9284,2715,14709
26-06-2019,09 - 10,1040,1627,9447,2779,14893
26-06-2019,10 - 11,1050,1612,9677,2811,15150
26-06-2019,11 - 12,1032,1566,9748,2830,15176
26-06-2019,12 - 13,1028,1532,9824,2805,15189
26-06-2019,13 - 14,1042,1599,9891,2811,15343
26-06-2019,14 - 15,1010,1653,9808,2698,15169
26-06-2019,15 - 16,914,1754,9700,2682,15050
26-06-2019,16 - 17,970,1518,9361,2626,14475
26-06-2019,17 - 18,1021,1522,9193,2606,14342
26-06-2019,18 - 19,1046,1475,9178,2547,14246
26-06-2019,19 - 20,1011,1511,8970,2552,14044
26-06-2019,20 - 21,1029,1511,8816,2435,13791
26-06-2019,21 - 22,1040,1422,8524,2360,13346
26-06-2019,22 - 23,1022,1596,8177,2311,13106
26-06-2019,23 - 00,897,1542,7709,2135,12283
27-06-2019,00 - 01,931,1437,7195,1897,11460
27-06-2019,01 - 02,932,1390,7008,1776,11106
27-06-2019,02 - 03,979,1282,6974,1741,10976
27-06-2019,03 - 04,1003,1290,6780,1775,10848
27-06-2019,04 - 05,956,1338,6744,1759,10797
27-06-2019,05 - 06,1014,1478,7040,1780,11312
27-06-2019,06 - 07,998,1482,7922,2127,12529
27-06-2019,07 - 08,969,1675,8752,2474,13870
27-06-2019,08 - 09,959,1759,9561,2617,14896
27-06-2019,09 - 10,1082,1724,9951,2660,15417
27-06-2019,10 - 11,1077,1792,9642,2703,15214
27-06-2019,11 - 12,1099,1793,9655,2739,15286
27-06-2019,12 - 13,1141,1888,9656,2721,15406
27-06-2019,13 - 14,1169,1836,9690,2776,15471
27-06-2019,14 - 15,1125,1742,9411,2776,15054
27-06-2019,15 - 16,1075,1716,9324,2740,14855
27-06-2019,16 - 17,993,1661,9331,2620,14605
27-06-2019,17 - 18,997,1604,9186,2607,14394
27-06-2019,18 - 19,1002,1562,8998,2534,14096
27-06-2019,19 - 20,1030,1506,8835,2496,13867
27-06-2019,20 - 21,969,1487,8757,2424,13637
27-06-2019,21 - 22,1056,1596,8367,2369,13388
27-06-2019,22 - 23,1067,1521,8110,2312,13010
27-06-2019,23 - 00,1110,1450,7657,2136,12353
28-06-2019,00 - 01,1045,1129,7114,1985,11273
28-06-2019,01 - 02,970,1117,6821,1891,10799
28-06-2019,02 - 03,901,1318,6736,1912,10867
28-06-2019,03 - 04,874,1364,6668,1912,10818
28-06-2019,04 - 05,972,1307,6610,1810,10699
28-06-2019,05 - 06,1072,1493,6984,1873,11422
28-06-2019,06 - 07,1144,1806,7836,2231,13017
28-06-2019,07 - 08,1157,1852,8688,2545,14242
28-06-2019,08 - 09,1160,1702,9081,2729,14672
28-06-2019,09 - 10,1167,1679,9302,2702,14850
28-06-2019,10 - 11,1176,1717,9253,2729,14875
28-06-2019,11 - 12,1139,1715,9124,2683,14661
28-06-2019,12 - 13,1126,1668,9089,2658,14541
28-06-2019,13 - 14,1069,1599,8938,2625,14231
28-06-2019,14 - 15,1053,1660,8854,2586,14153
28-06-2019,15 - 16,1157,1829,8806,2523,14315
28-06-2019,16 - 17,1142,1886,8602,2474,14104
28-06-2019,17 - 18,1067,1870,8563,2451,13951
28-06-2019,18 - 19,1105,1791,8328,2380,13604
28-06-2019,19 - 20,1183,1721,8098,2307,13309
28-06-2019,20 - 21,1182,1527,7906,2211,12826
28-06-2019,21 - 22,1026,1393,7587,2132,12138
28-06-2019,22 - 23,920,1443,7418,2086,11867
28-06-2019,23 - 00,898,1505,7235,2010,11648
29-06-2019,00 - 01,829,1396,6773,1854,10852
29-06-2019,01 - 02,853,1272,6541,1811,10477
29-06-2019,02 - 03,851,1407,6387,1720,10365
29-06-2019,03 - 04,864,1376,6358,1644,10242
29-06-2019,04 - 05,970,1331,6156,1584,10041
29-06-2019,05 - 06,973,1461,6155,1648,10237
29-06-2019,06 - 07,1013,1436,6394,1786,10629
29-06-2019,07 - 08,942,1430,6744,1955,11071
29-06-2019,08 - 09,946,1531,7337,2136,11950
29-06-2019,09 - 10,980,1637,7708,2185,12510
29-06-2019,10 - 11,1054,1731,7918,2256,12959
29-06-2019,11 - 12,1044,1687,7933,2290,12954
29-06-2019,12 - 13,1015,1633,7819,2260,12727
29-06-2019,13 - 14,936,1516,7654,2269,12375
29-06-2019,14 - 15,860,1527,7691,2204,12282
29-06-2019,15 - 16,973,1533,7607,2175,12288
29-06-2019,16 - 17,1027,1554,7755,2221,12557
29-06-2019,17 - 18,1066,1457,7870,2323,12716
29-06-2019,18 - 19,1090,1327,7669,2312,12398
29-06-2019,19 - 20,1072,1359,7607,2304,12342
29-06-2019,20 - 21,1026,1359,7597,2244,12226
29-06-2019,21 - 22,1055,1555,7429,2145,12184
29-06-2019,22 - 23,999,1529,7238,2066,11832
29-06-2019,23 - 00,927,1484,7024,1911,11346
30-06-2019,00 - 01,883,1409,6805,1749,10846
30-06-2019,01 - 02,812,1270,6471,1631,10184
30-06-2019,02 - 03,962,1256,6374,1551,10143
30-06-2019,03 - 04,1010,1410,6193,1525,10138
30-06-2019,04 - 05,1049,1310,5953,1495,9807
30-06-2019,05 - 06,981,1340,5981,1425,9727
30-06-2019,06 - 07,1085,1356,6317,1521,10279
30-06-2019,07 - 08,1013,1371,6616,1662,10662
30-06-2019,08 - 09,1016,1433,7010,1855,11314
30-06-2019,09 - 10,997,1435,7405,2014,11851
30-06-2019,10 - 11,1033,1489,7567,2136,12225
30-06-2019,11 - 12,1014,1603,7675,2158,12450
30-06-2019,12 - 13,1075,1650,7621,2148,12494
30-06-2019,13 - 14,1034,1547,7530,2136,12247
30-06-2019,14 - 15,968,1616,7525,2092,12201
30-06-2019,15 - 16,951,1494,7536,2077,12058
30-06-2019,16 - 17,1031,1448,7579,2140,12198
30-06-2019,17 - 18,1092,1621,7822,2230,12765
30-06-2019,18 - 19,1063,1695,7774,2368,12900
30-06-2019,19 - 20,811,1537,7939,2374,12661
30-06-2019,20 - 21,1016,1533,7859,2335,12743
30-06-2019,21 - 22,944,1662,7657,2276,12539
30-06-2019,22 - 23,1010,1521,7458,2187,12176
30-06-2019,23 - 00,1026,1387,7269,2089,11771
01-07-2019,00 - 01,939,1373,6895,1963,11170
01-07-2019,01 - 02,972,1586,6703,1867,11128
01-07-2019,02 - 03,1077,1508,6689,1861,11135
01-07-2019,03 - 04,1014,1304,6624,1903,10845
01-07-2019,04 - 05,1004,1375,6526,1921,10826
01-07-2019,05 - 06,971,1403,6769,2047,11190
01-07-2019,06 - 07,1062,1650,7664,2332,12708
01-07-2019,07 - 08,1001,1768,8596,2575,13940
01-07-2019,08 - 09,1049,1691,8993,2683,14416
01-07-2019,09 - 10,1121,1808,9172,2761,14862
01-07-2019,10 - 11,1056,1767,9366,2850,15039
01-07-2019,11 - 12,1125,1751,9449,2865,15190
01-07-2019,12 - 13,1089,1800,9484,2881,15254
01-07-2019,13 - 14,1095,1729,9290,2918,15032
01-07-2019,14 - 15,1144,1653,9218,2873,14888
01-07-2019,15 - 16,1180,1686,9171,2770,14807
01-07-2019,16 - 17,1251,1576,9021,2695,14543
01-07-2019,17 - 18,1204,1678,9121,2776,14779
01-07-2019,18 - 19,1187,1765,9056,2753,14761
01-07-2019,19 - 20,1131,1654,8733,2582,14100
01-07-2019,20 - 21,1129,1538,8532,2528,13727
01-07-2019,21 - 22,1126,1624,8208,2413,13371
01-07-2019,22 - 23,1042,1617,7924,2365,12948
01-07-2019,23 - 00,993,1530,7575,2178,12276
02-07-2019,00 - 01,938,1198,7189,2060,11385
02-07-2019,01 - 02,980,1227,6887,1973,11067
02-07-2019,02 - 03,1005,1257,6766,1964,10992
02-07-2019,03 - 04,1046,1321,6714,1930,11011
02-07-2019,04 - 05,1043,1363,6675,1877,10958
02-07-2019,05 - 06,1157,1419,6990,1968,11534
02-07-2019,06 - 07,1160,1690,7778,2230,12858
02-07-2019,07 - 08,1124,1688,8616,2525,13953
02-07-2019,08 - 09,1142,1753,8951,2661,14507
02-07-2019,09 - 10,1064,1900,9284,2746,14994
02-07-2019,10 - 11,1094,1794,9654,2806,15348
02-07-2019,11 - 12,1093,1761,9660,2825,15339
02-07-2019,12 - 13,1097,1768,9590,2735,15190
02-07-2019,13 - 14,1060,1732,9447,2712,14951
02-07-2019,14 - 15,1051,1870,9370,2663,14954
02-07-2019,15 - 16,1049,1666,9138,2610,14463
02-07-2019,16 - 17,1059,1610,8872,2548,14089
02-07-2019,17 - 18,1102,1780,8917,2546,14345
02-07-2019,18 - 19,1095,1716,8723,2528,14062
02-07-2019,19 - 20,1134,1554,8663,2501,13852
02-07-2019,20 - 21,1139,1616,8459,2507,13721
02-07-2019,21 - 22,1114,1700,8219,2535,13568
02-07-2019,22 - 23,1052,1745,7908,2448,13153
02-07-2019,23 - 00,1076,1704,7530,2264,12574
03-07-2019,00 - 01,995,1547,7183,2080,11805
03-07-2019,01 - 02,918,1386,7043,1955,11302
03-07-2019,02 - 03,846,1242,6856,1954,10898
03-07-2019,03 - 04,868,1210,6803,1963,10844
03-07-2019,04 - 05,961,1215,6802,1901,10879
03-07-2019,05 - 06,989,1470,7051,2040,11550
03-07-2019,06 - 07,1076,1707,7815,2443,13041
03-07-2019,07 - 08,1119,1723,8562,2690,14094
03-07-2019,08 - 09,1066,1770,8859,2764,14459
03-07-2019,09 - 10,1096,1764,9190,2760,14810
03-07-2019,10 - 11,1068,1777,9239,2729,14813
03-07-2019,11 - 12,1116,1781,9240,2743,14880
03-07-2019,12 - 13,1235,1718,9225,2680,14858
03-07-2019,13 - 14,1089,1679,9079,2670,14517
03-07-2019,14 - 15,1026,1691,8994,2603,14314
03-07-2019,15 - 16,1109,1609,8959,2654,14331
03-07-2019,16 - 17,1067,1608,8901,2565,14141
03-07-2019,17 - 18,1121,1648,8877,2579,14225
03-07-2019,18 - 19,1060,1573,8767,2581,13981
03-07-2019,19 - 20,837,1562,8660,2519,13578
03-07-2019,20 - 21,972,1673,8512,2444,13601
03-07-2019,21 - 22,1107,1684,8238,2420,13449
03-07-2019,22 - 23,1041,1572,8040,2380,13033
03-07-2019,23 - 00,972,1402,7685,2201,12260
04-07-2019,00 - 01,822,1297,7188,1966,11273
04-07-2019,01 - 02,851,1392,7058,1893,11194
04-07-2019,02 - 03,920,1464,6955,1887,11226
04-07-2019,03 - 04,948,1486,6906,1874,11214
04-07-2019,04 - 05,898,1576,6742,1838,11054
04-07-2019,05 - 06,784,1691,7080,1991,11546
04-07-2019,06 - 07,952,1754,8052,2380,13138
04-07-2019,07 - 08,968,1800,8722,2698,14188
04-07-2019,08 - 09,970,1805,9003,2715,14493
04-07-2019,09 - 10,879,1781,9203,2756,14619
04-07-2019,10 - 11,912,1755,9366,2815,14848
04-07-2019,11 - 12,1003,1732,9523,2842,15100
04-07-2019,12 - 13,1003,1733,9342,2886,14964
04-07-2019,13 - 14,1021,1769,9219,2861,14870
04-07-2019,14 - 15,1005,1747,9189,2808,14749
04-07-2019,15 - 16,1026,1743,9194,2796,14759
04-07-2019,16 - 17,980,1773,9178,2755,14686
04-07-2019,17 - 18,1009,1732,9350,2706,14797
04-07-2019,18 - 19,1008,1689,9331,2675,14703
04-07-2019,19 - 20,1099,1728,9141,2605,14573
04-07-2019,20 - 21,1076,1768,8886,2556,14286
04-07-2019,21 - 22,938,1615,8471,2483,13507
04-07-2019,22 - 23,984,1502,8234,2469,13189
04-07-2019,23 - 00,951,1428,7893,2289,12561
05-07-2019,00 - 01,969,1217,7401,2114,11701
05-07-2019,01 - 02,919,1324,7210,1976,11429
05-07-2019,02 - 03,882,1415,7159,1867,11323
05-07-2019,03 - 04,843,1498,7117,1859,11317
05-07-2019,04 - 05,825,1429,7049,1800,11103
05-07-2019,05 - 06,839,1389,7387,1952,11567
05-07-2019,06 - 07,967,1565,8288,2320,13140
05-07-2019,07 - 08,1023,1800,8913,2569,14305
05-07-2019,08 - 09,989,1840,9114,2607,14550
05-07-2019,09 - 10,989,1758,9219,2512,14478
05-07-2019,10 - 11,1047,1643,9376,2502,14568
05-07-2019,11 - 12,1019,1610,9356,2454,14439
05-07-2019,12 - 13,1034,1635,9314,2444,14427
05-07-2019,13 - 14,961,1692,9222,2416,14291
05-07-2019,14 - 15,1042,1676,9046,2345,14109
05-07-2019,15 - 16,1001,1666,8924,2306,13897
05-07-2019,16 - 17,953,1591,8984,2252,13780
05-07-2019,17 - 18,1020,1571,9024,2245,13860
05-07-2019,18 - 19,1009,1546,8792,2275,13622
05-07-2019,19 - 20,919,1561,8536,2293,13309
05-07-2019,20 - 21,903,1647,8212,2308,13070
05-07-2019,21 - 22,945,1607,7808,2188,12548
05-07-2019,22 - 23,904,1526,7559,2137,12126
05-07-2019,23 - 00,910,1446,7349,1977,11682
06-07-2019,00 - 01,961,1428,7121,1792,11302
06-07-2019,01 - 02,906,1502,6862,1681,10951
06-07-2019,02 - 03,808,1408,6672,1695,10583
06-07-2019,03 - 04,833,1358,6661,1745,10597
06-07-2019,04 - 05,762,1437,6547,1682,10428
06-07-2019,05 - 06,868,1412,6525,1650,10455
06-07-2019,06 - 07,925,1393,6683,1738,10739
06-07-2019,07 - 08,916,1391,6951,1856,11114
06-07-2019,08 - 09,904,1495,7399,2037,11835
06-07-2019,09 - 10,866,1652,7782,2169,12469
06-07-2019,10 - 11,1034,1622,7845,2202,12703
06-07-2019,11 - 12,1054,1667,7903,2176,12800
06-07-2019,12 - 13,1058,1550,8003,2143,12754
06-07-2019,13 - 14,1050,1581,7872,2047,12550
06-07-2019,14 - 15,1015,1545,7721,1972,12253
06-07-2019,15 - 16,1032,1550,7567,1997,12146
06-07-2019,16 - 17,1032,1445,7545,1990,12012
06-07-2019,17 - 18,997,1544,7584,2025,12150
06-07-2019,18 - 19,1033,1563,7561,2012,12169
06-07-2019,19 - 20,1016,1559,7595,2078,12248
06-07-2019,20 - 21,1020,1504,7525,2080,12129
06-07-2019,21 - 22,1032,1436,7343,2036,11847
06-07-2019,22 - 23,989,1458,7305,1941,11693
06-07-2019,23 - 00,959,1420,6998,1819,11196
07-07-2019,00 - 01,945,1323,6694,1714,10676
07-07-2019,01 - 02,929,1367,6497,1652,10445
07-07-2019,02 - 03,894,1315,6372,1616,10197
07-07-2019,03 - 04,864,1266,6259,1617,10006
07-07-2019,04 - 05,876,1227,6161,1618,9882
07-07-2019,05 - 06,882,1224,6081,1570,9757
07-07-2019,06 - 07,951,1303,6203,1630,10087
07-07-2019,07 - 08,935,1362,6568,1747,10612
07-07-2019,08 - 09,937,1358,6863,1853,11011
07-07-2019,09 - 10,1012,1486,7133,1996,11627
07-07-2019,10 - 11,998,1470,7484,1983,11935
07-07-2019,11 - 12,992,1558,7572,2021,12143
07-07-2019,12 - 13,928,1530,7665,2015,12138
07-07-2019,13 - 14,976,1541,7734,1979,12230
07-07-2019,14 - 15,988,1525,7650,1905,12068
07-07-2019,15 - 16,956,1532,7646,1856,11990
07-07-2019,16 - 17,991,1531,7659,1923,12104
07-07-2019,17 - 18,896,1550,7805,2028,12279
07-07-2019,18 - 19,873,1716,7866,2106,12561
07-07-2019,19 - 20,910,1595,7872,2149,12526
07-07-2019,20 - 21,829,1562,7754,2129,12274
07-07-2019,21 - 22,938,1505,7620,2090,12153
07-07-2019,22 - 23,886,1485,7554,2048,11973
07-07-2019,23 - 00,797,1443,7329,1966,11535
08-07-2019,00 - 01,890,1404,6853,1815,10962
08-07-2019,01 - 02,884,1456,6729,1754,10823
08-07-2019,02 - 03,894,1418,6673,1766,10751
08-07-2019,03 - 04,881,1479,6539,1735,10634
08-07-2019,04 - 05,914,1428,6485,1752,10579
08-07-2019,05 - 06,847,1254,6749,1782,10632
08-07-2019,06 - 07,919,1444,7445,2033,11841
08-07-2019,07 - 08,867,1654,8204,2314,13039
08-07-2019,08 - 09,847,1664,8741,2525,13777
08-07-2019,09 - 10,1049,1655,8861,2595,14160
08-07-2019,10 - 11,1057,1822,9060,2603,14542
08-07-2019,11 - 12,1072,1791,9179,2583,14625
08-07-2019,12 - 13,1058,1817,9179,2478,14532
08-07-2019,13 - 14,1026,1820,9049,2391,14286
08-07-2019,14 - 15,974,1758,9023,2385,14140
08-07-2019,15 - 16,989,1716,8910,2395,14010
08-07-2019,16 - 17,991,1692,8774,2505,13962
08-07-2019,17 - 18,1039,1637,8781,2476,13933
08-07-2019,18 - 19,1010,1657,8530,2408,13605
08-07-2019,19 - 20,1087,1630,8419,2365,13501
08-07-2019,20 - 21,1069,1600,8340,2305,13314
08-07-2019,21 - 22,1095,1609,8097,2231,13032
08-07-2019,22 - 23,966,1467,7905,2152,12490
08-07-2019,23 - 00,805,1407,7570,1971,11753
09-07-2019,00 - 01,782,1462,6993,1851,11088
09-07-2019,01 - 02,726,1471,6616,1727,10540
09-07-2019,02 - 03,844,1369,6554,1705,10472
09-07-2019,03 - 04,912,1308,6543,1756,10519
09-07-2019,04 - 05,907,1286,6491,1781,10465
09-07-2019,05 - 06,947,1222,6721,1847,10737
09-07-2019,06 - 07,978,1401,7489,2139,12007
09-07-2019,07 - 08,966,1528,8236,2411,13141
09-07-2019,08 - 09,929,1597,8735,2536,13797
09-07-2019,09 - 10,844,1437,9007,2560,13848
09-07-2019,10 - 11,943,1573,9066,2590,14172
09-07-2019,11 - 12,984,1618,9083,2611,14296
09-07-2019,12 - 13,1047,1839,9030,2603,14519
09-07-2019,13 - 14,1037,1713,8913,2596,14259
09-07-2019,14 - 15,1048,1552,8774,2505,13879
09-07-2019,15 - 16,1012,1565,8693,2456,13726
09-07-2019,16 - 17,997,1611,8512,2413,13533
09-07-2019,17 - 18,1119,1646,8569,2455,13789
09-07-2019,18 - 19,1077,1687,8581,2434,13779
09-07-2019,19 - 20,1074,1619,8526,2429,13648
09-07-2019,20 - 21,990,1705,8390,2351,13436
09-07-2019,21 - 22,945,1723,8211,2230,13109
09-07-2019,22 - 23,977,1519,8079,2176,12751
09-07-2019,23 - 00,926,1584,7686,2000,12196
10-07-2019,00 - 01,1015,1592,7239,1835,11681
10-07-2019,01 - 02,872,1567,7006,1722,11167
10-07-2019,02 - 03,837,1511,6904,1661,10913
10-07-2019,03 - 04,812,1392,6729,1690,10623
10-07-2019,04 - 05,833,1351,6606,1677,10467
10-07-2019,05 - 06,781,1328,6835,1733,10677
10-07-2019,06 - 07,837,1398,7395,1971,11601
10-07-2019,07 - 08,1112,1566,8175,2245,13098
10-07-2019,08 - 09,933,1676,8588,2466,13663
10-07-2019,09 - 10,1023,1795,8701,2521,14040
10-07-2019,10 - 11,895,1849,8710,2559,14013
10-07-2019,11 - 12,866,1719,8744,2544,13873
10-07-2019,12 - 13,878,1581,8682,2476,13617
10-07-2019,13 - 14,891,1656,8687,2398,13632
10-07-2019,14 - 15,951,1598,8550,2408,13507
10-07-2019,15 - 16,803,1633,8441,2365,13242
10-07-2019,16 - 17,887,1653,8291,2400,13231
10-07-2019,17 - 18,903,1668,8472,2391,13434
10-07-2019,18 - 19,967,1685,8326,2413,13391
10-07-2019,19 - 20,926,1636,8213,2316,13091
10-07-2019,20 - 21,1002,1658,8045,2223,12928
10-07-2019,21 - 22,1048,1626,7731,2216,12621
10-07-2019,22 - 23,974,1557,7652,2200,12383
10-07-2019,23 - 00,924,1535,7192,2016,11667
11-07-2019,00 - 01,842,1368,6757,1840,10807
11-07-2019,01 - 02,872,1378,6540,1789,10579
11-07-2019,02 - 03,859,1351,6352,1810,10372
11-07-2019,03 - 04,816,1348,6262,1817,10243
11-07-2019,04 - 05,879,1346,6140,1799,10164
11-07-2019,05 - 06,970,1396,6389,1843,10598
11-07-2019,06 - 07,916,1476,6988,2036,11416
11-07-2019,07 - 08,823,1658,7667,2270,12418
11-07-2019,08 - 09,962,1746,8159,2421,13288
11-07-2019,09 - 10,975,1807,8417,2512,13711
11-07-2019,10 - 11,995,1712,8563,2537,13807
11-07-2019,11 - 12,1012,1762,8606,2484,13864
11-07-2019,12 - 13,986,1684,8511,2497,13678
11-07-2019,13 - 14,955,1683,8419,2491,13548
11-07-2019,14 - 15,1022,1630,8371,2444,13467
11-07-2019,15 - 16,979,1700,8427,2414,13520
11-07-2019,16 - 17,1004,1665,8332,2392,13393
11-07-2019,17 - 18,979,1626,8323,2383,13311
11-07-2019,18 - 19,922,1598,8142,2334,12996
11-07-2019,19 - 20,957,1612,7974,2282,12825
11-07-2019,20 - 21,955,1562,7817,2203,12537
11-07-2019,21 - 22,960,1484,7544,2167,12155
11-07-2019,22 - 23,857,1580,7419,2159,12015
11-07-2019,23 - 00,985,1505,7054,2012,11556
12-07-2019,00 - 01,931,1354,6634,1884,10803
12-07-2019,01 - 02,798,1274,6361,1816,10249
12-07-2019,02 - 03,812,1292,6275,1773,10152
12-07-2019,03 - 04,832,1246,6273,1766,10117
12-07-2019,04 - 05,952,1230,6261,1735,10178
12-07-2019,05 - 06,891,1342,6425,1767,10425
12-07-2019,06 - 07,939,1542,7017,1986,11484
12-07-2019,07 - 08,942,1630,7599,2211,12382
12-07-2019,08 - 09,895,1701,8086,2390,13072
12-07-2019,09 - 10,933,1754,8381,2497,13565
12-07-2019,10 - 11,965,1646,8475,2549,13635
12-07-2019,11 - 12,981,1651,8372,2532,13536
12-07-2019,12 - 13,991,1699,8328,2487,13505
12-07-2019,13 - 14,999,1627,8291,2393,13310
12-07-2019,14 - 15,985,1581,8318,2296,13180
12-07-2019,15 - 16,902,1497,8190,2259,12848
12-07-2019,16 - 17,915,1559,7994,2228,12696
12-07-2019,17 - 18,969,1611,7974,2284,12838
12-07-2019,18 - 19,963,1562,7808,2279,12612
12-07-2019,19 - 20,943,1521,7589,2197,12250
12-07-2019,20 - 21,958,1490,7298,2077,11823
12-07-2019,21 - 22,963,1501,7100,2038,11602
12-07-2019,22 - 23,911,1503,7059,2021,11494
12-07-2019,23 - 00,862,1548,6810,1894,11114
13-07-2019,00 - 01,941,1374,6486,1763,10564
13-07-2019,01 - 02,893,1434,6135,1681,10143
13-07-2019,02 - 03,953,1388,5966,1632,9939
13-07-2019,03 - 04,742,1433,5915,1614,9704
13-07-2019,04 - 05,820,1359,5742,1565,9486
13-07-2019,05 - 06,972,1269,5711,1519,9471
13-07-2019,06 - 07,851,1395,5899,1613,9758
13-07-2019,07 - 08,931,1436,6245,1767,10379
13-07-2019,08 - 09,931,1541,6630,1952,11054
13-07-2019,09 - 10,827,1461,7037,2052,11377
13-07-2019,10 - 11,827,1490,7298,2133,11748
13-07-2019,11 - 12,885,1511,7382,2169,11947
13-07-2019,12 - 13,912,1446,7303,2138,11799
13-07-2019,13 - 14,892,1345,7119,2028,11384
13-07-2019,14 - 15,882,1302,6972,1928,11084
13-07-2019,15 - 16,918,1358,6933,1889,11098
13-07-2019,16 - 17,921,1471,7018,1875,11285
13-07-2019,17 - 18,900,1505,7147,1955,11507
13-07-2019,18 - 19,1048,1512,7160,2037,11757
13-07-2019,19 - 20,945,1452,7195,2020,11612
13-07-2019,20 - 21,1018,1427,7034,1952,11431
13-07-2019,21 - 22,835,1397,6904,1892,11028
13-07-2019,22 - 23,825,1393,6856,1914,10988
13-07-2019,23 - 00,728,1532,6643,1818,10721
14-07-2019,00 - 01,802,1404,6246,1654,10106
14-07-2019,01 - 02,820,1367,6053,1544,9784
14-07-2019,02 - 03,771,1258,5950,1514,9493
14-07-2019,03 - 04,765,1152,5827,1506,9250
14-07-2019,04 - 05,796,1197,5691,1466,9150
14-07-2019,05 - 06,875,1169,5597,1424,9065
14-07-2019,06 - 07,826,1339,5683,1448,9296
14-07-2019,07 - 08,897,1363,5938,1596,9794
14-07-2019,08 - 09,875,1451,6373,1771,10470
14-07-2019,09 - 10,913,1403,6757,1925,10998
14-07-2019,10 - 11,999,1523,6960,1994,11476
14-07-2019,11 - 12,974,1511,7053,2012,11550
14-07-2019,12 - 13,973,1577,7064,2037,11651
14-07-2019,13 - 14,936,1364,6985,1983,11268
14-07-2019,14 - 15,895,1359,6936,1969,11159
14-07-2019,15 - 16,900,1425,6959,1952,11236
14-07-2019,16 - 17,919,1439,6932,1992,11282
14-07-2019,17 - 18,915,1471,6967,2074,11427
14-07-2019,18 - 19,849,1484,7091,2098,11522
14-07-2019,19 - 20,906,1471,7206,2085,11668
14-07-2019,20 - 21,950,1398,7168,2069,11585
14-07-2019,21 - 22,910,1429,7039,2025,11403
14-07-2019,22 - 23,802,1393,6971,2036,11202
14-07-2019,23 - 00,859,1355,6547,1923,10684
15-07-2019,00 - 01,886,1310,6015,1769,9980
15-07-2019,01 - 02,852,1338,5831,1670,9691
15-07-2019,02 - 03,849,1366,5775,1588,9578
15-07-2019,03 - 04,754,1238,5631,1530,9153
15-07-2019,04 - 05,826,1151,5451,1539,8967
15-07-2019,05 - 06,863,1218,5723,1610,9414
15-07-2019,06 - 07,892,1400,6323,1870,10485
15-07-2019,07 - 08,958,1569,6940,2148,11615
15-07-2019,08 - 09,950,1710,7607,2333,12600
15-07-2019,09 - 10,988,1756,7930,2413,13087
15-07-2019,10 - 11,989,1696,8083,2463,13231
15-07-2019,11 - 12,967,1750,8146,2434,13297
15-07-2019,12 - 13,984,1804,8252,2408,13448
15-07-2019,13 - 14,1013,1771,8270,2424,13478
15-07-2019,14 - 15,1024,1784,8247,2402,13457
15-07-2019,15 - 16,1007,1625,8197,2371,13200
15-07-2019,16 - 17,984,1760,8145,2296,13185
15-07-2019,17 - 18,1008,1761,8139,2332,13240
15-07-2019,18 - 19,998,1773,8028,2357,13156
15-07-2019,19 - 20,1015,1705,7847,2318,12885
15-07-2019,20 - 21,972,1573,7590,2207,12342
15-07-2019,21 - 22,957,1547,7344,2135,11983
15-07-2019,22 - 23,926,1511,7159,2082,11678
15-07-2019,23 - 00,867,1372,6651,1935,10825
16-07-2019,00 - 01,858,1272,6245,1721,10096
16-07-2019,01 - 02,837,1234,6001,1611,9683
16-07-2019,02 - 03,880,1224,6034,1574,9712
16-07-2019,03 - 04,855,1176,6055,1556,9642
16-07-2019,04 - 05,847,1092,5898,1586,9423
16-07-2019,05 - 06,872,1182,6002,1634,9690
16-07-2019,06 - 07,924,1336,6689,1875,10824
16-07-2019,07 - 08,850,1403,7286,2125,11664
16-07-2019,08 - 09,953,1417,7693,2292,12355
16-07-2019,09 - 10,1070,1467,8007,2386,12930
16-07-2019,10 - 11,1049,1553,8191,2404,13197
16-07-2019,11 - 12,1001,1653,8319,2396,13369
16-07-2019,12 - 13,1072,1729,8370,2392,13563
16-07-2019,13 - 14,1000,1740,8188,2358,13286
16-07-2019,14 - 15,980,1653,8152,2251,13036
16-07-2019,15 - 16,963,1521,8028,2234,12746
16-07-2019,16 - 17,942,1492,7967,2243,12644
16-07-2019,17 - 18,956,1689,7938,2264,12847
16-07-2019,18 - 19,939,1578,7783,2272,12572
16-07-2019,19 - 20,965,1558,7711,2291,12525
16-07-2019,20 - 21,944,1466,7533,2210,12153
16-07-2019,21 - 22,920,1409,7262,2118,11709
16-07-2019,22 - 23,898,1424,7130,2062,11514
16-07-2019,23 - 00,878,1436,6792,1948,11054
17-07-2019,00 - 01,820,1507,6441,1749,10517
17-07-2019,01 - 02,846,1384,6174,1627,10031
17-07-2019,02 - 03,831,1408,6101,1564,9904
17-07-2019,03 - 04,786,1405,6038,1561,9790
17-07-2019,04 - 05,800,1380,5937,1538,9655
17-07-2019,05 - 06,801,1424,6125,1643,9993
17-07-2019,06 - 07,851,1484,6669,1913,10917
17-07-2019,07 - 08,905,1546,7376,2158,11985
17-07-2019,08 - 09,884,1600,7751,2280,12515
17-07-2019,09 - 10,960,1576,7991,2347,12874
17-07-2019,10 - 11,979,1647,8075,2360,13061
17-07-2019,11 - 12,935,1536,8060,2371,12902
17-07-2019,12 - 13,940,1534,8074,2342,12890
17-07-2019,13 - 14,908,1482,8057,2327,12774
17-07-2019,14 - 15,865,1510,7995,2281,12651
17-07-2019,15 - 16,925,1509,7947,2287,12668
17-07-2019,16 - 17,951,1515,7860,2272,12598
17-07-2019,17 - 18,935,1499,7915,2285,12634
17-07-2019,18 - 19,974,1476,7825,2284,12559
17-07-2019,19 - 20,946,1461,7410,2224,12041
17-07-2019,20 - 21,950,1505,6995,2172,11622
17-07-2019,21 - 22,927,1403,6989,2115,11434
17-07-2019,22 - 23,948,1319,7076,2094,11437
17-07-2019,23 - 00,910,1286,6650,1958,10804
18-07-2019,00 - 01,921,1247,6456,1847,10471
18-07-2019,01 - 02,898,1385,6215,1759,10257
18-07-2019,02 - 03,890,1333,6067,1719,10009
18-07-2019,03 - 04,854,1288,6258,1715,10115
18-07-2019,04 - 05,835,1249,6274,1694,10052
18-07-2019,05 - 06,861,1228,6111,1746,9946
18-07-2019,06 - 07,928,1301,6683,1919,10831
18-07-2019,07 - 08,892,1485,7294,2118,11789
18-07-2019,08 - 09,953,1567,7696,2280,12496
18-07-2019,09 - 10,877,1542,7943,2350,12712
18-07-2019,10 - 11,950,1583,8067,2397,12997
18-07-2019,11 - 12,890,1620,8126,2397,13033
18-07-2019,12 - 13,914,1469,8099,2388,12870
18-07-2019,13 - 14,875,1472,8106,2365,12818
18-07-2019,14 - 15,851,1496,8136,2330,12813
18-07-2019,15 - 16,892,1538,8058,2305,12793
18-07-2019,16 - 17,933,1491,8037,2287,12748
18-07-2019,17 - 18,911,1565,8105,2326,12907
18-07-2019,18 - 19,937,1464,8027,2310,12738
18-07-2019,19 - 20,984,1447,7871,2247,12549
18-07-2019,20 - 21,975,1437,7637,2167,12216
18-07-2019,21 - 22,907,1352,7407,2106,11772
18-07-2019,22 - 23,886,1298,7257,2097,11538
18-07-2019,23 - 00,841,1280,6831,1976,10928
19-07-2019,00 - 01,888,1230,6411,1826,10355
19-07-2019,01 - 02,873,1133,6187,1733,9926
19-07-2019,02 - 03,874,1131,6186,1685,9876
19-07-2019,03 - 04,838,1172,6160,1666,9836
19-07-2019,04 - 05,841,1270,6013,1629,9753
19-07-2019,05 - 06,836,1232,6162,1647,9877
19-07-2019,06 - 07,855,1415,6685,1839,10794
19-07-2019,07 - 08,893,1492,7303,2083,11771
19-07-2019,08 - 09,937,1577,7900,2298,12712
19-07-2019,09 - 10,899,1584,8095,2360,12938
19-07-2019,10 - 11,930,1593,8246,2388,13157
19-07-2019,11 - 12,924,1643,8197,2371,13135
19-07-2019,12 - 13,920,1595,8156,2303,12974
19-07-2019,13 - 14,924,1592,8148,2280,12944
19-07-2019,14 - 15,915,1660,8074,2255,12904
19-07-2019,15 - 16,931,1570,7969,2269,12739
19-07-2019,16 - 17,934,1583,7821,2236,12574
19-07-2019,17 - 18,998,1619,7804,2268,12689
19-07-2019,18 - 19,966,1512,7767,2264,12509
19-07-2019,19 - 20,930,1357,7545,2246,12078
19-07-2019,20 - 21,880,1321,7276,2155,11632
19-07-2019,21 - 22,833,1323,7084,2089,11329
19-07-2019,22 - 23,781,1265,7056,2058,11160
19-07-2019,23 - 00,740,1255,6703,1926,10624
20-07-2019,00 - 01,799,1290,6382,1808,10279
20-07-2019,01 - 02,877,1275,6074,1682,9908
20-07-2019,02 - 03,798,1271,5884,1607,9560
20-07-2019,03 - 04,713,1221,5819,1628,9381
20-07-2019,04 - 05,788,1210,5730,1582,9310
20-07-2019,05 - 06,858,1208,5716,1528,9310
20-07-2019,06 - 07,865,1258,5864,1566,9553
20-07-2019,07 - 08,849,1377,6153,1681,10060
20-07-2019,08 - 09,893,1385,6552,1834,10664
20-07-2019,09 - 10,933,1465,6860,1976,11234
20-07-2019,10 - 11,885,1408,6977,2038,11308
20-07-2019,11 - 12,855,1375,7039,2014,11283
20-07-2019,12 - 13,888,1274,7045,1992,11199
20-07-2019,13 - 14,917,1245,6995,1983,11140
20-07-2019,14 - 15,874,1306,6944,1930,11054
20-07-2019,15 - 16,878,1344,6835,1909,10966
20-07-2019,16 - 17,821,1315,6841,1950,10927
20-07-2019,17 - 18,797,1267,6964,1972,11000
20-07-2019,18 - 19,854,1402,7021,2030,11307
20-07-2019,19 - 20,998,1433,7076,2009,11516
20-07-2019,20 - 21,964,1314,7022,1908,11208
20-07-2019,21 - 22,850,1488,6737,1835,10910
20-07-2019,22 - 23,795,1439,6693,1802,10729
20-07-2019,23 - 00,882,1233,6444,1750,10309
21-07-2019,00 - 01,865,1086,6180,1728,9859
21-07-2019,01 - 02,742,1193,5988,1652,9575
21-07-2019,02 - 03,701,1124,5827,1653,9305
21-07-2019,03 - 04,689,1146,5751,1626,9212
21-07-2019,04 - 05,786,1173,5549,1602,9110
21-07-2019,05 - 06,791,1156,5501,1552,9000
21-07-2019,06 - 07,779,1082,5482,1595,8938
21-07-2019,07 - 08,831,1114,5719,1691,9355
21-07-2019,08 - 09,881,1262,6156,1834,10133
21-07-2019,09 - 10,893,1345,6592,1965,10795
21-07-2019,10 - 11,925,1281,6864,2032,11102
21-07-2019,11 - 12,922,1267,7052,2097,11338
21-07-2019,12 - 13,935,1303,7107,2043,11388
21-07-2019,13 - 14,917,1375,7027,2002,11321
21-07-2019,14 - 15,920,1324,7052,1920,11216
21-07-2019,15 - 16,906,1274,7107,1855,11142
21-07-2019,16 - 17,853,1292,7076,1881,11102
21-07-2019,17 - 18,875,1389,7133,1949,11346
21-07-2019,18 - 19,922,1410,7234,2012,11578
21-07-2019,19 - 20,982,1458,7243,1970,11653
21-07-2019,20 - 21,1019,1603,7136,1905,11663
21-07-2019,21 - 22,971,1445,7014,1927,11357
21-07-2019,22 - 23,923,1445,6774,1988,11130
21-07-2019,23 - 00,921,1357,6355,1787,10420
22-07-2019,00 - 01,800,1227,6041,1713,9781
22-07-2019,01 - 02,730,1245,5848,1662,9485
22-07-2019,02 - 03,835,1278,5782,1539,9434
22-07-2019,03 - 04,909,1319,5733,1548,9509
22-07-2019,04 - 05,909,1345,5686,1568,9508
22-07-2019,05 - 06,760,1265,5777,1608,9410
22-07-2019,06 - 07,878,1333,6259,1860,10330
22-07-2019,07 - 08,938,1394,6884,2082,11298
22-07-2019,08 - 09,984,1505,7341,2240,12070
22-07-2019,09 - 10,1023,1536,7619,2262,12440
22-07-2019,10 - 11,1010,1538,7809,2256,12613
22-07-2019,11 - 12,1016,1492,7823,2220,12551
22-07-2019,12 - 13,977,1546,7880,2235,12638
22-07-2019,13 - 14,951,1582,7941,2268,12742
22-07-2019,14 - 15,955,1553,7991,2275,12774
22-07-2019,15 - 16,989,1590,7909,2273,12761
22-07-2019,16 - 17,1025,1610,7830,2220,12685
22-07-2019,17 - 18,927,1547,7868,2236,12578
22-07-2019,18 - 19,956,1577,7796,2317,12646
22-07-2019,19 - 20,971,1580,7651,2256,12458
22-07-2019,20 - 21,1044,1496,7423,2149,12112
22-07-2019,21 - 22,968,1442,7138,2128,11676
22-07-2019,22 - 23,949,1456,7027,2054,11486
22-07-2019,23 - 00,928,1443,6566,1913,10850
23-07-2019,00 - 01,916,1345,6151,1801,10213
23-07-2019,01 - 02,898,1380,6006,1715,9999
23-07-2019,02 - 03,890,1325,5957,1636,9808
23-07-2019,03 - 04,912,1319,5840,1610,9681
23-07-2019,04 - 05,865,1316,5768,1565,9514
23-07-2019,05 - 06,862,1350,5872,1583,9667
23-07-2019,06 - 07,888,1380,6347,1762,10377
23-07-2019,07 - 08,898,1419,6961,1996,11274
23-07-2019,08 - 09,917,1512,7405,2145,11979
23-07-2019,09 - 10,910,1564,7720,2277,12471
23-07-2019,10 - 11,903,1589,7959,2378,12829
23-07-2019,11 - 12,879,1595,8005,2406,12885
23-07-2019,12 - 13,883,1633,8020,2402,12938
23-07-2019,13 - 14,878,1555,8016,2391,12840
23-07-2019,14 - 15,916,1519,7967,2366,12768
23-07-2019,15 - 16,944,1525,7895,2326,12690
23-07-2019,16 - 17,990,1551,7787,2276,12604
23-07-2019,17 - 18,970,1560,7738,2242,12510
23-07-2019,18 - 19,970,1586,7706,2225,12487
23-07-2019,19 - 20,972,1539,7507,2199,12217
23-07-2019,20 - 21,898,1553,7322,2164,11937
23-07-2019,21 - 22,986,1482,7096,2118,11682
23-07-2019,22 - 23,947,1450,6960,2086,11443
23-07-2019,23 - 00,980,1404,6575,1902,10861
24-07-2019,00 - 01,899,1324,6287,1763,10273
24-07-2019,01 - 02,932,1242,6050,1678,9902
24-07-2019,02 - 03,901,1273,5979,1634,9787
24-07-2019,03 - 04,898,1256,5937,1618,9709
24-07-2019,04 - 05,877,1212,5856,1595,9540
24-07-2019,05 - 06,842,1126,5888,1601,9457
24-07-2019,06 - 07,907,1242,6340,1733,10222
24-07-2019,07 - 08,907,1406,6949,1952,11214
24-07-2019,08 - 09,968,1485,7449,2131,12033
24-07-2019,09 - 10,947,1663,7726,2229,12565
24-07-2019,10 - 11,966,1734,7931,2299,12930
24-07-2019,11 - 12,925,1746,8020,2312,13003
24-07-2019,12 - 13,1100,1707,7973,2291,13071
24-07-2019,13 - 14,912,1672,7860,2285,12729
24-07-2019,14 - 15,947,1723,7803,2262,12735
24-07-2019,15 - 16,956,1738,7780,2251,12725
24-07-2019,16 - 17,943,1784,7764,2223,12714
24-07-2019,17 - 18,917,1809,7776,2243,12745
24-07-2019,18 - 19,1032,1631,7717,2228,12608
24-07-2019,19 - 20,824,1607,7552,2185,12168
24-07-2019,20 - 21,958,1505,7331,2119,11913
24-07-2019,21 - 22,983,1500,7104,2059,11646
24-07-2019,22 - 23,906,1461,7071,2049,11487
24-07-2019,23 - 00,843,1420,6745,1879,10887
25-07-2019,00 - 01,784,1261,6349,1709,10103
25-07-2019,01 - 02,771,1248,6008,1617,9644
25-07-2019,02 - 03,735,1203,5808,1602,9348
25-07-2019,03 - 04,784,1210,5536,1607,9137
25-07-2019,04 - 05,742,1222,5465,1621,9050
25-07-2019,05 - 06,837,1263,5774,1616,9490
25-07-2019,06 - 07,852,1294,6365,1728,10239
25-07-2019,07 - 08,851,1334,7101,1961,11247
25-07-2019,08 - 09,913,1532,7629,2136,12210
25-07-2019,09 - 10,945,1776,7936,2233,12890
25-07-2019,10 - 11,996,1723,7868,2284,12871
25-07-2019,11 - 12,935,1577,7850,2291,12653
25-07-2019,12 - 13,976,1536,8120,2277,12909
25-07-2019,13 - 14,1000,1532,8082,2292,12906
25-07-2019,14 - 15,979,1493,8074,2259,12805
25-07-2019,15 - 16,1010,1523,8026,2237,12796
25-07-2019,16 - 17,857,1532,7972,2216,12577
25-07-2019,17 - 18,955,1565,8054,2226,12800
25-07-2019,18 - 19,980,1628,7999,2249,12856
25-07-2019,19 - 20,947,1607,7811,2219,12584
25-07-2019,20 - 21,920,1590,7551,2137,12198
25-07-2019,21 - 22,849,1544,7335,2067,11795
25-07-2019,22 - 23,850,1365,7229,2025,11469
25-07-2019,23 - 00,857,1301,6854,1879,10891
26-07-2019,00 - 01,918,1319,6459,1741,10437
26-07-2019,01 - 02,911,1330,6231,1652,10124
26-07-2019,02 - 03,896,1238,6103,1594,9831
26-07-2019,03 - 04,872,1172,6069,1559,9672
26-07-2019,04 - 05,884,1290,5916,1543,9633
26-07-2019,05 - 06,955,1243,5992,1560,9750
26-07-2019,06 - 07,924,1273,6487,1732,10416
26-07-2019,07 - 08,945,1351,7113,1996,11405
26-07-2019,08 - 09,985,1485,7672,2157,12299
26-07-2019,09 - 10,981,1554,7987,2263,12785
26-07-2019,10 - 11,954,1568,8086,2308,12916
26-07-2019,11 - 12,968,1542,8113,2298,12921
26-07-2019,12 - 13,979,1422,8043,2259,12703
26-07-2019,13 - 14,942,1372,8040,2215,12569
26-07-2019,14 - 15,956,1427,7921,2179,12483
26-07-2019,15 - 16,937,1471,7876,2096,12380
26-07-2019,16 - 17,962,1505,7893,2061,12421
26-07-2019,17 - 18,1002,1526,7875,2053,12456
26-07-2019,18 - 19,1118,1499,7846,2082,12545
26-07-2019,19 - 20,990,1520,7692,2077,12279
26-07-2019,20 - 21,965,1461,7486,2023,11935
26-07-2019,21 - 22,902,1391,7249,1974,11516
26-07-2019,22 - 23,928,1414,7122,1950,11414
26-07-2019,23 - 00,926,1310,6677,1825,10738
27-07-2019,00 - 01,873,1335,6248,1719,10175
27-07-2019,01 - 02,889,1239,6001,1569,9698
27-07-2019,02 - 03,901,1332,5903,1479,9615
27-07-2019,03 - 04,845,1218,5885,1478,9426
27-07-2019,04 - 05,868,1192,5734,1519,9313
27-07-2019,05 - 06,881,1244,5671,1460,9256
27-07-2019,06 - 07,846,1238,5891,1540,9515
27-07-2019,07 - 08,878,1313,6254,1697,10142
27-07-2019,08 - 09,948,1416,6600,1912,10876
27-07-2019,09 - 10,981,1482,6908,2050,11421
27-07-2019,10 - 11,1011,1369,7105,1939,11424
27-07-2019,11 - 12,959,1385,7151,1844,11339
27-07-2019,12 - 13,964,1400,7172,1908,11444
27-07-2019,13 - 14,966,1368,7146,1985,11465
27-07-2019,14 - 15,962,1384,7190,1955,11491
27-07-2019,15 - 16,955,1367,7135,2001,11458
27-07-2019,16 - 17,953,1381,7085,2052,11471
27-07-2019,17 - 18,894,1412,7205,2075,11586
27-07-2019,18 - 19,997,1408,7184,2067,11656
27-07-2019,19 - 20,1134,1372,7152,1990,11648
27-07-2019,20 - 21,1061,1333,7057,1944,11395
27-07-2019,21 - 22,1059,1369,6966,1973,11367
27-07-2019,22 - 23,1001,1371,7000,1952,11324
27-07-2019,23 - 00,1044,1353,6700,1832,10929
28-07-2019,00 - 01,939,1311,6444,1724,10418
28-07-2019,01 - 02,881,1302,6347,1669,10199
28-07-2019,02 - 03,868,1225,5873,1671,9637
28-07-2019,03 - 04,861,1188,5791,1641,9481
28-07-2019,04 - 05,861,1198,5674,1637,9370
28-07-2019,05 - 06,779,1136,5740,1549,9204
28-07-2019,06 - 07,854,1103,6033,1589,9579
28-07-2019,07 - 08,906,1194,6369,1723,10192
28-07-2019,08 - 09,985,1260,6649,1956,10850
28-07-2019,09 - 10,966,1421,7019,2074,11480
28-07-2019,10 - 11,994,1425,7257,2162,11838
28-07-2019,11 - 12,971,1442,7247,2160,11820
28-07-2019,12 - 13,971,1421,7281,2002,11675
28-07-2019,13 - 14,903,1435,7219,1867,11424
28-07-2019,14 - 15,950,1451,7067,1824,11292
28-07-2019,15 - 16,909,1474,7127,1823,11333
28-07-2019,16 - 17,998,1500,7224,1850,11572
28-07-2019,17 - 18,979,1464,7306,1932,11681
28-07-2019,18 - 19,1012,1419,7408,2087,11926
28-07-2019,19 - 20,982,1374,7464,2127,11947
28-07-2019,20 - 21,940,1313,7473,2136,11862
28-07-2019,21 - 22,975,1271,7373,2135,11754
28-07-2019,22 - 23,898,1219,7108,2073,11298
28-07-2019,23 - 00,821,1193,6687,1910,10611
29-07-2019,00 - 01,821,994,6220,1660,9695
29-07-2019,01 - 02,829,1080,5944,1564,9417
29-07-2019,02 - 03,892,1124,5754,1571,9341
29-07-2019,03 - 04,845,1151,5734,1576,9306
29-07-2019,04 - 05,654,1148,5624,1563,8989
29-07-2019,05 - 06,769,1029,5616,1547,8961
29-07-2019,06 - 07,920,1257,6217,1806,10200
29-07-2019,07 - 08,1000,1352,7058,2075,11485
29-07-2019,08 - 09,1006,1529,7654,2291,12480
29-07-2019,09 - 10,968,1513,8058,2408,12947
29-07-2019,10 - 11,1033,1534,8320,2420,13307
29-07-2019,11 - 12,1015,1523,8454,2432,13424
29-07-2019,12 - 13,996,1568,8469,2409,13442
29-07-2019,13 - 14,890,1682,8392,2452,13416
29-07-2019,14 - 15,967,1573,8354,2421,13315
29-07-2019,15 - 16,920,1521,8293,2348,13082
29-07-2019,16 - 17,1015,1442,8110,2312,12879
29-07-2019,17 - 18,1007,1404,8159,2352,12922
29-07-2019,18 - 19,955,1437,7990,2332,12714
29-07-2019,19 - 20,918,1435,7712,2244,12309
29-07-2019,20 - 21,950,1428,7489,2190,12057
29-07-2019,21 - 22,1047,1391,7396,2194,12028
29-07-2019,22 - 23,753,1256,7166,2135,11310
29-07-2019,23 - 00,786,1255,6718,1993,10752
30-07-2019,00 - 01,849,1217,6251,1743,10060
30-07-2019,01 - 02,787,1112,6066,1601,9566
30-07-2019,02 - 03,777,1080,6028,1567,9452
30-07-2019,03 - 04,717,1166,5903,1562,9348
30-07-2019,04 - 05,741,1208,5809,1609,9367
30-07-2019,05 - 06,874,1186,5812,1637,9509
30-07-2019,06 - 07,802,1429,6415,1812,10458
30-07-2019,07 - 08,895,1534,6943,2010,11382
30-07-2019,08 - 09,908,1562,7520,2136,12126
30-07-2019,09 - 10,908,1456,7906,2226,12496
30-07-2019,10 - 11,928,1584,8202,2410,13124
30-07-2019,11 - 12,932,1647,8203,2454,13236
30-07-2019,12 - 13,959,1608,8189,2433,13189
30-07-2019,13 - 14,939,1587,8248,2495,13269
30-07-2019,14 - 15,950,1574,8158,2519,13201
30-07-2019,15 - 16,943,1604,8135,2421,13103
30-07-2019,16 - 17,969,1541,7973,2357,12840
30-07-2019,17 - 18,866,1528,8004,2357,12755
30-07-2019,18 - 19,882,1550,7941,2274,12647
30-07-2019,19 - 20,929,1532,7802,2199,12462
30-07-2019,20 - 21,909,1488,7586,2127,12110
30-07-2019,21 - 22,903,1396,7431,2114,11844
30-07-2019,22 - 23,951,1355,7156,2059,11521
30-07-2019,23 - 00,758,1323,6487,1818,10386
31-07-2019,00 - 01,749,1209,6097,1677,9732
31-07-2019,01 - 02,915,1221,5966,1620,9722
31-07-2019,02 - 03,899,1172,5906,1557,9534
31-07-2019,03 - 04,813,1151,5815,1548,9327
31-07-2019,04 - 05,815,1130,5804,1578,9327
31-07-2019,05 - 06,765,1139,5910,1573,9387
31-07-2019,06 - 07,943,1247,6614,1794,10598
31-07-2019,07 - 08,883,1431,7306,2111,11731
31-07-2019,08 - 09,996,1586,7646,2299,12527
31-07-2019,09 - 10,1036,1716,7948,2371,13071
31-07-2019,10 - 11,1075,1689,8276,2409,13449
31-07-2019,11 - 12,1066,1605,8311,2454,13436
31-07-2019,12 - 13,1077,1659,8359,2438,13533
31-07-2019,13 - 14,1015,1588,8370,2397,13370
31-07-2019,14 - 15,972,1571,8276,2362,13181
31-07-2019,15 - 16,975,1559,8183,2305,13022
31-07-2019,16 - 17,950,1532,8061,2279,12822
31-07-2019,17 - 18,1000,1579,8096,2305,12980
31-07-2019,18 - 19,973,1590,8042,2270,12875
31-07-2019,19 - 20,949,1595,7815,2222,12581
31-07-2019,20 - 21,966,1528,7640,2148,12282
31-07-2019,21 - 22,992,1528,7499,2135,12154
31-07-2019,22 - 23,1029,1583,7292,2073,11977
31-07-2019,23 - 00,1008,1439,6762,1912,11121
01-08-2019,00 - 01,856,1279,6373,1758,10266
01-08-2019,01 - 02,915,1384,6265,1607,10171
01-08-2019,02 - 03,869,1314,6230,1579,9992
01-08-2019,03 - 04,834,1340,6186,1609,9969
01-08-2019,04 - 05,832,1305,6146,1636,9919
01-08-2019,05 - 06,874,1229,6195,1647,9945
01-08-2019,06 - 07,895,1418,6812,1824,10949
01-08-2019,07 - 08,1016,1426,7430,2084,11956
01-08-2019,08 - 09,1071,1553,7875,2288,12787
01-08-2019,09 - 10,1062,1463,8066,2357,12948
01-08-2019,10 - 11,983,1502,8159,2355,12999
01-08-2019,11 - 12,977,1566,8220,2366,13129
01-08-2019,12 - 13,958,1551,8205,2335,13049
01-08-2019,13 - 14,971,1582,8191,2329,13073
01-08-2019,14 - 15,999,1562,8089,2342,12992
01-08-2019,15 - 16,983,1508,8065,2324,12880
01-08-2019,16 - 17,932,1563,7975,2296,12766
01-08-2019,17 - 18,1016,1565,7999,2299,12879
01-08-2019,18 - 19,1024,1605,7824,2264,12717
01-08-2019,19 - 20,946,1623,7635,2238,12442
01-08-2019,20 - 21,923,1523,7436,2147,12029
01-08-2019,21 - 22,866,1538,7285,2115,11804
01-08-2019,22 - 23,884,1477,7150,1995,11506
01-08-2019,23 - 00,911,1440,6723,1792,10866
02-08-2019,00 - 01,864,1263,6334,1673,10134
02-08-2019,01 - 02,872,1258,6091,1599,9820
02-08-2019,02 - 03,946,1249,5958,1593,9746
02-08-2019,03 - 04,896,1214,6048,1593,9751
02-08-2019,04 - 05,842,1103,6015,1633,9593
02-08-2019,05 - 06,798,1054,6107,1643,9602
02-08-2019,06 - 07,901,1124,6613,1830,10468
02-08-2019,07 - 08,811,1279,7161,2067,11318
02-08-2019,08 - 09,982,1509,7730,2236,12457
02-08-2019,09 - 10,964,1557,8082,2308,12911
02-08-2019,10 - 11,1121,1585,8203,2364,13273
02-08-2019,11 - 12,924,1609,8232,2379,13144
02-08-2019,12 - 13,1020,1512,8157,2355,13044
02-08-2019,13 - 14,1017,1492,7975,2307,12791
02-08-2019,14 - 15,1051,1469,7875,2211,12606
02-08-2019,15 - 16,963,1513,7778,2124,12378
02-08-2019,16 - 17,1030,1510,7693,2088,12321
02-08-2019,17 - 18,1059,1517,7734,2128,12438
02-08-2019,18 - 19,1016,1518,7678,2103,12315
02-08-2019,19 - 20,1063,1487,7525,2056,12131
02-08-2019,20 - 21,1090,1469,7368,2016,11943
02-08-2019,21 - 22,1015,1418,7227,2004,11664
02-08-2019,22 - 23,914,1444,7062,1970,11390
02-08-2019,23 - 00,922,1434,6608,1853,10817
03-08-2019,00 - 01,935,1309,6245,1710,10199
03-08-2019,01 - 02,962,1380,6060,1625,10027
03-08-2019,02 - 03,898,1423,5923,1564,9808
03-08-2019,03 - 04,876,1255,5866,1525,9522
03-08-2019,04 - 05,728,1217,5767,1512,9224
03-08-2019,05 - 06,875,1296,5603,1468,9242
03-08-2019,06 - 07,893,1312,5832,1496,9533
03-08-2019,07 - 08,1004,1324,6118,1608,10054
03-08-2019,08 - 09,1028,1379,6588,1766,10761
03-08-2019,09 - 10,1055,1425,6896,1905,11281
03-08-2019,10 - 11,1037,1411,7153,1956,11557
03-08-2019,11 - 12,993,1465,7270,1983,11711
03-08-2019,12 - 13,993,1502,7260,1979,11734
03-08-2019,13 - 14,924,1489,7173,1903,11489
03-08-2019,14 - 15,1014,1426,7070,1841,11351
03-08-2019,15 - 16,999,1443,6987,1814,11243
03-08-2019,16 - 17,1017,1495,6991,1883,11386
03-08-2019,17 - 18,1025,1492,7076,1947,11540
03-08-2019,18 - 19,1027,1444,7097,1960,11528
03-08-2019,19 - 20,1007,1428,7067,1986,11488
03-08-2019,20 - 21,993,1429,6891,1950,11263
03-08-2019,21 - 22,1017,1422,6891,1944,11274
03-08-2019,22 - 23,1013,1383,6767,1893,11056
03-08-2019,23 - 00,981,1290,6408,1749,10428
04-08-2019,00 - 01,892,1282,6158,1597,9929
04-08-2019,01 - 02,890,1316,5989,1522,9717
04-08-2019,02 - 03,900,1296,5914,1482,9592
04-08-2019,03 - 04,872,1261,5831,1492,9456
04-08-2019,04 - 05,868,1272,5759,1496,9395
04-08-2019,05 - 06,830,1245,5734,1446,9255
04-08-2019,06 - 07,839,1299,5810,1439,9387
04-08-2019,07 - 08,866,1366,6066,1528,9826
04-08-2019,08 - 09,925,1331,6466,1680,10402
04-08-2019,09 - 10,952,1457,6929,1809,11147
04-08-2019,10 - 11,973,1433,7218,1890,11514
04-08-2019,11 - 12,933,1421,7367,1933,11654
04-08-2019,12 - 13,879,1432,7390,1942,11643
04-08-2019,13 - 14,909,1424,7305,1921,11559
04-08-2019,14 - 15,913,1438,7288,1864,11503
04-08-2019,15 - 16,894,1415,7275,1831,11415
04-08-2019,16 - 17,913,1419,7278,1857,11467
04-08-2019,17 - 18,945,1427,7369,1955,11696
04-08-2019,18 - 19,915,1451,7360,2010,11736
04-08-2019,19 - 20,916,1523,7298,1997,11734
04-08-2019,20 - 21,934,1570,7283,1991,11778
04-08-2019,21 - 22,894,1498,7228,2008,11628
04-08-2019,22 - 23,863,1472,6977,1934,11246
04-08-2019,23 - 00,847,1503,6602,1791,10743
05-08-2019,00 - 01,760,1304,6273,1639,9976
05-08-2019,01 - 02,782,1261,6111,1585,9739
05-08-2019,02 - 03,859,1301,6080,1570,9810
05-08-2019,03 - 04,872,1340,6072,1569,9853
05-08-2019,04 - 05,853,1330,6090,1592,9865
05-08-2019,05 - 06,821,1335,6217,1636,10009
05-08-2019,06 - 07,975,1505,7027,1917,11424
05-08-2019,07 - 08,1080,1608,7888,2224,12800
05-08-2019,08 - 09,1109,1694,8449,2429,13681
05-08-2019,09 - 10,1034,1726,8684,2467,13911
05-08-2019,10 - 11,1050,1617,8871,2513,14051
05-08-2019,11 - 12,1064,1701,8926,2542,14233
05-08-2019,12 - 13,1048,1676,8979,2515,14218
05-08-2019,13 - 14,1036,1616,8921,2481,14054
05-08-2019,14 - 15,1042,1590,8796,2451,13879
05-08-2019,15 - 16,1027,1578,8738,2446,13789
05-08-2019,16 - 17,1036,1613,8545,2372,13566
05-08-2019,17 - 18,1045,1646,8553,2410,13654
05-08-2019,18 - 19,1049,1631,8368,2396,13444
05-08-2019,19 - 20,1066,1585,8186,2343,13180
05-08-2019,20 - 21,1000,1545,7926,2285,12756
05-08-2019,21 - 22,1015,1581,7782,2254,12632
05-08-2019,22 - 23,990,1501,7411,2152,12054
05-08-2019,23 - 00,854,1384,6892,1913,11043
06-08-2019,00 - 01,827,1311,6550,1756,10444
06-08-2019,01 - 02,827,1269,6399,1653,10148
06-08-2019,02 - 03,851,1247,6265,1667,10030
06-08-2019,03 - 04,885,1291,6225,1678,10079
06-08-2019,04 - 05,801,1306,6157,1690,9954
06-08-2019,05 - 06,829,1334,6245,1709,10117
06-08-2019,06 - 07,925,1427,6974,1936,11262
06-08-2019,07 - 08,1095,1576,7843,2324,12838
06-08-2019,08 - 09,1124,1725,8406,2506,13761
06-08-2019,09 - 10,1068,1652,8629,2553,13902
06-08-2019,10 - 11,1024,1608,8706,2576,13914
06-08-2019,11 - 12,1085,1691,8784,2545,14105
06-08-2019,12 - 13,1072,1613,8759,2442,13886
06-08-2019,13 - 14,1049,1604,8798,2392,13843
06-08-2019,14 - 15,1064,1538,8523,2383,13508
06-08-2019,15 - 16,1053,1570,8447,2404,13474
06-08-2019,16 - 17,1045,1574,8329,2338,13286
06-08-2019,17 - 18,1084,1590,8286,2399,13359
06-08-2019,18 - 19,1027,1593,8206,2414,13240
06-08-2019,19 - 20,998,1510,8056,2407,12971
06-08-2019,20 - 21,986,1550,7860,2351,12747
06-08-2019,21 - 22,1003,1478,7781,2295,12557
06-08-2019,22 - 23,938,1451,7334,2114,11837
06-08-2019,23 - 00,983,1453,6847,1925,11208
07-08-2019,00 - 01,929,1559,6538,1763,10789
07-08-2019,01 - 02,854,1401,6332,1643,10230
07-08-2019,02 - 03,857,1302,6223,1580,9962
07-08-2019,03 - 04,874,1344,6284,1673,10175
07-08-2019,04 - 05,898,1322,6342,1731,10293
07-08-2019,05 - 06,883,1399,6498,1811,10591
07-08-2019,06 - 07,882,1441,7217,2041,11581
07-08-2019,07 - 08,1017,1609,8124,2367,13117
07-08-2019,08 - 09,967,1545,8576,2560,13648
07-08-2019,09 - 10,1013,1589,8788,2590,13980
07-08-2019,10 - 11,1035,1710,8904,2628,14277
07-08-2019,11 - 12,1008,1724,8923,2555,14210
07-08-2019,12 - 13,1062,1605,8922,2574,14163
07-08-2019,13 - 14,966,1619,8895,2556,14036
07-08-2019,14 - 15,970,1581,8781,2543,13875
07-08-2019,15 - 16,998,1607,8766,2530,13901
07-08-2019,16 - 17,1033,1589,8547,2455,13624
07-08-2019,17 - 18,995,1711,8519,2335,13560
07-08-2019,18 - 19,1007,1609,8430,2411,13457
07-08-2019,19 - 20,972,1611,8199,2389,13171
07-08-2019,20 - 21,1008,1542,8050,2303,12903
07-08-2019,21 - 22,997,1484,7957,2262,12700
07-08-2019,22 - 23,883,1460,7574,2114,12031
07-08-2019,23 - 00,806,1514,7123,1930,11373
08-08-2019,00 - 01,816,1410,6708,1769,10703
08-08-2019,01 - 02,779,1412,6472,1688,10351
08-08-2019,02 - 03,784,1446,6372,1691,10293
08-08-2019,03 - 04,761,1418,6270,1670,10119
08-08-2019,04 - 05,790,1355,6315,1679,10139
08-08-2019,05 - 06,803,1276,6474,1701,10254
08-08-2019,06 - 07,961,1394,7227,1987,11569
08-08-2019,07 - 08,993,1582,8142,2368,13085
08-08-2019,08 - 09,1041,1716,8568,2547,13872
08-08-2019,09 - 10,978,1728,8613,2521,13840
08-08-2019,10 - 11,1045,1710,8832,2579,14166
08-08-2019,11 - 12,1047,1662,8837,2635,14181
08-08-2019,12 - 13,1055,1683,8880,2566,14184
08-08-2019,13 - 14,1071,1671,8894,2551,14187
08-08-2019,14 - 15,957,1547,8813,2535,13852
08-08-2019,15 - 16,1008,1486,8668,2489,13651
08-08-2019,16 - 17,943,1491,8342,2553,13329
08-08-2019,17 - 18,982,1509,8290,2592,13373
08-08-2019,18 - 19,1005,1497,8168,2496,13166
08-08-2019,19 - 20,968,1580,8144,2477,13169
08-08-2019,20 - 21,966,1618,8089,2391,13064
08-08-2019,21 - 22,944,1588,7991,2388,12911
08-08-2019,22 - 23,890,1507,7570,2182,12149
08-08-2019,23 - 00,919,1396,7021,1951,11287
09-08-2019,00 - 01,851,1370,6712,1836,10769
09-08-2019,01 - 02,865,1375,6515,1780,10535
09-08-2019,02 - 03,894,1356,6442,1730,10422
09-08-2019,03 - 04,865,1322,6493,1734,10414
09-08-2019,04 - 05,848,1322,6476,1714,10360
09-08-2019,05 - 06,842,1233,6635,1774,10484
09-08-2019,06 - 07,991,1466,7451,2067,11975
09-08-2019,07 - 08,1084,1665,8238,2422,13409
09-08-2019,08 - 09,1161,1788,8703,2567,14219
09-08-2019,09 - 10,1017,1734,8769,2606,14126
09-08-2019,10 - 11,1041,1641,8816,2635,14133
09-08-2019,11 - 12,1031,1690,8859,2596,14176
09-08-2019,12 - 13,1088,1692,8866,2526,14172
09-08-2019,13 - 14,1104,1548,8685,2478,13815
09-08-2019,14 - 15,1042,1603,8540,2369,13554
09-08-2019,15 - 16,1060,1571,8374,2302,13307
09-08-2019,16 - 17,1029,1506,8251,2280,13066
09-08-2019,17 - 18,999,1549,8290,2286,13124
09-08-2019,18 - 19,1083,1526,8202,2259,13070
09-08-2019,19 - 20,1070,1558,7886,2218,12732
09-08-2019,20 - 21,973,1490,7647,2162,12272
09-08-2019,21 - 22,988,1451,7488,2144,12071
09-08-2019,22 - 23,954,1445,7123,2017,11539
09-08-2019,23 - 00,767,1310,6750,1858,10685
10-08-2019,00 - 01,914,1143,6459,1676,10192
10-08-2019,01 - 02,869,1160,6205,1665,9899
10-08-2019,02 - 03,877,1165,6090,1599,9731
10-08-2019,03 - 04,890,1143,6022,1589,9644
10-08-2019,04 - 05,894,1103,5922,1537,9456
10-08-2019,05 - 06,877,1077,5835,1529,9318
10-08-2019,06 - 07,867,1127,6089,1559,9642
10-08-2019,07 - 08,875,1193,6559,1687,10314
10-08-2019,08 - 09,901,1378,7102,1970,11351
10-08-2019,09 - 10,938,1506,7486,2221,12151
10-08-2019,10 - 11,976,1496,7755,2344,12571
10-08-2019,11 - 12,988,1533,7875,2393,12789
10-08-2019,12 - 13,1005,1385,7923,2319,12632
10-08-2019,13 - 14,1043,1418,7860,2213,12534
10-08-2019,14 - 15,1023,1510,7705,2146,12384
10-08-2019,15 - 16,978,1507,7708,2238,12431
10-08-2019,16 - 17,924,1545,7714,2366,12549
10-08-2019,17 - 18,961,1596,7799,2362,12718
10-08-2019,18 - 19,909,1505,7848,2323,12585
10-08-2019,19 - 20,911,1334,7777,2288,12310
10-08-2019,20 - 21,899,1350,7650,2090,11989
10-08-2019,21 - 22,862,1328,7490,2057,11737
10-08-2019,22 - 23,839,1205,7071,1961,11076
10-08-2019,23 - 00,800,1275,6708,1838,10621
11-08-2019,00 - 01,842,1230,6537,1726,10335
11-08-2019,01 - 02,814,1141,6395,1664,10014
11-08-2019,02 - 03,793,1202,6298,1672,9965
11-08-2019,03 - 04,760,1325,6202,1623,9910
11-08-2019,04 - 05,820,1338,6066,1642,9866
11-08-2019,05 - 06,851,1249,5976,1622,9698
11-08-2019,06 - 07,851,1161,6055,1626,9693
11-08-2019,07 - 08,859,1138,6304,1721,10022
11-08-2019,08 - 09,914,1320,6723,1818,10775
11-08-2019,09 - 10,959,1479,7070,1966,11474
11-08-2019,10 - 11,1004,1520,7435,2102,12061
11-08-2019,11 - 12,956,1473,7598,2087,12114
11-08-2019,12 - 13,943,1438,7670,2082,12133
11-08-2019,13 - 14,862,1435,7700,2081,12078
11-08-2019,14 - 15,966,1445,7662,2084,12157
11-08-2019,15 - 16,1028,1469,7611,2106,12214
11-08-2019,16 - 17,942,1478,7659,2060,12139
11-08-2019,17 - 18,938,1454,7759,2079,12230
11-08-2019,18 - 19,951,1462,7796,2177,12386
11-08-2019,19 - 20,982,1430,7770,2229,12411
11-08-2019,20 - 21,987,1401,7661,2238,12287
11-08-2019,21 - 22,981,1500,7583,2325,12389
11-08-2019,22 - 23,966,1419,7142,2207,11734
11-08-2019,23 - 00,892,1370,6702,1987,10951
12-08-2019,00 - 01,869,1312,6396,1817,10394
12-08-2019,01 - 02,924,1306,6352,1782,10364
12-08-2019,02 - 03,869,1305,6275,1758,10207
12-08-2019,03 - 04,823,1291,6228,1702,10044
12-08-2019,04 - 05,721,1302,6282,1787,10092
12-08-2019,05 - 06,867,1378,6517,1847,10609
12-08-2019,06 - 07,940,1477,7494,2200,12111
12-08-2019,07 - 08,883,1550,8492,2608,13533
12-08-2019,08 - 09,907,1508,8912,2779,14106
12-08-2019,09 - 10,868,1543,8961,2686,14058
12-08-2019,10 - 11,1012,1453,9231,2627,14323
12-08-2019,11 - 12,989,1421,9333,2624,14367
12-08-2019,12 - 13,973,1644,9349,2552,14518
12-08-2019,13 - 14,1056,1629,9300,2625,14610
12-08-2019,14 - 15,1029,1594,9210,2630,14463
12-08-2019,15 - 16,1058,1403,9037,2578,14076
12-08-2019,16 - 17,1006,1443,8964,2524,13937
12-08-2019,17 - 18,1038,1501,9005,2572,14116
12-08-2019,18 - 19,988,1568,8843,2558,13957
12-08-2019,19 - 20,930,1473,8768,2532,13703
12-08-2019,20 - 21,981,1558,8586,2463,13588
12-08-2019,21 - 22,1045,1553,8547,2383,13528
12-08-2019,22 - 23,938,1424,7899,2214,12475
12-08-2019,23 - 00,969,1345,7302,2006,11622
13-08-2019,00 - 01,956,1181,6838,1877,10852
13-08-2019,01 - 02,898,1270,6753,1824,10745
13-08-2019,02 - 03,844,1284,6678,1761,10567
13-08-2019,03 - 04,795,1302,6631,1757,10485
13-08-2019,04 - 05,753,1321,6691,1768,10533
13-08-2019,05 - 06,796,1287,6844,1866,10793
13-08-2019,06 - 07,897,1377,7681,2151,12106
13-08-2019,07 - 08,953,1492,8503,2538,13486
13-08-2019,08 - 09,964,1577,8985,2765,14291
13-08-2019,09 - 10,929,1579,8947,2829,14284
13-08-2019,10 - 11,963,1495,9014,2818,14290
13-08-2019,11 - 12,918,1529,9049,2828,14324
13-08-2019,12 - 13,1016,1583,9049,2776,14424
13-08-2019,13 - 14,973,1515,8956,2678,14122
13-08-2019,14 - 15,945,1494,8922,2612,13973
13-08-2019,15 - 16,1023,1514,8951,2581,14069
13-08-2019,16 - 17,984,1556,8866,2510,13916
13-08-2019,17 - 18,933,1591,8774,2526,13824
13-08-2019,18 - 19,965,1709,8652,2620,13946
13-08-2019,19 - 20,1009,1675,8390,2588,13662
13-08-2019,20 - 21,998,1514,8420,2501,13433
13-08-2019,21 - 22,919,1560,8521,2411,13411
13-08-2019,22 - 23,880,1548,7708,2134,12270
13-08-2019,23 - 00,924,1420,7093,1987,11424
14-08-2019,00 - 01,739,1232,6765,1934,10670
14-08-2019,01 - 02,788,1164,6605,1850,10407
14-08-2019,02 - 03,834,1147,6477,1793,10251
14-08-2019,03 - 04,843,1147,6353,1755,10098
14-08-2019,04 - 05,804,1061,6240,1812,9917
14-08-2019,05 - 06,772,1030,6526,1886,10214
14-08-2019,06 - 07,978,1117,7570,2224,11889
14-08-2019,07 - 08,972,1366,8589,2626,13553
14-08-2019,08 - 09,964,1480,8909,2792,14145
14-08-2019,09 - 10,918,1493,8812,2735,13958
14-08-2019,10 - 11,871,1402,8915,2788,13976
14-08-2019,11 - 12,905,1496,8939,2809,14149
14-08-2019,12 - 13,1099,1574,8963,2757,14393
14-08-2019,13 - 14,1049,1564,8815,2732,14160
14-08-2019,14 - 15,1053,1548,8822,2635,14058
14-08-2019,15 - 16,981,1586,8765,2558,13890
14-08-2019,16 - 17,987,1586,8667,2481,13721
14-08-2019,17 - 18,1033,1724,8800,2552,14109
14-08-2019,18 - 19,962,1660,8751,2485,13858
14-08-2019,19 - 20,954,1694,8630,2465,13743
14-08-2019,20 - 21,934,1653,8539,2403,13529
14-08-2019,21 - 22,923,1522,8451,2379,13275
14-08-2019,22 - 23,866,1409,7866,2129,12270
14-08-2019,23 - 00,889,1389,7406,1893,11577
15-08-2019,00 - 01,772,1356,6981,1834,10943
15-08-2019,01 - 02,884,1254,6731,1804,10673
15-08-2019,02 - 03,800,1290,6690,1814,10594
15-08-2019,03 - 04,862,1253,6665,1837,10617
15-08-2019,04 - 05,818,1247,6748,1896,10709
15-08-2019,05 - 06,835,1136,6888,2009,10868
15-08-2019,06 - 07,976,1382,7742,2236,12336
15-08-2019,07 - 08,969,1516,8623,2531,13639
15-08-2019,08 - 09,973,1748,9057,2710,14488
15-08-2019,09 - 10,970,1676,9071,2754,14471
15-08-2019,10 - 11,1020,1670,9221,2773,14684
15-08-2019,11 - 12,1038,1669,9190,2698,14595
15-08-2019,12 - 13,1051,1636,9229,2697,14613
15-08-2019,13 - 14,1029,1566,9177,2712,14484
15-08-2019,14 - 15,988,1595,9118,2658,14359
15-08-2019,15 - 16,1046,1640,9037,2614,14337
15-08-2019,16 - 17,988,1649,8959,2553,14149
15-08-2019,17 - 18,960,1681,8925,2598,14164
15-08-2019,18 - 19,965,1666,8817,2573,14021
15-08-2019,19 - 20,1033,1653,8679,2595,13960
15-08-2019,20 - 21,981,1680,8598,2647,13906
15-08-2019,21 - 22,824,1565,8346,2501,13236
15-08-2019,22 - 23,835,1397,7775,2351,12358
15-08-2019,23 - 00,812,1429,7259,2142,11642
16-08-2019,00 - 01,853,1244,6848,1996,10941
16-08-2019,01 - 02,826,1281,6684,1944,10735
16-08-2019,02 - 03,886,1239,6657,1888,10670
16-08-2019,03 - 04,892,1293,6716,1880,10781
16-08-2019,04 - 05,825,1395,6691,1894,10805
16-08-2019,05 - 06,878,1301,6843,1993,11015
16-08-2019,06 - 07,953,1441,7562,2240,12196
16-08-2019,07 - 08,1089,1442,8601,2534,13666
16-08-2019,08 - 09,1088,1479,9056,2703,14326
16-08-2019,09 - 10,1070,1579,9246,2662,14557
16-08-2019,10 - 11,1017,1648,9270,2717,14652
16-08-2019,11 - 12,1022,1654,9259,2679,14614
16-08-2019,12 - 13,1046,1592,9175,2635,14448
16-08-2019,13 - 14,1087,1475,9067,2519,14148
16-08-2019,14 - 15,1085,1445,8872,2433,13835
16-08-2019,15 - 16,1079,1449,8689,2331,13548
16-08-2019,16 - 17,1092,1495,8558,2315,13460
16-08-2019,17 - 18,1151,1585,8576,2443,13755
16-08-2019,18 - 19,1139,1551,8429,2441,13560
16-08-2019,19 - 20,899,1546,8226,2407,13078
16-08-2019,20 - 21,856,1596,8088,2302,12842
16-08-2019,21 - 22,1025,1452,7999,2217,12693
16-08-2019,22 - 23,1083,1318,7536,2052,11989
16-08-2019,23 - 00,1000,1265,7063,1907,11235
17-08-2019,00 - 01,967,1135,6804,1747,10653
17-08-2019,01 - 02,902,1172,6626,1711,10411
17-08-2019,02 - 03,857,1198,6483,1694,10232
17-08-2019,03 - 04,822,1227,6354,1624,10027
17-08-2019,04 - 05,883,1294,6315,1635,10127
17-08-2019,05 - 06,952,1301,6188,1579,10020
17-08-2019,06 - 07,987,1308,6226,1593,10114
17-08-2019,07 - 08,1050,1329,6605,1797,10781
17-08-2019,08 - 09,995,1462,7274,2094,11825
17-08-2019,09 - 10,1162,1504,7659,2272,12597
17-08-2019,10 - 11,1154,1475,7976,2337,12942
17-08-2019,11 - 12,1186,1630,8076,2318,13210
17-08-2019,12 - 13,1139,1635,8082,2307,13163
17-08-2019,13 - 14,1039,1499,8087,2326,12951
17-08-2019,14 - 15,996,1574,8023,2330,12923
17-08-2019,15 - 16,1013,1647,7899,2269,12828
17-08-2019,16 - 17,1116,1596,7814,2229,12755
17-08-2019,17 - 18,1139,1520,7961,2249,12869
17-08-2019,18 - 19,956,1510,7881,2285,12632
17-08-2019,19 - 20,1017,1507,7918,2218,12660
17-08-2019,20 - 21,1056,1407,7748,2229,12440
17-08-2019,21 - 22,953,1359,7612,2209,12133
17-08-2019,22 - 23,928,1311,7174,2115,11528
17-08-2019,23 - 00,1075,1243,6819,1944,11081
18-08-2019,00 - 01,1072,1242,6618,1819,10751
18-08-2019,01 - 02,1045,1189,6466,1683,10383
18-08-2019,02 - 03,974,1219,6372,1644,10209
18-08-2019,03 - 04,954,1268,6253,1654,10129
18-08-2019,04 - 05,999,1260,6148,1645,10052
18-08-2019,05 - 06,1007,1220,6082,1652,9961
18-08-2019,06 - 07,976,1189,6203,1642,10010
18-08-2019,07 - 08,990,1232,6456,1726,10404
18-08-2019,08 - 09,1020,1334,6872,1866,11092
18-08-2019,09 - 10,971,1480,7297,2003,11751
18-08-2019,10 - 11,1101,1532,7527,2119,12279
18-08-2019,11 - 12,1109,1604,7678,2169,12560
18-08-2019,12 - 13,1101,1460,7773,2195,12529
18-08-2019,13 - 14,1112,1482,7717,2190,12501
18-08-2019,14 - 15,1113,1480,7677,2195,12465
18-08-2019,15 - 16,1025,1454,7699,2212,12390
18-08-2019,16 - 17,1077,1584,7810,2257,12728
18-08-2019,17 - 18,1084,1596,8091,2345,13116
18-08-2019,18 - 19,1076,1629,8112,2385,13202
18-08-2019,19 - 20,1175,1718,8075,2339,13307
18-08-2019,20 - 21,1083,1609,8016,2253,12961
18-08-2019,21 - 22,1001,1641,7800,2167,12609
18-08-2019,22 - 23,1084,1564,7414,2082,12144
18-08-2019,23 - 00,1086,1550,6955,1963,11554
19-08-2019,00 - 01,1077,1406,6653,1760,10896
19-08-2019,01 - 02,1015,1433,6412,1700,10560
19-08-2019,02 - 03,963,1446,6356,1731,10496
19-08-2019,03 - 04,1018,1452,6352,1767,10589
19-08-2019,04 - 05,1021,1418,6492,1768,10699
19-08-2019,05 - 06,1033,1383,6729,1887,11032
19-08-2019,06 - 07,1102,1532,7618,2208,12460
19-08-2019,07 - 08,1149,1690,8606,2584,14029
19-08-2019,08 - 09,1161,1794,8990,2757,14702
19-08-2019,09 - 10,1179,1727,9080,2683,14669
19-08-2019,10 - 11,1300,1644,8981,2688,14613
19-08-2019,11 - 12,1223,1581,9069,2705,14578
19-08-2019,12 - 13,1198,1602,9200,2710,14710
19-08-2019,13 - 14,1153,1596,9132,2716,14597
19-08-2019,14 - 15,1168,1637,9079,2624,14508
19-08-2019,15 - 16,1174,1440,8966,2539,14119
19-08-2019,16 - 17,1116,1461,8718,2510,13805
19-08-2019,17 - 18,1168,1703,8767,2489,14127
19-08-2019,18 - 19,1132,1553,8722,2564,13971
19-08-2019,19 - 20,1121,1560,8823,2630,14134
19-08-2019,20 - 21,1064,1357,8532,2607,13560
19-08-2019,21 - 22,1018,1296,8196,2447,12957
19-08-2019,22 - 23,944,1372,7670,2160,12146
19-08-2019,23 - 00,943,1412,7091,2026,11472
20-08-2019,00 - 01,948,1434,6739,1892,11013
20-08-2019,01 - 02,935,1332,6525,1818,10610
20-08-2019,02 - 03,988,1334,6445,1804,10571
20-08-2019,03 - 04,1047,1279,6491,1849,10666
20-08-2019,04 - 05,1091,1288,6548,1855,10782
20-08-2019,05 - 06,1034,1263,6765,1929,10991
20-08-2019,06 - 07,1069,1310,7848,2242,12469
20-08-2019,07 - 08,1011,1528,8872,2622,14033
20-08-2019,08 - 09,1154,1695,9119,2752,14720
20-08-2019,09 - 10,1145,1686,9043,2731,14605
20-08-2019,10 - 11,1141,1651,9015,2679,14486
20-08-2019,11 - 12,1057,1604,9007,2614,14282
20-08-2019,12 - 13,1024,1540,9098,2540,14202
20-08-2019,13 - 14,1036,1533,9015,2576,14160
20-08-2019,14 - 15,1050,1594,8933,2594,14171
20-08-2019,15 - 16,1090,1607,8903,2625,14225
20-08-2019,16 - 17,1064,1563,8915,2554,14096
20-08-2019,17 - 18,1064,1681,8929,2710,14384
20-08-2019,18 - 19,1090,1689,8651,2602,14032
20-08-2019,19 - 20,1049,1616,8684,2564,13913
20-08-2019,20 - 21,1045,1344,8812,2479,13680
20-08-2019,21 - 22,1065,1327,8701,2419,13512
20-08-2019,22 - 23,992,1406,7965,2163,12526
20-08-2019,23 - 00,924,1475,7277,1944,11620
21-08-2019,00 - 01,919,1563,6918,1783,11183
21-08-2019,01 - 02,905,1548,6680,1736,10869
21-08-2019,02 - 03,949,1501,6593,1699,10742
21-08-2019,03 - 04,1077,1453,6660,1722,10912
21-08-2019,04 - 05,1014,1417,6866,1739,11036
21-08-2019,05 - 06,895,1401,7085,1869,11250
21-08-2019,06 - 07,782,1524,8224,2145,12675
21-08-2019,07 - 08,1047,1627,9134,2488,14296
21-08-2019,08 - 09,1115,1707,9511,2658,14991
21-08-2019,09 - 10,1165,1703,9342,2631,14841
21-08-2019,10 - 11,1034,1680,9358,2641,14713
21-08-2019,11 - 12,1036,1631,9404,2613,14684
21-08-2019,12 - 13,1006,1708,9323,2529,14566
21-08-2019,13 - 14,933,1652,9210,2502,14297
21-08-2019,14 - 15,1073,1564,9111,2473,14221
21-08-2019,15 - 16,1024,1651,9101,2419,14195
21-08-2019,16 - 17,995,1782,8886,2429,14092
21-08-2019,17 - 18,1054,1721,9034,2462,14271
21-08-2019,18 - 19,1060,1650,8941,2461,14112
21-08-2019,19 - 20,1002,1648,8846,2444,13940
21-08-2019,20 - 21,999,1686,8814,2443,13942
21-08-2019,21 - 22,893,1530,8522,2334,13279
21-08-2019,22 - 23,890,1438,7934,2087,12349
21-08-2019,23 - 00,977,1401,7287,1870,11535
22-08-2019,00 - 01,983,1338,6862,1761,10944
22-08-2019,01 - 02,1008,1356,6727,1712,10803
22-08-2019,02 - 03,988,1412,6772,1719,10891
22-08-2019,03 - 04,933,1427,6690,1730,10780
22-08-2019,04 - 05,898,1303,6690,1774,10665
22-08-2019,05 - 06,943,1331,7079,1879,11232
22-08-2019,06 - 07,1083,1555,7886,2156,12680
22-08-2019,07 - 08,1099,1789,8836,2470,14194
22-08-2019,08 - 09,1153,1864,9090,2630,14737
22-08-2019,09 - 10,1151,1823,9135,2650,14759
22-08-2019,10 - 11,1126,1697,9026,2630,14479
22-08-2019,11 - 12,1070,1561,9191,2595,14417
22-08-2019,12 - 13,1050,1571,9085,2503,14209
22-08-2019,13 - 14,1089,1583,9153,2518,14343
22-08-2019,14 - 15,1112,1559,9379,2516,14566
22-08-2019,15 - 16,1124,1584,9200,2480,14388
22-08-2019,16 - 17,1071,1509,9229,2384,14193
22-08-2019,17 - 18,1140,1640,9381,2396,14557
22-08-2019,18 - 19,1136,1581,9279,2433,14429
22-08-2019,19 - 20,1124,1524,9043,2395,14086
22-08-2019,20 - 21,1043,1478,8886,2324,13731
22-08-2019,21 - 22,1072,1468,8647,2274,13461
22-08-2019,22 - 23,1144,1422,8004,2143,12713
22-08-2019,23 - 00,1111,1429,7527,1944,12011
23-08-2019,00 - 01,995,1451,7123,1900,11469
23-08-2019,01 - 02,1041,1529,6833,1856,11259
23-08-2019,02 - 03,984,1344,6724,1836,10888
23-08-2019,03 - 04,997,1288,6741,1772,10798
23-08-2019,04 - 05,955,1335,6790,1764,10844
23-08-2019,05 - 06,968,1358,6963,1856,11145
23-08-2019,06 - 07,1055,1503,7801,2129,12488
23-08-2019,07 - 08,1046,1527,8832,2492,13897
23-08-2019,08 - 09,1137,1604,9155,2624,14520
23-08-2019,09 - 10,1143,1625,9390,2650,14808
23-08-2019,10 - 11,1186,1653,9504,2698,15041
23-08-2019,11 - 12,1178,1691,9521,2628,15018
23-08-2019,12 - 13,1187,1641,9375,2544,14747
23-08-2019,13 - 14,1161,1541,9253,2455,14410
23-08-2019,14 - 15,1160,1469,9043,2388,14060
23-08-2019,15 - 16,1165,1474,8797,2385,13821
23-08-2019,16 - 17,1073,1647,8674,2406,13800
23-08-2019,17 - 18,1095,1809,8716,2465,14085
23-08-2019,18 - 19,1073,1648,8519,2396,13636
23-08-2019,19 - 20,1086,1594,8408,2284,13372
23-08-2019,20 - 21,1056,1571,8275,2222,13124
23-08-2019,21 - 22,933,1483,8141,2190,12747
23-08-2019,22 - 23,834,1410,7580,2028,11852
23-08-2019,23 - 00,893,1293,7041,1856,11083
24-08-2019,00 - 01,931,1246,6730,1764,10671
24-08-2019,01 - 02,1054,1346,6652,1734,10786
24-08-2019,02 - 03,1023,1408,6496,1635,10562
24-08-2019,03 - 04,954,1440,6415,1613,10422
24-08-2019,04 - 05,1029,1402,6353,1624,10408
24-08-2019,05 - 06,1047,1322,6320,1639,10328
24-08-2019,06 - 07,983,1305,6456,1675,10419
24-08-2019,07 - 08,999,1531,6854,1762,11146
24-08-2019,08 - 09,1119,1602,7394,1939,12054
24-08-2019,09 - 10,1139,1590,7754,2074,12557
24-08-2019,10 - 11,1105,1639,7965,2101,12810
24-08-2019,11 - 12,1117,1537,7997,2128,12779
24-08-2019,12 - 13,1068,1448,7906,2122,12544
24-08-2019,13 - 14,1102,1481,7805,2080,12468
24-08-2019,14 - 15,1084,1467,7768,2012,12331
24-08-2019,15 - 16,1066,1444,7647,2000,12157
24-08-2019,16 - 17,1062,1483,7635,2014,12194
24-08-2019,17 - 18,1076,1472,7748,2030,12326
24-08-2019,18 - 19,1068,1519,7699,2059,12345
24-08-2019,19 - 20,1080,1497,7656,2049,12282
24-08-2019,20 - 21,1105,1407,7640,2057,12209
24-08-2019,21 - 22,1143,1284,7563,2037,12027
24-08-2019,22 - 23,1040,1224,7160,1925,11349
24-08-2019,23 - 00,987,1242,6791,1753,10773
25-08-2019,00 - 01,979,1259,6511,1657,10406
25-08-2019,01 - 02,938,1134,6383,1611,10066
25-08-2019,02 - 03,906,1093,6282,1587,9868
25-08-2019,03 - 04,929,1196,6267,1589,9981
25-08-2019,04 - 05,924,1265,6324,1574,10087
25-08-2019,05 - 06,893,1201,6197,1562,9853
25-08-2019,06 - 07,867,986,6236,1562,9651
25-08-2019,07 - 08,929,1003,6466,1657,10055
25-08-2019,08 - 09,989,1078,7006,1825,10898
25-08-2019,09 - 10,1021,1269,7585,1933,11808
25-08-2019,10 - 11,1121,1519,7761,2034,12435
25-08-2019,11 - 12,1052,1462,7938,2054,12506
25-08-2019,12 - 13,1061,1452,8095,2064,12672
25-08-2019,13 - 14,1045,1509,8073,2044,12671
25-08-2019,14 - 15,1036,1592,8053,2040,12721
25-08-2019,15 - 16,950,1482,7986,2028,12446
25-08-2019,16 - 17,921,1421,8091,2063,12496
25-08-2019,17 - 18,959,1317,8232,2131,12639
25-08-2019,18 - 19,931,1359,8375,2206,12871
25-08-2019,19 - 20,1064,1417,8288,2207,12976
25-08-2019,20 - 21,1161,1469,8380,2224,13234
25-08-2019,21 - 22,1036,1438,8249,2203,12926
25-08-2019,22 - 23,991,1303,7605,1963,11862
25-08-2019,23 - 00,972,1196,7133,1767,11068
26-08-2019,00 - 01,954,1263,6734,1739,10690
26-08-2019,01 - 02,953,1298,6633,1688,10572
26-08-2019,02 - 03,983,1224,6575,1709,10491
26-08-2019,03 - 04,942,1327,7050,1727,11046
26-08-2019,04 - 05,958,1379,7243,1768,11348
26-08-2019,05 - 06,1007,1384,7707,1885,11983
26-08-2019,06 - 07,1271,1533,8190,2114,13108
26-08-2019,07 - 08,1049,1681,9004,2477,14211
26-08-2019,08 - 09,1291,1904,9374,2611,15180
26-08-2019,09 - 10,1198,1804,9582,2713,15297
26-08-2019,10 - 11,1213,1840,9731,2776,15560
26-08-2019,11 - 12,1064,1749,9711,2781,15305
26-08-2019,12 - 13,1082,1718,9600,2705,15105
26-08-2019,13 - 14,1092,1761,9548,2672,15073
26-08-2019,14 - 15,1053,1846,9555,2698,15152
26-08-2019,15 - 16,1135,1712,9511,2692,15050
26-08-2019,16 - 17,1168,1674,9386,2654,14882
26-08-2019,17 - 18,1154,1714,9421,2693,14982
26-08-2019,18 - 19,1043,1662,9282,2607,14594
26-08-2019,19 - 20,962,1636,9090,2522,14210
26-08-2019,20 - 21,863,1562,9042,2489,13956
26-08-2019,21 - 22,874,1491,8751,2366,13482
26-08-2019,22 - 23,964,1311,8097,2167,12539
26-08-2019,23 - 00,897,1274,7381,1983,11535
27-08-2019,00 - 01,823,1102,6973,1873,10771
27-08-2019,01 - 02,721,1163,6693,1827,10404
27-08-2019,02 - 03,755,1243,6656,1762,10416
27-08-2019,03 - 04,813,1227,6648,1712,10400
27-08-2019,04 - 05,898,1162,6710,1730,10500
27-08-2019,05 - 06,987,1209,7062,1860,11118
27-08-2019,06 - 07,912,1299,7862,2097,12170
27-08-2019,07 - 08,837,1420,8760,2424,13441
27-08-2019,08 - 09,958,1519,9169,2671,14317
27-08-2019,09 - 10,1209,1638,9382,2744,14973
27-08-2019,10 - 11,1199,1709,9539,2803,15250
27-08-2019,11 - 12,1123,1626,9565,2780,15094
27-08-2019,12 - 13,1241,1489,9510,2684,14924
27-08-2019,13 - 14,1177,1549,9363,2674,14763
27-08-2019,14 - 15,1199,1653,9341,2661,14854
27-08-2019,15 - 16,1664,1638,9359,2690,15351
27-08-2019,16 - 17,1063,1802,9447,2662,14974
27-08-2019,17 - 18,1081,1818,9613,2675,15187
27-08-2019,18 - 19,1152,1717,9419,2640,14928
27-08-2019,19 - 20,1111,1678,9118,2542,14449
27-08-2019,20 - 21,1010,1547,8921,2491,13969
27-08-2019,21 - 22,1103,1468,8576,2261,13408
27-08-2019,22 - 23,995,1302,7842,2132,12271
27-08-2019,23 - 00,938,1266,7343,2043,11590
28-08-2019,00 - 01,968,1332,6852,1961,11113
28-08-2019,01 - 02,992,1225,6669,1765,10651
28-08-2019,02 - 03,983,1223,6693,1697,10596
28-08-2019,03 - 04,1044,1250,6752,1660,10706
28-08-2019,04 - 05,1100,1342,6813,1625,10880
28-08-2019,05 - 06,1021,1340,7155,1869,11385
28-08-2019,06 - 07,1056,1481,7939,2133,12609
28-08-2019,07 - 08,1083,1559,9001,2466,14109
28-08-2019,08 - 09,1052,1516,9350,2640,14558
28-08-2019,09 - 10,1122,1613,9510,2753,14998
28-08-2019,10 - 11,1046,1563,9691,2839,15139
28-08-2019,11 - 12,1100,1472,9729,2875,15176
28-08-2019,12 - 13,1023,1542,9600,2800,14965
28-08-2019,13 - 14,1091,1440,9595,2715,14841
28-08-2019,14 - 15,1125,1621,9625,2654,15025
28-08-2019,15 - 16,1131,1494,9575,2658,14858
28-08-2019,16 - 17,1081,1436,9435,2651,14603
28-08-2019,17 - 18,1019,1540,9382,2668,14609
28-08-2019,18 - 19,1159,1518,9138,2614,14429
28-08-2019,19 - 20,1033,1458,8909,2568,13968
28-08-2019,20 - 21,1010,1376,8821,2486,13693
28-08-2019,21 - 22,983,1369,8433,2352,13137
28-08-2019,22 - 23,1044,1213,7811,2175,12243
28-08-2019,23 - 00,929,1160,7228,1983,11300
29-08-2019,00 - 01,791,1071,6794,1865,10521
29-08-2019,01 - 02,848,1061,6516,1775,10200
29-08-2019,02 - 03,871,1197,6418,1758,10244
29-08-2019,03 - 04,934,1413,6353,1840,10540
29-08-2019,04 - 05,1006,1410,6504,1876,10796
29-08-2019,05 - 06,1025,1299,6873,1949,11146
29-08-2019,06 - 07,1072,1559,7951,2180,12762
29-08-2019,07 - 08,1134,1723,8985,2451,14293
29-08-2019,08 - 09,1150,1766,9431,2591,14938
29-08-2019,09 - 10,1139,1762,9546,2638,15085
29-08-2019,10 - 11,1207,1946,9540,2707,15400
29-08-2019,11 - 12,1131,1990,9742,2793,15656
29-08-2019,12 - 13,1197,1852,9675,2768,15492
29-08-2019,13 - 14,1342,2017,9661,2776,15796
29-08-2019,14 - 15,1302,2034,9610,2685,15631
29-08-2019,15 - 16,1324,1892,9524,2640,15380
29-08-2019,16 - 17,1091,1660,9359,2658,14768
29-08-2019,17 - 18,1229,1736,9365,2633,14963
29-08-2019,18 - 19,1092,1486,9193,2547,14318
29-08-2019,19 - 20,1110,1585,9123,2506,14324
29-08-2019,20 - 21,1258,1819,8970,2527,14574
29-08-2019,21 - 22,1125,1623,8471,2366,13585
29-08-2019,22 - 23,1105,1637,7856,2178,12776
29-08-2019,23 - 00,922,1516,7397,1974,11809
30-08-2019,00 - 01,959,1441,7036,1867,11303
30-08-2019,01 - 02,1030,1355,6857,1770,11012
30-08-2019,02 - 03,1057,1439,6781,1749,11026
30-08-2019,03 - 04,958,1549,6810,1732,11049
30-08-2019,04 - 05,874,1522,6868,1734,10998
30-08-2019,05 - 06,983,1715,7329,1867,11894
30-08-2019,06 - 07,1343,1837,8252,2111,13543
30-08-2019,07 - 08,1208,1668,9063,2469,14408
30-08-2019,08 - 09,1179,1676,9330,2610,14795
30-08-2019,09 - 10,1331,1647,9690,2639,15307
30-08-2019,10 - 11,1289,1733,9870,2680,15572
30-08-2019,11 - 12,1215,1555,9457,2664,14891
30-08-2019,12 - 13,1085,1556,9219,2605,14465
30-08-2019,13 - 14,1089,1654,9130,2538,14411
30-08-2019,14 - 15,1061,1557,8965,2437,14020
30-08-2019,15 - 16,1079,1503,8837,2413,13832
30-08-2019,16 - 17,1143,1517,8940,2386,13986
30-08-2019,17 - 18,1139,1523,8940,2462,14064
30-08-2019,18 - 19,1135,1544,8693,2460,13832
30-08-2019,19 - 20,1012,1467,8576,2343,13398
30-08-2019,20 - 21,1051,1309,8475,2295,13130
30-08-2019,21 - 22,1111,1124,7949,2155,12339
30-08-2019,22 - 23,1145,1247,7371,1959,11722
30-08-2019,23 - 00,918,1293,6972,1845,11028
31-08-2019,00 - 01,1037,1320,6693,1733,10783
31-08-2019,01 - 02,942,1226,6466,1697,10331
31-08-2019,02 - 03,924,1228,6352,1694,10198
31-08-2019,03 - 04,900,1254,6352,1692,10198
31-08-2019,04 - 05,876,1192,6293,1726,10087
31-08-2019,05 - 06,946,1064,6379,1774,10163
31-08-2019,06 - 07,926,1161,6553,1726,10366
31-08-2019,07 - 08,929,1253,6972,1803,10957
31-08-2019,08 - 09,1013,1287,7542,1970,11812
31-08-2019,09 - 10,1078,1417,7987,2139,12621
31-08-2019,10 - 11,1087,1545,8120,2197,12949
31-08-2019,11 - 12,1069,1612,8222,2223,13126
31-08-2019,12 - 13,1032,1542,8150,2143,12867
31-08-2019,13 - 14,1021,1552,8050,2142,12765
31-08-2019,14 - 15,998,1431,8006,2104,12539
31-08-2019,15 - 16,972,1469,7843,2087,12371
31-08-2019,16 - 17,984,1541,7923,2090,12538
31-08-2019,17 - 18,1018,1403,8016,2126,12563
31-08-2019,18 - 19,1013,1513,8185,2172,12883
31-08-2019,19 - 20,1068,1367,8049,2162,12646
31-08-2019,20 - 21,991,1278,8006,2207,12482
31-08-2019,21 - 22,975,1282,7587,2097,11941
31-08-2019,22 - 23,989,1199,7172,1947,11307
31-08-2019,23 - 00,1006,1154,6709,1740,10609
01-09-2019,00 - 01,992,1110,6449,1712,10263
01-09-2019,01 - 02,987,1069,6260,1655,9971
01-09-2019,02 - 03,984,977,6126,1565,9652
01-09-2019,03 - 04,1074,1057,6022,1591,9744
01-09-2019,04 - 05,1007,1068,6022,1521,9618
01-09-2019,05 - 06,917,983,6084,1554,9538
01-09-2019,06 - 07,921,816,6280,1730,9747
01-09-2019,07 - 08,1016,1125,6839,1879,10859
01-09-2019,08 - 09,993,1198,7349,2033,11573
01-09-2019,09 - 10,1032,1428,7759,2180,12399
01-09-2019,10 - 11,1060,1480,8184,2151,12875
01-09-2019,11 - 12,1046,1460,8407,2069,12982
01-09-2019,12 - 13,967,1576,8408,2145,13096
01-09-2019,13 - 14,1087,1741,8240,2172,13240
01-09-2019,14 - 15,1121,1823,7984,2281,13209
01-09-2019,15 - 16,1201,1708,8009,2303,13221
01-09-2019,16 - 17,1208,1502,8135,2300,13145
01-09-2019,17 - 18,1149,1554,8393,2328,13424
01-09-2019,18 - 19,1090,1454,8419,2377,13340
01-09-2019,19 - 20,1002,1394,8265,2318,12979
01-09-2019,20 - 21,962,1635,8341,2399,13337
01-09-2019,21 - 22,1130,1477,8056,2270,12933
01-09-2019,22 - 23,1140,1588,7509,2110,12347
01-09-2019,23 - 00,1105,1549,7101,1954,11709
02-09-2019,00 - 01,1035,1584,6927,1740,11286
02-09-2019,01 - 02,1023,1637,6628,1630,10918
02-09-2019,02 - 03,1053,1506,6658,1630,10847
02-09-2019,03 - 04,1074,1310,6631,1671,10686
02-09-2019,04 - 05,1045,1237,6689,1703,10674
02-09-2019,05 - 06,1102,1321,7130,1817,11370
02-09-2019,06 - 07,1270,1409,8123,2064,12866
02-09-2019,07 - 08,1212,1394,9179,2402,14187
02-09-2019,08 - 09,1141,1428,9554,2555,14678
02-09-2019,09 - 10,1176,1534,9528,2554,14792
02-09-2019,10 - 11,1281,1575,9491,2545,14892
02-09-2019,11 - 12,1338,1660,9561,2537,15096
02-09-2019,12 - 13,1308,1627,9499,2445,14879
02-09-2019,13 - 14,1306,1616,9295,2577,14794
02-09-2019,14 - 15,1184,1662,9148,2629,14623
02-09-2019,15 - 16,1226,1681,9158,2648,14713
02-09-2019,16 - 17,1186,1659,9066,2588,14499
02-09-2019,17 - 18,1087,1908,9174,2612,14781
02-09-2019,18 - 19,1157,1768,9050,2594,14569
02-09-2019,19 - 20,1252,1696,9047,2531,14526
02-09-2019,20 - 21,1252,1741,9184,2529,14706
02-09-2019,21 - 22,1149,1571,8698,2360,13778
02-09-2019,22 - 23,981,1509,8066,2193,12749
02-09-2019,23 - 00,954,1424,7522,1998,11898
03-09-2019,00 - 01,1028,1548,7268,1915,11759
03-09-2019,01 - 02,870,1488,7005,1845,11208
03-09-2019,02 - 03,919,1497,6891,1818,11125
03-09-2019,03 - 04,970,1508,6850,1849,11177
03-09-2019,04 - 05,977,1456,6899,1867,11199
03-09-2019,05 - 06,1006,1375,7295,1992,11668
03-09-2019,06 - 07,1143,1343,8242,2249,12977
03-09-2019,07 - 08,1176,1366,9339,2481,14362
03-09-2019,08 - 09,1077,1468,9642,2753,14940
03-09-2019,09 - 10,1153,1660,9704,2866,15383
03-09-2019,10 - 11,1128,1730,9671,2861,15390
03-09-2019,11 - 12,1093,1758,9682,2923,15456
03-09-2019,12 - 13,1116,1630,9439,2979,15164
03-09-2019,13 - 14,1098,1690,9351,2992,15131
03-09-2019,14 - 15,1094,1601,9311,2945,14951
03-09-2019,15 - 16,1110,1719,9258,2819,14906
03-09-2019,16 - 17,1113,1746,9130,2700,14689
03-09-2019,17 - 18,1055,1748,9150,2666,14619
03-09-2019,18 - 19,1089,1709,9053,2656,14507
03-09-2019,19 - 20,975,1547,8979,2663,14164
03-09-2019,20 - 21,1063,1545,9047,2603,14258
03-09-2019,21 - 22,1234,1477,8611,2415,13737
03-09-2019,22 - 23,1082,1515,7941,2206,12744
03-09-2019,23 - 00,922,1449,7419,2040,11830
04-09-2019,00 - 01,832,1240,7088,1955,11115
04-09-2019,01 - 02,895,1187,6963,1856,10901
04-09-2019,02 - 03,1039,1127,6941,1806,10913
04-09-2019,03 - 04,1022,1196,6971,1801,10990
04-09-2019,04 - 05,976,1217,7014,1794,11001
04-09-2019,05 - 06,942,1405,7431,1959,11737
04-09-2019,06 - 07,1081,1415,8404,2262,13162
04-09-2019,07 - 08,1091,1602,9346,2585,14624
04-09-2019,08 - 09,1088,1781,9765,2781,15415
04-09-2019,09 - 10,1150,1824,9875,2788,15637
04-09-2019,10 - 11,1149,1779,9781,2825,15534
04-09-2019,11 - 12,1133,1779,9864,2817,15593
04-09-2019,12 - 13,1128,1734,9797,2761,15420
04-09-2019,13 - 14,1098,1601,9649,2754,15102
04-09-2019,14 - 15,1095,1603,9599,2781,15078
04-09-2019,15 - 16,1130,1642,9580,2732,15084
04-09-2019,16 - 17,1065,1637,9562,2673,14937
04-09-2019,17 - 18,1038,1686,9779,2700,15203
04-09-2019,18 - 19,1069,1638,9686,2704,15097
04-09-2019,19 - 20,1084,1582,9563,2687,14916
04-09-2019,20 - 21,1050,1601,9461,2687,14799
04-09-2019,21 - 22,804,1398,8951,2539,13692
04-09-2019,22 - 23,931,1234,8249,2227,12641
04-09-2019,23 - 00,1019,1281,7705,2035,12040
05-09-2019,00 - 01,1067,1174,7433,1949,11623
05-09-2019,01 - 02,990,1164,7239,1846,11239
05-09-2019,02 - 03,1001,1191,7177,1777,11146
05-09-2019,03 - 04,980,1219,7142,1815,11156
05-09-2019,04 - 05,961,1272,7237,1792,11262
05-09-2019,05 - 06,986,1390,7665,1898,11939
05-09-2019,06 - 07,909,1610,8462,2146,13127
05-09-2019,07 - 08,1031,1680,9385,2486,14582
05-09-2019,08 - 09,1044,1773,9673,2654,15144
05-09-2019,09 - 10,1010,1813,9532,2671,15026
05-09-2019,10 - 11,1107,1720,9421,2593,14841
05-09-2019,11 - 12,1165,1841,9441,2639,15086
05-09-2019,12 - 13,1165,1840,9399,2696,15100
05-09-2019,13 - 14,1261,1617,9440,2633,14951
05-09-2019,14 - 15,1020,1676,9385,2739,14820
05-09-2019,15 - 16,929,1593,9377,2727,14626
05-09-2019,16 - 17,1121,1590,9368,2579,14658
05-09-2019,17 - 18,1231,1659,9581,2669,15140
05-09-2019,18 - 19,1145,1645,9484,2648,14922
05-09-2019,19 - 20,1013,1639,9422,2646,14720
05-09-2019,20 - 21,1082,1608,9502,2526,14718
05-09-2019,21 - 22,1044,1485,9020,2349,13898
05-09-2019,22 - 23,966,1405,8429,2182,12982
05-09-2019,23 - 00,950,1327,7824,1914,12015
06-09-2019,00 - 01,934,1373,7467,1833,11607
06-09-2019,01 - 02,1114,1356,7254,1856,11580
06-09-2019,02 - 03,1029,1281,7173,1860,11343
06-09-2019,03 - 04,950,1254,7160,1915,11279
06-09-2019,04 - 05,837,1229,7284,1895,11245
06-09-2019,05 - 06,941,1338,7659,2031,11969
06-09-2019,06 - 07,1071,1380,8593,2328,13372
06-09-2019,07 - 08,1191,1684,9533,2684,15092
06-09-2019,08 - 09,1204,1983,9769,2761,15717
06-09-2019,09 - 10,1198,1906,9811,2760,15675
06-09-2019,10 - 11,1109,1788,9830,2692,15419
06-09-2019,11 - 12,1059,1803,9667,2626,15155
06-09-2019,12 - 13,906,1717,9526,2614,14763
06-09-2019,13 - 14,1081,1708,9349,2643,14781
06-09-2019,14 - 15,1034,1630,9065,2638,14367
06-09-2019,15 - 16,1077,1593,8809,2537,14016
06-09-2019,16 - 17,1025,1581,8792,2394,13792
06-09-2019,17 - 18,1068,1606,8870,2391,13935
06-09-2019,18 - 19,1147,1544,8932,2412,14035
06-09-2019,19 - 20,1050,1550,8828,2453,13881
06-09-2019,20 - 21,1022,1391,8608,2497,13518
06-09-2019,21 - 22,978,1469,8095,2388,12930
06-09-2019,22 - 23,1033,1457,7746,2162,12398
06-09-2019,23 - 00,1179,1400,7262,2098,11939
07-09-2019,00 - 01,1160,1284,6938,2012,11394
07-09-2019,01 - 02,1139,1343,6802,1854,11138
07-09-2019,02 - 03,1058,1257,6722,1824,10861
07-09-2019,03 - 04,1049,1375,6738,1810,10972
07-09-2019,04 - 05,993,1512,6707,1851,11063
07-09-2019,05 - 06,1007,1458,6793,1876,11134
07-09-2019,06 - 07,1084,1414,6890,1848,11236
07-09-2019,07 - 08,1157,1443,7369,1941,11910
07-09-2019,08 - 09,1099,1523,7947,2234,12803
07-09-2019,09 - 10,1116,1618,8317,2331,13382
07-09-2019,10 - 11,1116,1649,8455,2333,13553
07-09-2019,11 - 12,1083,1676,8436,2210,13405
07-09-2019,12 - 13,1064,1625,8339,2107,13135
07-09-2019,13 - 14,1105,1606,8222,2063,12996
07-09-2019,14 - 15,1062,1530,8026,2026,12644
07-09-2019,15 - 16,994,1487,7952,2036,12469
07-09-2019,16 - 17,1047,1519,8018,2080,12664
07-09-2019,17 - 18,1010,1587,8192,2123,12912
07-09-2019,18 - 19,1033,1638,8260,2130,13061
07-09-2019,19 - 20,1063,1581,8226,2125,12995
07-09-2019,20 - 21,1078,1557,8408,2176,13219
07-09-2019,21 - 22,1062,1418,8042,2073,12595
07-09-2019,22 - 23,1052,1447,7635,2008,12142
07-09-2019,23 - 00,996,1353,7244,1886,11479
08-09-2019,00 - 01,1022,1386,6961,1780,11149
08-09-2019,01 - 02,926,1448,6820,1704,10898
08-09-2019,02 - 03,950,1365,6804,1634,10753
08-09-2019,03 - 04,1009,1361,6727,1638,10735
08-09-2019,04 - 05,1031,1365,6726,1631,10753
08-09-2019,05 - 06,1017,1379,6786,1633,10815
08-09-2019,06 - 07,992,1382,6797,1632,10803
08-09-2019,07 - 08,1056,1436,6992,1708,11192
08-09-2019,08 - 09,1093,1541,7380,1929,11943
08-09-2019,09 - 10,1115,1653,7812,2098,12678
08-09-2019,10 - 11,1015,1611,7992,2173,12791
08-09-2019,11 - 12,1035,1562,8157,2214,12968
08-09-2019,12 - 13,1049,1563,8133,2198,12943
08-09-2019,13 - 14,1024,1531,8031,2160,12746
08-09-2019,14 - 15,1017,1531,7986,2132,12666
08-09-2019,15 - 16,1052,1568,8004,2173,12797
08-09-2019,16 - 17,1043,1581,8129,2225,12978
08-09-2019,17 - 18,1109,1584,8447,2277,13417
08-09-2019,18 - 19,1124,1634,8674,2272,13704
08-09-2019,19 - 20,1072,1612,8628,2282,13594
08-09-2019,20 - 21,1144,1629,8491,2310,13574
08-09-2019,21 - 22,1114,1580,7973,2159,12826
08-09-2019,22 - 23,1067,1520,7530,2030,12147
08-09-2019,23 - 00,919,1479,7165,1938,11501
09-09-2019,00 - 01,960,1467,7020,1896,11343
09-09-2019,01 - 02,982,1442,6777,1832,11033
09-09-2019,02 - 03,962,1474,6742,1796,10974
09-09-2019,03 - 04,901,1503,6760,1777,10941
09-09-2019,04 - 05,1128,1557,6796,1803,11284
09-09-2019,05 - 06,1124,1572,7257,1911,11864
09-09-2019,06 - 07,1198,1704,8344,2254,13500
09-09-2019,07 - 08,1137,1816,9362,2586,14901
09-09-2019,08 - 09,1238,1863,9872,2747,15720
09-09-2019,09 - 10,1150,1846,9878,2826,15700
09-09-2019,10 - 11,1096,1787,10080,2827,15790
09-09-2019,11 - 12,1049,1859,10085,2793,15786
09-09-2019,12 - 13,1119,1820,9893,2732,15564
09-09-2019,13 - 14,1081,1783,9838,2714,15416
09-09-2019,14 - 15,1067,1792,9752,2728,15339
09-09-2019,15 - 16,1069,1820,9658,2681,15228
09-09-2019,16 - 17,1122,1885,9474,2664,15145
09-09-2019,17 - 18,1141,1786,9525,2682,15134
09-09-2019,18 - 19,1085,1731,9356,2593,14765
09-09-2019,19 - 20,1074,1688,9344,2577,14683
09-09-2019,20 - 21,1103,1745,9226,2555,14629
09-09-2019,21 - 22,1089,1625,8633,2441,13788
09-09-2019,22 - 23,1025,1580,7982,2336,12923
09-09-2019,23 - 00,952,1456,7451,2124,11983
10-09-2019,00 - 01,999,1431,7078,1953,11461
10-09-2019,01 - 02,984,1419,6885,1883,11171
10-09-2019,02 - 03,1000,1433,6776,1890,11099
10-09-2019,03 - 04,977,1393,6758,1775,10903
10-09-2019,04 - 05,1011,1438,6955,1832,11236
10-09-2019,05 - 06,1135,1495,7308,2007,11945
10-09-2019,06 - 07,1137,1639,8280,2293,13349
10-09-2019,07 - 08,1197,1691,9139,2610,14637
10-09-2019,08 - 09,1051,1761,9301,2704,14817
10-09-2019,09 - 10,1149,1800,9398,2766,15113
10-09-2019,10 - 11,1187,1687,9467,2880,15221
10-09-2019,11 - 12,1136,1709,9509,2903,15257
10-09-2019,12 - 13,1139,1635,9369,2841,14984
10-09-2019,13 - 14,1176,1688,9238,2773,14875
10-09-2019,14 - 15,1161,1766,9115,2756,14798
10-09-2019,15 - 16,1089,1704,9170,2752,14715
10-09-2019,16 - 17,1144,1673,9221,2703,14741
10-09-2019,17 - 18,1155,1749,9320,2768,14992
10-09-2019,18 - 19,1096,1595,9182,2678,14551
10-09-2019,19 - 20,1125,1562,9337,2717,14741
10-09-2019,20 - 21,1092,1681,9291,2713,14777
10-09-2019,21 - 22,1030,1522,8762,2545,13859
10-09-2019,22 - 23,993,1542,8113,2333,12981
10-09-2019,23 - 00,915,1446,7403,2116,11880
11-09-2019,00 - 01,951,1480,6951,1943,11325
11-09-2019,01 - 02,853,1408,6729,1935,10925
11-09-2019,02 - 03,859,1350,6614,1858,10681
11-09-2019,03 - 04,897,1399,6532,1795,10623
11-09-2019,04 - 05,990,1312,6628,1853,10783
11-09-2019,05 - 06,1068,1489,7021,2005,11583
11-09-2019,06 - 07,1084,1661,8095,2282,13122
11-09-2019,07 - 08,1091,1676,9036,2689,14492
11-09-2019,08 - 09,1121,1654,9420,2851,15046
11-09-2019,09 - 10,1038,1607,9434,2832,14911
11-09-2019,10 - 11,1103,1790,9570,2781,15244
11-09-2019,11 - 12,1037,1723,9401,2725,14886
11-09-2019,12 - 13,1033,1623,9298,2627,14581
11-09-2019,13 - 14,997,1575,9283,2629,14484
11-09-2019,14 - 15,985,1568,9158,2635,14346
11-09-2019,15 - 16,1039,1693,9320,2618,14670
11-09-2019,16 - 17,987,1606,9248,2575,14416
11-09-2019,17 - 18,915,1557,9332,2643,14447
11-09-2019,18 - 19,956,1559,9319,2620,14454
11-09-2019,19 - 20,1069,1465,9310,2677,14521
11-09-2019,20 - 21,979,1524,9222,2592,14317
11-09-2019,21 - 22,896,1420,8643,2442,13401
11-09-2019,22 - 23,871,1389,7936,2255,12451
11-09-2019,23 - 00,970,1443,7311,2046,11770
12-09-2019,00 - 01,1000,1318,6938,2064,11320
12-09-2019,01 - 02,950,1332,6752,2061,11095
12-09-2019,02 - 03,986,1450,6673,1985,11094
12-09-2019,03 - 04,1000,1365,6703,1935,11003
12-09-2019,04 - 05,917,1448,6811,1980,11156
12-09-2019,05 - 06,943,1529,7171,2086,11729
12-09-2019,06 - 07,1067,1567,8171,2431,13236
12-09-2019,07 - 08,1103,1714,9064,2714,14595
12-09-2019,08 - 09,1134,1857,9377,2847,15215
12-09-2019,09 - 10,1131,1747,9344,2834,15056
12-09-2019,10 - 11,1170,1662,9314,2789,14935
12-09-2019,11 - 12,1038,1556,9206,2714,14514
12-09-2019,12 - 13,975,1651,9182,2699,14507
12-09-2019,13 - 14,1029,1696,9046,2792,14563
12-09-2019,14 - 15,1062,1466,8941,2735,14204
12-09-2019,15 - 16,1030,1687,8957,2677,14351
12-09-2019,16 - 17,1196,1831,9030,2635,14692
12-09-2019,17 - 18,1102,1398,9199,2703,14402
12-09-2019,18 - 19,1179,1289,8981,2676,14125
12-09-2019,19 - 20,1107,1421,9077,2717,14322
12-09-2019,20 - 21,1030,1629,8950,2688,14297
12-09-2019,21 - 22,1086,1802,8263,2490,13641
12-09-2019,22 - 23,918,1673,7787,2246,12624
12-09-2019,23 - 00,996,1536,7348,2125,12005
13-09-2019,00 - 01,956,1201,6945,1974,11076
13-09-2019,01 - 02,976,1024,6707,1859,10566
13-09-2019,02 - 03,932,1177,6535,1860,10504
13-09-2019,03 - 04,896,1310,6509,1858,10573
13-09-2019,04 - 05,841,1329,6611,1909,10690
13-09-2019,05 - 06,1041,1241,7095,1978,11355
13-09-2019,06 - 07,1083,1425,8103,2216,12827
13-09-2019,07 - 08,1355,1592,9027,2522,14496
13-09-2019,08 - 09,1170,1655,9402,2754,14981
13-09-2019,09 - 10,1152,1801,9373,2729,15055
13-09-2019,10 - 11,1155,1708,9189,2654,14706
13-09-2019,11 - 12,1161,1596,9100,2609,14466
13-09-2019,12 - 13,1134,1558,8937,2578,14207
13-09-2019,13 - 14,1268,1571,8800,2548,14187
13-09-2019,14 - 15,1074,1670,8534,2478,13756
13-09-2019,15 - 16,1237,1503,8514,2439,13693
13-09-2019,16 - 17,1137,1581,8595,2417,13730
13-09-2019,17 - 18,990,1542,8746,2454,13732
13-09-2019,18 - 19,943,1783,8781,2561,14068
13-09-2019,19 - 20,1189,1683,8789,2525,14186
13-09-2019,20 - 21,1022,1605,8449,2437,13513
13-09-2019,21 - 22,884,1655,7978,2305,12822
13-09-2019,22 - 23,815,1660,7485,2196,12156
13-09-2019,23 - 00,869,1589,7084,1988,11530
14-09-2019,00 - 01,797,1518,6833,1962,11110
14-09-2019,01 - 02,938,1380,6652,1874,10844
14-09-2019,02 - 03,1009,1410,6593,1833,10845
14-09-2019,03 - 04,1077,1540,6583,1802,11002
14-09-2019,04 - 05,1102,1410,6710,1827,11049
14-09-2019,05 - 06,1017,1352,6890,1868,11127
14-09-2019,06 - 07,1092,1368,7011,1909,11380
14-09-2019,07 - 08,1104,1444,7288,2080,11916
14-09-2019,08 - 09,1043,1784,7799,2302,12928
14-09-2019,09 - 10,1140,1805,8206,2352,13503
14-09-2019,10 - 11,1147,1706,8146,2342,13341
14-09-2019,11 - 12,1101,1620,8090,2315,13126
14-09-2019,12 - 13,1076,1578,7964,2223,12841
14-09-2019,13 - 14,1014,1575,7731,2152,12472
14-09-2019,14 - 15,1003,1721,7615,2119,12458
14-09-2019,15 - 16,1060,1519,7640,2095,12314
14-09-2019,16 - 17,1122,1696,7864,2127,12809
14-09-2019,17 - 18,1087,2013,8192,2247,13539
14-09-2019,18 - 19,1060,1933,8174,2344,13511
14-09-2019,19 - 20,1108,1679,8358,2291,13436
14-09-2019,20 - 21,1123,1557,8206,2244,13130
14-09-2019,21 - 22,1092,1294,7771,2106,12263
14-09-2019,22 - 23,1128,1394,7406,2005,11933
14-09-2019,23 - 00,923,1354,7150,1866,11293
15-09-2019,00 - 01,982,1227,6871,1813,10893
15-09-2019,01 - 02,1017,1375,6687,1811,10890
15-09-2019,02 - 03,955,1429,6650,1782,10816
15-09-2019,03 - 04,810,1334,6582,1796,10522
15-09-2019,04 - 05,762,1363,6557,1758,10440
15-09-2019,05 - 06,903,1520,6729,1775,10927
15-09-2019,06 - 07,965,1588,6848,1840,11241
15-09-2019,07 - 08,921,1590,7009,1873,11393
15-09-2019,08 - 09,1000,1611,7329,2032,11972
15-09-2019,09 - 10,1094,1646,7833,2184,12757
15-09-2019,10 - 11,1043,1719,8106,2278,13146
15-09-2019,11 - 12,1085,1830,8208,2338,13461
15-09-2019,12 - 13,1229,1786,8200,2351,13566
15-09-2019,13 - 14,1113,1717,8160,2286,13276
15-09-2019,14 - 15,1100,1507,8029,2209,12845
15-09-2019,15 - 16,1112,1589,7956,2265,12922
15-09-2019,16 - 17,1119,1643,8038,2312,13112
15-09-2019,17 - 18,1218,1739,8321,2423,13701
15-09-2019,18 - 19,1213,1796,8468,2446,13923
15-09-2019,19 - 20,1156,1812,8747,2483,14198
15-09-2019,20 - 21,1064,1854,8704,2475,14097
15-09-2019,21 - 22,1092,1792,8160,2348,13392
15-09-2019,22 - 23,1022,1769,7865,2166,12822
15-09-2019,23 - 00,1002,1726,7529,2036,12293
16-09-2019,00 - 01,952,1732,7128,1987,11799
16-09-2019,01 - 02,893,1694,6957,1978,11522
16-09-2019,02 - 03,913,1561,6887,1971,11332
16-09-2019,03 - 04,1007,1576,6871,1979,11433
16-09-2019,04 - 05,1027,1596,7035,2008,11666
16-09-2019,05 - 06,1036,1614,7541,2147,12338
16-09-2019,06 - 07,1132,1826,8600,2523,14081
16-09-2019,07 - 08,1145,1902,9572,2834,15453
16-09-2019,08 - 09,1102,1921,9858,2920,15801
16-09-2019,09 - 10,1244,1991,9711,2883,15829
16-09-2019,10 - 11,1171,1943,9637,2877,15628
16-09-2019,11 - 12,1185,1971,9664,2889,15709
16-09-2019,12 - 13,1238,2023,9638,2825,15724
16-09-2019,13 - 14,1197,1932,9608,2811,15548
16-09-2019,14 - 15,1153,1922,9709,2788,15572
16-09-2019,15 - 16,1106,1791,9673,2751,15321
16-09-2019,16 - 17,1118,1745,9626,2696,15185
16-09-2019,17 - 18,1174,1933,9908,2754,15769
16-09-2019,18 - 19,1215,1866,10049,2818,15948
16-09-2019,19 - 20,1255,1649,10103,2964,15971
16-09-2019,20 - 21,1215,1665,9780,2913,15573
16-09-2019,21 - 22,1082,1542,9046,2663,14333
16-09-2019,22 - 23,1123,1531,8420,2448,13522
16-09-2019,23 - 00,1095,1530,7975,2257,12857
17-09-2019,00 - 01,1023,1508,7632,2134,12297
17-09-2019,01 - 02,845,1408,7454,2064,11771
17-09-2019,02 - 03,893,1459,7468,2034,11854
17-09-2019,03 - 04,872,1514,7539,2031,11956
17-09-2019,04 - 05,890,1604,7821,2119,12434
17-09-2019,05 - 06,945,1574,8261,2304,13084
17-09-2019,06 - 07,865,1684,9427,2673,14649
17-09-2019,07 - 08,783,1822,10356,2923,15884
17-09-2019,08 - 09,838,1780,10538,3025,16181
17-09-2019,09 - 10,1090,2117,10297,2968,16472
17-09-2019,10 - 11,1024,2009,10120,2986,16139
17-09-2019,11 - 12,1165,2025,9976,3040,16206
17-09-2019,12 - 13,1152,1916,9813,2916,15797
17-09-2019,13 - 14,1138,1838,9657,2927,15560
17-09-2019,14 - 15,1106,1862,9594,2974,15536
17-09-2019,15 - 16,1111,1824,9639,2979,15553
17-09-2019,16 - 17,1172,1836,9689,3029,15726
17-09-2019,17 - 18,1107,1913,9912,3002,15934
17-09-2019,18 - 19,1049,1815,9942,2935,15741
17-09-2019,19 - 20,1080,1798,10068,3099,16045
17-09-2019,20 - 21,1119,1727,9813,3022,15681
17-09-2019,21 - 22,1010,1573,9302,2773,14658
17-09-2019,22 - 23,947,1555,8636,2449,13587
17-09-2019,23 - 00,1028,1299,8010,2279,12616
18-09-2019,00 - 01,1053,1399,7671,2174,12297
18-09-2019,01 - 02,1067,1385,7421,2043,11916
18-09-2019,02 - 03,1041,1414,7331,1942,11728
18-09-2019,03 - 04,1003,1404,7561,1960,11928
18-09-2019,04 - 05,974,1379,7666,1994,12013
18-09-2019,05 - 06,931,1498,8130,2167,12726
18-09-2019,06 - 07,1087,1654,9308,2522,14571
18-09-2019,07 - 08,1114,1784,10365,2881,16144
18-09-2019,08 - 09,1119,1889,10585,3056,16649
18-09-2019,09 - 10,1108,1919,10574,3075,16676
18-09-2019,10 - 11,1301,1844,10293,2985,16423
18-09-2019,11 - 12,1113,1819,10167,2923,16022
18-09-2019,12 - 13,1132,1821,10008,2822,15783
18-09-2019,13 - 14,1036,1900,9910,2745,15591
18-09-2019,14 - 15,1066,1834,9698,2688,15286
18-09-2019,15 - 16,1065,1783,9516,2632,14996
18-09-2019,16 - 17,1058,1805,9432,2631,14926
18-09-2019,17 - 18,1136,1923,9659,2766,15484
18-09-2019,18 - 19,1131,2034,9878,2810,15853
18-09-2019,19 - 20,1127,1833,10120,2847,15927
18-09-2019,20 - 21,1063,1651,10053,2768,15535
18-09-2019,21 - 22,1133,1539,9390,2580,14642
18-09-2019,22 - 23,1168,1564,8571,2363,13666
18-09-2019,23 - 00,995,1564,7962,2163,12684
19-09-2019,00 - 01,882,1471,7574,2103,12030
19-09-2019,01 - 02,819,1494,7570,2059,11942
19-09-2019,02 - 03,870,1443,7499,2042,11854
19-09-2019,03 - 04,990,1375,7472,2041,11878
19-09-2019,04 - 05,973,1261,7649,2085,11968
19-09-2019,05 - 06,917,1355,8232,2278,12782
19-09-2019,06 - 07,997,1553,9394,2624,14568
19-09-2019,07 - 08,1101,1742,10283,2899,16025
19-09-2019,08 - 09,1075,1949,10524,3025,16573
19-09-2019,09 - 10,1135,1978,10414,3036,16563
19-09-2019,10 - 11,1176,1863,10226,2971,16236
19-09-2019,11 - 12,1113,1838,10132,2872,15955
19-09-2019,12 - 13,1027,1840,10014,2770,15651
19-09-2019,13 - 14,1027,2044,9909,2795,15775
19-09-2019,14 - 15,995,1934,9738,2741,15408
19-09-2019,15 - 16,1034,1852,9652,2708,15246
19-09-2019,16 - 17,1025,2016,9767,2691,15499
19-09-2019,17 - 18,1150,2048,10006,2769,15973
19-09-2019,18 - 19,1191,1838,10126,2777,15932
19-09-2019,19 - 20,1182,1681,10404,2862,16129
19-09-2019,20 - 21,1122,1768,10199,2799,15888
19-09-2019,21 - 22,1139,1657,9775,2651,15222
19-09-2019,22 - 23,1012,1609,9192,2471,14284
19-09-2019,23 - 00,949,1609,8691,2307,13556
20-09-2019,00 - 01,1031,1615,8322,2219,13187
20-09-2019,01 - 02,974,1626,8124,2175,12899
20-09-2019,02 - 03,852,1594,8000,2175,12621
20-09-2019,03 - 04,997,1591,7945,2175,12708
20-09-2019,04 - 05,1042,1613,8063,2232,12950
20-09-2019,05 - 06,1051,1635,8553,2333,13572
20-09-2019,06 - 07,1196,1852,9721,2648,15417
20-09-2019,07 - 08,1219,1941,10440,2924,16524
20-09-2019,08 - 09,1202,2019,10504,3009,16734
20-09-2019,09 - 10,1238,2017,10428,3058,16741
20-09-2019,10 - 11,1198,1936,10332,3112,16578
20-09-2019,11 - 12,1102,1899,10069,3058,16128
20-09-2019,12 - 13,1051,1797,9836,2958,15642
20-09-2019,13 - 14,1022,1709,9578,2819,15128
20-09-2019,14 - 15,1032,1709,9354,2679,14774
20-09-2019,15 - 16,1046,1674,9247,2597,14564
20-09-2019,16 - 17,1052,1713,9247,2650,14662
20-09-2019,17 - 18,1008,1589,9373,2752,14722
20-09-2019,18 - 19,1009,1581,9438,2726,14754
20-09-2019,19 - 20,1006,1603,9334,2703,14646
20-09-2019,20 - 21,1098,1489,8932,2543,14062
20-09-2019,21 - 22,1059,1492,8321,2344,13216
20-09-2019,22 - 23,1037,1521,7850,2235,12643
20-09-2019,23 - 00,974,1367,7472,2099,11912
21-09-2019,00 - 01,989,1411,7079,1971,11450
21-09-2019,01 - 02,927,1431,6764,1896,11018
21-09-2019,02 - 03,942,1427,6715,1899,10983
21-09-2019,03 - 04,951,1395,6676,1872,10894
21-09-2019,04 - 05,979,1455,6745,1869,11048
21-09-2019,05 - 06,1007,1429,6786,1861,11083
21-09-2019,06 - 07,1044,1362,6990,1937,11333
21-09-2019,07 - 08,937,1335,7325,2043,11640
21-09-2019,08 - 09,958,1410,7658,2228,12254
21-09-2019,09 - 10,1072,1381,7956,2345,12754
21-09-2019,10 - 11,1017,1262,8050,2360,12689
21-09-2019,11 - 12,1024,1486,7981,2333,12824
21-09-2019,12 - 13,1015,1660,7906,2297,12878
21-09-2019,13 - 14,1015,1665,7887,2236,12803
21-09-2019,14 - 15,1038,1410,7711,2193,12352
21-09-2019,15 - 16,987,1462,7576,2138,12163
21-09-2019,16 - 17,934,1343,7657,2172,12106
21-09-2019,17 - 18,1115,1611,8024,2292,13042
21-09-2019,18 - 19,1066,1681,8178,2367,13292
21-09-2019,19 - 20,1163,1605,8314,2429,13511
21-09-2019,20 - 21,1001,1605,8099,2408,13113
21-09-2019,21 - 22,962,1645,7657,2225,12489
21-09-2019,22 - 23,920,1578,7294,2098,11890
21-09-2019,23 - 00,923,1529,7059,1999,11510
22-09-2019,00 - 01,875,1507,6720,1897,10999
22-09-2019,01 - 02,854,1488,6609,1909,10860
22-09-2019,02 - 03,874,1484,6658,1928,10944
22-09-2019,03 - 04,891,1466,6602,1916,10875
22-09-2019,04 - 05,898,1597,6580,1926,11001
22-09-2019,05 - 06,849,1492,6731,1910,10982
22-09-2019,06 - 07,855,1511,6950,1861,11177
22-09-2019,07 - 08,957,1474,7078,1865,11374
22-09-2019,08 - 09,1178,1521,7516,2027,12242
22-09-2019,09 - 10,1151,1656,7914,2217,12938
22-09-2019,10 - 11,1064,1708,8227,2285,13284
22-09-2019,11 - 12,991,1640,8492,2252,13375
22-09-2019,12 - 13,1023,1586,8495,2193,13297
22-09-2019,13 - 14,1023,1672,8304,2141,13140
22-09-2019,14 - 15,985,1625,8142,2077,12829
22-09-2019,15 - 16,1031,1634,8021,2029,12715
22-09-2019,16 - 17,976,1628,8148,2096,12848
22-09-2019,17 - 18,1072,1729,8448,2271,13520
22-09-2019,18 - 19,1139,1840,8693,2345,14017
22-09-2019,19 - 20,1211,1824,8975,2368,14378
22-09-2019,20 - 21,1197,1699,8862,2193,13951
22-09-2019,21 - 22,1090,1594,8379,2084,13147
22-09-2019,22 - 23,998,1585,7910,2026,12519
22-09-2019,23 - 00,956,1508,7556,1940,11960
23-09-2019,00 - 01,1003,1435,7336,1845,11619
23-09-2019,01 - 02,1042,1394,7257,1773,11466
23-09-2019,02 - 03,1048,1396,7261,1752,11457
23-09-2019,03 - 04,1039,1409,7360,1787,11595
23-09-2019,04 - 05,1023,1339,7562,1831,11755
23-09-2019,05 - 06,1130,1424,8097,2047,12698
23-09-2019,06 - 07,1206,1592,9410,2474,14682
23-09-2019,07 - 08,1213,1687,10232,2792,15924
23-09-2019,08 - 09,1176,1806,10413,2818,16213
23-09-2019,09 - 10,1203,1872,10399,2881,16355
23-09-2019,10 - 11,1172,1808,10210,2810,16000
23-09-2019,11 - 12,1187,1759,9971,2803,15720
23-09-2019,12 - 13,1197,1835,10010,2739,15781
23-09-2019,13 - 14,1128,1862,9769,2698,15457
23-09-2019,14 - 15,1050,1735,9553,2660,14998
23-09-2019,15 - 16,1062,1815,9613,2659,15149
23-09-2019,16 - 17,1079,1913,9630,2592,15214
23-09-2019,17 - 18,1070,1896,9822,2646,15434
23-09-2019,18 - 19,1079,1868,9894,2704,15545
23-09-2019,19 - 20,1121,1960,10042,2799,15922
23-09-2019,20 - 21,1067,1908,9652,2713,15340
23-09-2019,21 - 22,1087,1854,9052,2619,14612
23-09-2019,22 - 23,1061,1779,8395,2406,13641
23-09-2019,23 - 00,1077,1694,7925,2248,12944
24-09-2019,00 - 01,1007,1544,7497,2190,12238
24-09-2019,01 - 02,943,1580,7277,2079,11879
24-09-2019,02 - 03,950,1558,7277,2050,11835
24-09-2019,03 - 04,1030,1556,7319,2078,11983
24-09-2019,04 - 05,1025,1517,7368,2127,12037
24-09-2019,05 - 06,992,1590,7820,2259,12661
24-09-2019,06 - 07,1090,1785,9278,2640,14793
24-09-2019,07 - 08,1208,1836,10152,2898,16094
24-09-2019,08 - 09,1228,1786,10407,2955,16376
24-09-2019,09 - 10,1178,1828,10184,2921,16111
24-09-2019,10 - 11,1133,1803,10154,2915,16005
24-09-2019,11 - 12,1084,1767,10020,2904,15775
24-09-2019,12 - 13,1092,1850,9825,2892,15659
24-09-2019,13 - 14,1061,1783,9789,2836,15469
24-09-2019,14 - 15,1073,1803,9897,2830,15603
24-09-2019,15 - 16,1099,1793,9999,2834,15725
24-09-2019,16 - 17,1070,1808,9783,2796,15457
24-09-2019,17 - 18,1082,1776,9773,2850,15481
24-09-2019,18 - 19,1073,1800,9788,2838,15499
24-09-2019,19 - 20,1098,1885,10131,2907,16021
24-09-2019,20 - 21,1109,1847,9656,2832,15444
24-09-2019,21 - 22,1128,1779,8815,2668,14390
24-09-2019,22 - 23,917,1796,8587,2459,13759
24-09-2019,23 - 00,954,1594,8022,2262,12832
25-09-2019,00 - 01,1001,1577,7666,2084,12328
25-09-2019,01 - 02,970,1564,7577,2023,12134
25-09-2019,02 - 03,955,1519,7494,1988,11956
25-09-2019,03 - 04,891,1528,7554,1992,11965
25-09-2019,04 - 05,894,1516,7608,2013,12031
25-09-2019,05 - 06,827,1618,8298,2199,12942
25-09-2019,06 - 07,973,1871,9531,2548,14923
25-09-2019,07 - 08,1073,1890,10370,2853,16186
25-09-2019,08 - 09,991,1862,10558,2926,16337
25-09-2019,09 - 10,994,1878,10415,2936,16223
25-09-2019,10 - 11,1141,1955,10398,3008,16502
25-09-2019,11 - 12,1193,1938,10267,3038,16436
25-09-2019,12 - 13,1137,1959,10162,2994,16252
25-09-2019,13 - 14,1102,1801,10061,2960,15924
25-09-2019,14 - 15,1048,1836,10688,2910,16482
25-09-2019,15 - 16,1062,1801,10919,2895,16677
25-09-2019,16 - 17,1089,1853,9949,2808,15699
25-09-2019,17 - 18,1029,1746,9937,2794,15506
25-09-2019,18 - 19,944,1707,10013,2799,15463
25-09-2019,19 - 20,1013,1883,10016,2860,15772
25-09-2019,20 - 21,1131,1895,9914,2735,15675
25-09-2019,21 - 22,1115,1798,9343,2580,14836
25-09-2019,22 - 23,872,1655,8898,2356,13781
25-09-2019,23 - 00,926,1611,8346,2224,13107
26-09-2019,00 - 01,979,1536,7844,2130,12489
26-09-2019,01 - 02,948,1487,7663,2036,12134
26-09-2019,02 - 03,962,1395,7680,2025,12062
26-09-2019,03 - 04,985,1398,7644,2036,12063
26-09-2019,04 - 05,1085,1427,7597,2007,12116
26-09-2019,05 - 06,1019,1710,7887,2157,12773
26-09-2019,06 - 07,1171,1898,9276,2528,14873
26-09-2019,07 - 08,1114,1939,10242,2864,16159
26-09-2019,08 - 09,1057,1805,10446,2963,16271
26-09-2019,09 - 10,1137,1910,10349,2995,16391
26-09-2019,10 - 11,1099,1936,10280,2968,16283
26-09-2019,11 - 12,1101,1840,9907,2885,15733
26-09-2019,12 - 13,1143,1719,9760,2825,15447
26-09-2019,13 - 14,1059,1814,9686,2864,15423
26-09-2019,14 - 15,1024,1719,9614,2804,15161
26-09-2019,15 - 16,1050,1722,9574,2783,15129
26-09-2019,16 - 17,1055,1801,9531,2735,15122
26-09-2019,17 - 18,1079,1743,9747,2718,15287
26-09-2019,18 - 19,1057,1709,9850,2755,15371
26-09-2019,19 - 20,1049,1726,9995,2822,15592
26-09-2019,20 - 21,1016,1727,9654,2731,15128
26-09-2019,21 - 22,1126,1575,9153,2550,14404
26-09-2019,22 - 23,884,1529,8579,2319,13311
26-09-2019,23 - 00,663,1482,8115,2155,12415
27-09-2019,00 - 01,908,1400,7843,2082,12233
27-09-2019,01 - 02,962,1467,7696,2046,12171
27-09-2019,02 - 03,966,1473,7624,2017,12080
27-09-2019,03 - 04,959,1485,7615,2024,12083
27-09-2019,04 - 05,933,1447,7809,2092,12281
27-09-2019,05 - 06,1002,1607,8332,2215,13156
27-09-2019,06 - 07,1101,1800,9444,2579,14924
27-09-2019,07 - 08,1084,1779,10289,2887,16039
27-09-2019,08 - 09,1059,1812,10428,2989,16288
27-09-2019,09 - 10,1056,1746,10395,2965,16162
27-09-2019,10 - 11,1040,1748,10299,2943,16030
27-09-2019,11 - 12,1080,1709,10148,2965,15902
27-09-2019,12 - 13,1075,1682,9886,2932,15575
27-09-2019,13 - 14,1071,1617,9634,2853,15175
27-09-2019,14 - 15,1058,1614,9476,2799,14947
27-09-2019,15 - 16,1044,1506,9422,2695,14667
27-09-2019,16 - 17,1022,1645,9401,2538,14606
27-09-2019,17 - 18,1009,1642,9428,2552,14631
27-09-2019,18 - 19,1061,1603,9477,2595,14736
27-09-2019,19 - 20,1084,1708,9662,2641,15095
27-09-2019,20 - 21,1063,1731,9198,2471,14463
27-09-2019,21 - 22,1041,1533,8681,2344,13599
27-09-2019,22 - 23,971,1473,8161,2235,12840
27-09-2019,23 - 00,988,1503,7729,2084,12304
28-09-2019,00 - 01,974,1321,7395,1978,11668
28-09-2019,01 - 02,1048,1300,7188,1916,11452
28-09-2019,02 - 03,1036,1327,7099,1887,11349
28-09-2019,03 - 04,1012,1372,7114,1851,11349
28-09-2019,04 - 05,1051,1332,7076,1878,11337
28-09-2019,05 - 06,978,1377,7097,1925,11377
28-09-2019,06 - 07,927,1339,7302,1995,11563
28-09-2019,07 - 08,927,1412,7597,2046,11982
28-09-2019,08 - 09,830,1401,8038,2259,12528
28-09-2019,09 - 10,897,1506,8521,2350,13274
28-09-2019,10 - 11,1118,1642,8780,2401,13941
28-09-2019,11 - 12,1145,1511,8911,2359,13926
28-09-2019,12 - 13,1159,1507,8810,2304,13780
28-09-2019,13 - 14,1076,1552,8807,2283,13718
28-09-2019,14 - 15,1048,1728,8752,2234,13762
28-09-2019,15 - 16,1056,1695,8652,2237,13640
28-09-2019,16 - 17,1069,1590,8586,2313,13558
28-09-2019,17 - 18,1079,1546,8650,2429,13704
28-09-2019,18 - 19,981,1659,8851,2533,14024
28-09-2019,19 - 20,1013,1647,9013,2573,14246
28-09-2019,20 - 21,984,1568,8587,2369,13508
28-09-2019,21 - 22,855,1548,8237,2175,12815
28-09-2019,22 - 23,862,1465,7814,2037,12178
28-09-2019,23 - 00,1023,1383,7615,1948,11969
29-09-2019,00 - 01,1089,1434,7300,1858,11681
29-09-2019,01 - 02,1001,1448,7137,1795,11381
29-09-2019,02 - 03,953,1459,7048,1709,11169
29-09-2019,03 - 04,934,1409,7063,1755,11161
29-09-2019,04 - 05,1021,1411,6978,1765,11175
29-09-2019,05 - 06,1047,1408,7071,1856,11382
29-09-2019,06 - 07,1030,1447,7237,1963,11677
29-09-2019,07 - 08,996,1461,7405,1945,11807
29-09-2019,08 - 09,1031,1546,7893,2037,12507
29-09-2019,09 - 10,1157,1541,8175,2166,13039
29-09-2019,10 - 11,1191,1445,8465,2271,13372
29-09-2019,11 - 12,1089,1463,8655,2279,13486
29-09-2019,12 - 13,1060,1530,8585,2297,13472
29-09-2019,13 - 14,1066,1543,8501,2287,13397
29-09-2019,14 - 15,1050,1494,8447,2249,13240
29-09-2019,15 - 16,1076,1557,8443,2259,13335
29-09-2019,16 - 17,1116,1623,8487,2366,13592
29-09-2019,17 - 18,1086,1518,8832,2435,13871
29-09-2019,18 - 19,1100,1531,9368,2500,14499
29-09-2019,19 - 20,1141,1520,9637,2552,14850
29-09-2019,20 - 21,1163,1590,9092,2469,14314
29-09-2019,21 - 22,1110,1599,8717,2337,13763
29-09-2019,22 - 23,1024,1548,8198,2176,12946
29-09-2019,23 - 00,976,1282,7795,2020,12073
30-09-2019,00 - 01,939,1348,7433,1915,11635
30-09-2019,01 - 02,871,1326,7245,1870,11312
30-09-2019,02 - 03,881,1146,7219,1880,11126
30-09-2019,03 - 04,879,1219,7181,1896,11175
30-09-2019,04 - 05,871,1258,7235,1932,11296
30-09-2019,05 - 06,906,1402,7804,2108,12220
30-09-2019,06 - 07,971,1750,8937,2541,14199
30-09-2019,07 - 08,1059,1864,9825,2846,15594
30-09-2019,08 - 09,955,1779,10075,2966,15775
30-09-2019,09 - 10,1044,1923,10106,2972,16045
30-09-2019,10 - 11,1182,1832,10229,3054,16297
30-09-2019,11 - 12,1196,1786,10151,3035,16168
30-09-2019,12 - 13,1112,1933,10016,2932,15993
30-09-2019,13 - 14,1068,1860,9852,2848,15628
30-09-2019,14 - 15,1083,1740,9790,2824,15437
30-09-2019,15 - 16,1069,1700,9795,2773,15337
30-09-2019,16 - 17,1101,1853,9636,2828,15418
30-09-2019,17 - 18,1046,1949,9927,2909,15831
30-09-2019,18 - 19,1025,1884,10153,2865,15927
30-09-2019,19 - 20,1061,1862,10453,2962,16338
30-09-2019,20 - 21,1012,1752,10236,2850,15850
30-09-2019,21 - 22,971,1670,9672,2798,15111
30-09-2019,22 - 23,944,1650,9035,2622,14251
30-09-2019,23 - 00,841,1587,8447,2509,13384
01-10-2019,00 - 01,764,1535,8188,2337,12824
01-10-2019,01 - 02,791,1418,7874,2297,12380
01-10-2019,02 - 03,833,1325,7938,2242,12338
01-10-2019,03 - 04,819,1311,8000,2211,12341
01-10-2019,04 - 05,802,1408,8067,2257,12534
01-10-2019,05 - 06,895,1524,8610,2398,13427
01-10-2019,06 - 07,1016,1807,9754,2776,15353
01-10-2019,07 - 08,880,1970,10542,3031,16423
01-10-2019,08 - 09,836,1930,10753,3138,16657
01-10-2019,09 - 10,948,1790,10608,3175,16521
01-10-2019,10 - 11,951,1847,10585,3141,16524
01-10-2019,11 - 12,980,1838,10572,3086,16476
01-10-2019,12 - 13,950,1778,10263,3043,16034
01-10-2019,13 - 14,989,1630,9990,3039,15648
01-10-2019,14 - 15,1016,1566,9755,3039,15376
01-10-2019,15 - 16,979,1587,9760,2995,15321
01-10-2019,16 - 17,970,1610,9802,3006,15388
01-10-2019,17 - 18,985,1767,10053,3012,15817
01-10-2019,18 - 19,1037,1640,10244,3007,15928
01-10-2019,19 - 20,1016,1784,10361,3038,16199
01-10-2019,20 - 21,983,1749,9985,2812,15529
01-10-2019,21 - 22,920,1633,9608,2592,14753
01-10-2019,22 - 23,902,1586,8995,2452,13935
01-10-2019,23 - 00,898,1486,8369,2275,13028
02-10-2019,00 - 01,814,1484,8414,2186,12898
02-10-2019,01 - 02,859,1429,8335,2134,12757
02-10-2019,02 - 03,875,1397,8348,2101,12721
02-10-2019,03 - 04,831,1391,8301,2094,12617
02-10-2019,04 - 05,860,1402,8495,2104,12861
02-10-2019,05 - 06,954,1568,9062,2297,13881
02-10-2019,06 - 07,1055,1673,10399,2716,15843
02-10-2019,07 - 08,982,1716,11281,3013,16992
02-10-2019,08 - 09,917,1779,11554,3101,17351
02-10-2019,09 - 10,973,1835,11331,3140,17279
02-10-2019,10 - 11,975,1788,11285,3098,17146
02-10-2019,11 - 12,919,1918,10894,3050,16781
02-10-2019,12 - 13,958,1903,10871,2996,16728
02-10-2019,13 - 14,968,1776,10595,2894,16233
02-10-2019,14 - 15,1061,1848,10624,2855,16388
02-10-2019,15 - 16,1053,1904,10538,2800,16295
02-10-2019,16 - 17,979,1908,10620,2743,16250
02-10-2019,17 - 18,1064,1903,10841,2875,16683
02-10-2019,18 - 19,977,1932,11084,2895,16888
02-10-2019,19 - 20,1074,1905,11010,3025,17014
02-10-2019,20 - 21,959,1851,10634,2896,16340
02-10-2019,21 - 22,868,1836,10086,2717,15507
02-10-2019,22 - 23,936,1771,9342,2549,14598
02-10-2019,23 - 00,956,1784,8795,2289,13824
03-10-2019,00 - 01,917,1689,8540,2173,13319
03-10-2019,01 - 02,795,1645,8395,2152,12987
03-10-2019,02 - 03,880,1724,8266,2150,13020
03-10-2019,03 - 04,865,1800,8275,2154,13094
03-10-2019,04 - 05,890,1796,8423,2230,13339
03-10-2019,05 - 06,899,1810,8842,2389,13940
03-10-2019,06 - 07,1030,1958,10005,2739,15732
03-10-2019,07 - 08,1114,1961,10958,3124,17157
03-10-2019,08 - 09,1237,2041,11130,3267,17675
03-10-2019,09 - 10,1179,1969,11256,3270,17674
03-10-2019,10 - 11,1090,2171,11401,3227,17889
03-10-2019,11 - 12,993,2060,11270,3226,17549
03-10-2019,12 - 13,1138,1989,11157,3182,17466
03-10-2019,13 - 14,1069,1923,10919,3142,17053
03-10-2019,14 - 15,1103,1919,10822,3120,16964
03-10-2019,15 - 16,1127,2013,10900,3125,17165
03-10-2019,16 - 17,1063,1951,10912,3064,16990
03-10-2019,17 - 18,1144,2033,11053,3055,17285
03-10-2019,18 - 19,1166,2038,11395,3078,17677
03-10-2019,19 - 20,1119,1988,11492,3106,17705
03-10-2019,20 - 21,1128,1902,11156,2978,17164
03-10-2019,21 - 22,1104,1916,10619,2802,16441
03-10-2019,22 - 23,978,1876,9897,2658,15409
03-10-2019,23 - 00,1007,1684,9244,2472,14407
04-10-2019,00 - 01,1073,1760,8968,2322,14123
04-10-2019,01 - 02,1029,1799,8741,2263,13832
04-10-2019,02 - 03,1052,1755,8647,2259,13713
04-10-2019,03 - 04,989,1690,8704,2278,13661
04-10-2019,04 - 05,947,1681,8808,2343,13779
04-10-2019,05 - 06,1060,1807,9353,2481,14701
04-10-2019,06 - 07,1270,2209,10688,2890,17057
04-10-2019,07 - 08,1176,2236,11679,3202,18293
04-10-2019,08 - 09,1157,2137,11765,3284,18343
04-10-2019,09 - 10,1291,2147,11634,3305,18377
04-10-2019,10 - 11,1105,2162,11561,3298,18126
04-10-2019,11 - 12,1085,2084,11347,3231,17747
04-10-2019,12 - 13,1056,2048,11194,3057,17355
04-10-2019,13 - 14,1040,1913,10959,2974,16886
04-10-2019,14 - 15,1082,1940,10800,2947,16769
04-10-2019,15 - 16,1099,1930,10741,2865,16635
04-10-2019,16 - 17,1086,1925,10722,2806,16539
04-10-2019,17 - 18,1076,2025,11015,2876,16992
04-10-2019,18 - 19,1130,1979,11126,2972,17207
04-10-2019,19 - 20,1240,1981,11052,2970,17243
04-10-2019,20 - 21,1176,2001,10633,2787,16597
04-10-2019,21 - 22,1134,2012,10189,2626,15961
04-10-2019,22 - 23,1200,1941,9742,2486,15369
04-10-2019,23 - 00,989,1873,9452,2371,14685
05-10-2019,00 - 01,997,1924,9134,2352,14407
05-10-2019,01 - 02,981,1907,8998,2298,14184
05-10-2019,02 - 03,964,1983,8891,2227,14065
05-10-2019,03 - 04,986,1961,8855,2227,14029
05-10-2019,04 - 05,1038,1955,8874,2238,14105
05-10-2019,05 - 06,1040,1883,9070,2294,14287
05-10-2019,06 - 07,1051,1947,9431,2371,14800
05-10-2019,07 - 08,897,2015,9748,2451,15111
05-10-2019,08 - 09,928,2086,10188,2682,15884
05-10-2019,09 - 10,997,2173,10508,2855,16533
05-10-2019,10 - 11,1160,2033,10552,2861,16606
05-10-2019,11 - 12,1069,1994,10279,2767,16109
05-10-2019,12 - 13,1202,1928,10072,2721,15923
05-10-2019,13 - 14,1129,1921,9903,2650,15603
05-10-2019,14 - 15,936,1875,9762,2564,15137
05-10-2019,15 - 16,1037,1930,9755,2516,15238
05-10-2019,16 - 17,1079,1983,9879,2590,15531
05-10-2019,17 - 18,1048,2018,10210,2688,15964
05-10-2019,18 - 19,1040,2034,10644,2785,16503
05-10-2019,19 - 20,947,1961,10703,2815,16426
05-10-2019,20 - 21,1015,2010,10340,2724,16089
05-10-2019,21 - 22,1018,1986,10024,2607,15635
05-10-2019,22 - 23,949,1772,9672,2496,14889
05-10-2019,23 - 00,951,1830,9307,2348,14436
06-10-2019,00 - 01,846,1810,8944,2252,13852
06-10-2019,01 - 02,874,1825,8796,2206,13701
06-10-2019,02 - 03,950,1742,8815,2230,13737
06-10-2019,03 - 04,934,1756,8784,2239,13713
06-10-2019,04 - 05,907,1808,8818,2299,13832
06-10-2019,05 - 06,908,1790,8960,2386,14044
06-10-2019,06 - 07,962,1699,9173,2475,14309
06-10-2019,07 - 08,1009,1726,9439,2522,14696
06-10-2019,08 - 09,1125,1715,9809,2601,15250
06-10-2019,09 - 10,1044,1744,10130,2731,15649
06-10-2019,10 - 11,1065,1778,10257,2771,15871
06-10-2019,11 - 12,1005,1821,10202,2668,15696
06-10-2019,12 - 13,1008,1845,10046,2624,15523
06-10-2019,13 - 14,995,1870,9838,2602,15305
06-10-2019,14 - 15,1090,1881,9662,2581,15214
06-10-2019,15 - 16,1049,1806,9619,2577,15051
06-10-2019,16 - 17,1014,1774,9819,2615,15222
06-10-2019,17 - 18,964,1823,10253,2751,15791
06-10-2019,18 - 19,905,1719,10938,2855,16417
06-10-2019,19 - 20,935,1716,11228,2967,16846
06-10-2019,20 - 21,1008,1810,10897,2866,16581
06-10-2019,21 - 22,1059,1860,10523,2731,16173
06-10-2019,22 - 23,956,1801,10098,2620,15475
06-10-2019,23 - 00,917,1743,9605,2558,14823
07-10-2019,00 - 01,928,1711,9507,2513,14659
07-10-2019,01 - 02,907,1676,9365,2466,14414
07-10-2019,02 - 03,818,1691,9451,2472,14432
07-10-2019,03 - 04,894,1638,9467,2479,14478
07-10-2019,04 - 05,1069,1666,9735,2603,15073
07-10-2019,05 - 06,1028,1766,10306,2814,15914
07-10-2019,06 - 07,1071,1951,11685,3290,17997
07-10-2019,07 - 08,1141,1950,12606,3656,19353
07-10-2019,08 - 09,1085,1980,12562,3696,19323
07-10-2019,09 - 10,1099,2003,12193,3586,18881
07-10-2019,10 - 11,1117,2065,12023,3464,18669
07-10-2019,11 - 12,1061,2056,11733,3325,18175
07-10-2019,12 - 13,1027,2031,11432,3217,17707
07-10-2019,13 - 14,1038,2051,11166,3149,17404
07-10-2019,14 - 15,1036,1985,10955,3140,17116
07-10-2019,15 - 16,1147,2046,10917,3103,17213
07-10-2019,16 - 17,1175,2021,10967,3018,17181
07-10-2019,17 - 18,1062,2000,11322,3063,17447
07-10-2019,18 - 19,1121,2053,11684,3267,18125
07-10-2019,19 - 20,1079,2125,11782,3349,18335
07-10-2019,20 - 21,1042,2074,11545,3253,17914
07-10-2019,21 - 22,912,2116,11017,3100,17145
07-10-2019,22 - 23,891,2039,10313,2904,16147
07-10-2019,23 - 00,974,1827,9737,2773,15311
08-10-2019,00 - 01,892,1835,9392,2602,14721
08-10-2019,01 - 02,835,1777,9195,2534,14341
08-10-2019,02 - 03,905,1769,9098,2466,14238
08-10-2019,03 - 04,951,1822,9094,2442,14309
08-10-2019,04 - 05,1013,1821,9273,2484,14591
08-10-2019,05 - 06,1160,1845,9787,2662,15454
08-10-2019,06 - 07,1205,2005,11082,3036,17328
08-10-2019,07 - 08,1178,2128,12012,3080,18398
08-10-2019,08 - 09,1135,2254,12223,3377,18989
08-10-2019,09 - 10,1200,2191,12244,3420,19055
08-10-2019,10 - 11,1072,2174,12101,3446,18793
08-10-2019,11 - 12,953,2143,12035,3457,18588
08-10-2019,12 - 13,1033,2173,11835,3416,18457
08-10-2019,13 - 14,1217,2157,11685,3443,18502
08-10-2019,14 - 15,1155,2176,11609,3386,18326
08-10-2019,15 - 16,1130,2170,11592,3262,18154
08-10-2019,16 - 17,1155,2112,11625,3175,18067
08-10-2019,17 - 18,1179,2024,11736,3238,18177
08-10-2019,18 - 19,1115,1911,11922,3249,18197
08-10-2019,19 - 20,1109,2048,11751,3208,18116
08-10-2019,20 - 21,1049,2084,11403,3057,17593
08-10-2019,21 - 22,1054,2009,10862,2819,16744
08-10-2019,22 - 23,1046,1901,10104,2627,15678
08-10-2019,23 - 00,1023,1870,9549,2425,14867
09-10-2019,00 - 01,978,1860,8923,2352,14113
09-10-2019,01 - 02,968,1759,8747,2230,13704
09-10-2019,02 - 03,994,1768,8673,2181,13616
09-10-2019,03 - 04,942,1762,8617,2206,13527
09-10-2019,04 - 05,913,1703,8629,2266,13511
09-10-2019,05 - 06,994,1749,9178,2478,14399
09-10-2019,06 - 07,1065,1966,10444,2898,16373
09-10-2019,07 - 08,1104,2128,11306,3073,17611
09-10-2019,08 - 09,1089,2019,11429,3065,17602
09-10-2019,09 - 10,1109,2127,11429,3095,17760
09-10-2019,10 - 11,1087,2208,11458,3070,17823
09-10-2019,11 - 12,1131,2187,11341,3005,17664
09-10-2019,12 - 13,1126,2120,11171,2993,17410
09-10-2019,13 - 14,1118,2126,10989,2958,17191
09-10-2019,14 - 15,1071,2005,10895,3003,16974
09-10-2019,15 - 16,1230,1988,10891,2966,17075
09-10-2019,16 - 17,1096,2048,10810,2935,16889
09-10-2019,17 - 18,1132,2129,11205,2990,17456
09-10-2019,18 - 19,1196,2094,11373,3106,17769
09-10-2019,19 - 20,1141,1986,11149,3084,17360
09-10-2019,20 - 21,1140,2026,10777,2986,16929
09-10-2019,21 - 22,979,1932,10243,2841,15995
09-10-2019,22 - 23,1047,1861,9447,2667,15022
09-10-2019,23 - 00,1135,1708,8856,2434,14133
10-10-2019,00 - 01,1010,1645,8441,2250,13346
10-10-2019,01 - 02,1002,1657,8216,2207,13082
10-10-2019,02 - 03,1030,1659,8108,2178,12975
10-10-2019,03 - 04,1004,1683,8063,2145,12895
10-10-2019,04 - 05,1018,1663,8214,2177,13072
10-10-2019,05 - 06,1054,1780,8754,2367,13955
10-10-2019,06 - 07,1093,1930,9886,2706,15615
10-10-2019,07 - 08,1082,2105,10796,3019,17002
10-10-2019,08 - 09,1190,2015,10963,3108,17276
10-10-2019,09 - 10,1218,2014,10957,3127,17316
10-10-2019,10 - 11,1098,2024,10910,3133,17165
10-10-2019,11 - 12,1138,2024,10760,3145,17067
10-10-2019,12 - 13,1168,2080,10683,3050,16981
10-10-2019,13 - 14,1130,2008,10495,2952,16585
10-10-2019,14 - 15,1125,2058,10341,2878,16402
10-10-2019,15 - 16,1027,1937,10252,2844,16060
10-10-2019,16 - 17,1054,1904,10342,2818,16118
10-10-2019,17 - 18,1077,1953,10649,2897,16576
10-10-2019,18 - 19,1102,2071,10974,2925,17072
10-10-2019,19 - 20,1048,2138,10753,2943,16882
10-10-2019,20 - 21,1083,1968,10203,2818,16072
10-10-2019,21 - 22,1114,1791,9529,2653,15087
10-10-2019,22 - 23,1060,1602,8868,2450,13980
10-10-2019,23 - 00,922,1574,8301,2243,13040
11-10-2019,00 - 01,881,1607,8142,2175,12805
11-10-2019,01 - 02,982,1638,7983,2128,12731
11-10-2019,02 - 03,1020,1674,7936,2140,12770
11-10-2019,03 - 04,1038,1681,7968,2150,12837
11-10-2019,04 - 05,1040,1720,8045,2134,12939
11-10-2019,05 - 06,993,1766,8407,2258,13424
11-10-2019,06 - 07,1101,1866,9500,2648,15115
11-10-2019,07 - 08,1124,2068,10483,2950,16625
11-10-2019,08 - 09,1140,2100,10666,2998,16904
11-10-2019,09 - 10,1179,2084,10631,3088,16982
11-10-2019,10 - 11,1191,2019,10648,3156,17014
11-10-2019,11 - 12,1144,2069,10532,3186,16931
11-10-2019,12 - 13,1167,1958,10313,3075,16513
11-10-2019,13 - 14,1162,1813,10047,3105,16127
11-10-2019,14 - 15,1084,1884,9982,3039,15989
11-10-2019,15 - 16,1107,1881,9928,3020,15936
11-10-2019,16 - 17,1140,1941,9990,2935,16006
11-10-2019,17 - 18,1205,1956,10145,2822,16128
11-10-2019,18 - 19,1262,1870,10134,2861,16127
11-10-2019,19 - 20,1226,1905,9926,2893,15950
11-10-2019,20 - 21,1160,1807,9460,2785,15212
11-10-2019,21 - 22,1154,1756,8958,2706,14574
11-10-2019,22 - 23,1020,1728,8382,2783,13913
11-10-2019,23 - 00,1061,1756,7939,2552,13308
12-10-2019,00 - 01,983,1792,7843,2286,12904
12-10-2019,01 - 02,1053,1736,7834,2003,12626
12-10-2019,02 - 03,1024,1720,7597,1970,12311
12-10-2019,03 - 04,1024,1735,7367,2004,12130
12-10-2019,04 - 05,1055,1732,7406,2031,12224
12-10-2019,05 - 06,1039,1713,7601,2039,12392
12-10-2019,06 - 07,1107,1799,7881,2093,12880
12-10-2019,07 - 08,1135,1848,8175,2169,13327
12-10-2019,08 - 09,1150,1865,8492,2290,13797
12-10-2019,09 - 10,1130,1893,8951,2425,14399
12-10-2019,10 - 11,1164,1907,9151,2495,14717
12-10-2019,11 - 12,1136,1931,9168,2510,14745
12-10-2019,12 - 13,1126,1879,9068,2427,14500
12-10-2019,13 - 14,1191,1844,9041,2422,14498
12-10-2019,14 - 15,1101,1802,8931,2421,14255
12-10-2019,15 - 16,1158,1860,8936,2412,14366
12-10-2019,16 - 17,1169,1827,9049,2423,14468
12-10-2019,17 - 18,1224,1816,9272,2450,14762
12-10-2019,18 - 19,1180,2012,9593,2529,15314
12-10-2019,19 - 20,1202,1942,9457,2494,15095
12-10-2019,20 - 21,1179,1926,9067,2446,14618
12-10-2019,21 - 22,1125,1869,8687,2327,14008
12-10-2019,22 - 23,1187,1878,8330,2195,13590
12-10-2019,23 - 00,1035,1739,8022,2029,12825
13-10-2019,00 - 01,1053,1714,7807,2060,12634
13-10-2019,01 - 02,1068,1646,7598,1974,12286
13-10-2019,02 - 03,1013,1603,7423,1925,11964
13-10-2019,03 - 04,1017,1558,7339,1944,11858
13-10-2019,04 - 05,1056,1605,7403,1915,11979
13-10-2019,05 - 06,1099,1595,7457,1979,12130
13-10-2019,06 - 07,1114,1795,7655,2055,12619
13-10-2019,07 - 08,1106,1740,7968,2170,12984
13-10-2019,08 - 09,1118,1759,8416,2243,13536
13-10-2019,09 - 10,1203,1766,8741,2400,14110
13-10-2019,10 - 11,1114,1872,9005,2519,14510
13-10-2019,11 - 12,1110,1878,8987,2573,14548
13-10-2019,12 - 13,1133,1873,8858,2555,14419
13-10-2019,13 - 14,1152,1775,8849,2499,14275
13-10-2019,14 - 15,1127,1692,8801,2537,14157
13-10-2019,15 - 16,1108,1805,8805,2552,14270
13-10-2019,16 - 17,1077,1805,9056,2612,14550
13-10-2019,17 - 18,1076,1861,9486,2718,15141
13-10-2019,18 - 19,1215,1963,10052,2748,15978
13-10-2019,19 - 20,1290,2003,9991,2649,15933
13-10-2019,20 - 21,1261,1976,9601,2472,15310
13-10-2019,21 - 22,1226,1914,9153,2373,14666
13-10-2019,22 - 23,1126,1850,8637,2308,13921
13-10-2019,23 - 00,1042,1873,8167,2148,13230
14-10-2019,00 - 01,1137,1740,8035,2168,13080
14-10-2019,01 - 02,1046,1761,7829,2147,12783
14-10-2019,02 - 03,1026,1715,7695,2170,12606
14-10-2019,03 - 04,1076,1737,7723,2021,12557
14-10-2019,04 - 05,1027,1760,7920,2022,12729
14-10-2019,05 - 06,1071,1819,8401,2253,13544
14-10-2019,06 - 07,1255,2084,9489,2684,15512
14-10-2019,07 - 08,1225,2240,10563,3005,17033
14-10-2019,08 - 09,1271,2193,10875,3079,17418
14-10-2019,09 - 10,1258,2210,10993,3037,17498
14-10-2019,10 - 11,1353,2228,11016,3029,17626
14-10-2019,11 - 12,1407,2217,11014,3013,17651
14-10-2019,12 - 13,1505,2186,11011,2940,17642
14-10-2019,13 - 14,1182,2069,10931,2920,17102
14-10-2019,14 - 15,1254,2063,10861,2958,17136
14-10-2019,15 - 16,1336,2054,10764,2943,17097
14-10-2019,16 - 17,1361,2081,10694,2963,17099
14-10-2019,17 - 18,1338,2073,10894,2954,17259
14-10-2019,18 - 19,1346,2079,11189,3051,17665
14-10-2019,19 - 20,1410,2113,10953,3045,17521
14-10-2019,20 - 21,1340,1995,10636,2906,16877
14-10-2019,21 - 22,1393,1985,10045,2740,16163
14-10-2019,22 - 23,1328,1880,9239,2545,14992
14-10-2019,23 - 00,1267,1792,8674,2305,14038
15-10-2019,00 - 01,1196,1664,8252,2194,13306
15-10-2019,01 - 02,1180,1734,8117,2184,13215
15-10-2019,02 - 03,1119,1673,8015,2096,12903
15-10-2019,03 - 04,1109,1765,8131,2071,13076
15-10-2019,04 - 05,1043,1831,8069,2172,13115
15-10-2019,05 - 06,1162,1882,8492,2215,13751
15-10-2019,06 - 07,1327,2189,9722,2664,15902
15-10-2019,07 - 08,1429,2301,10625,3026,17381
15-10-2019,08 - 09,1457,2254,10795,3003,17509
15-10-2019,09 - 10,1421,2200,10872,2951,17444
15-10-2019,10 - 11,1286,2148,10828,3006,17268
15-10-2019,11 - 12,1309,2087,10844,2993,17233
15-10-2019,12 - 13,1257,2058,10802,2907,17024
15-10-2019,13 - 14,1310,2129,10837,3014,17290
15-10-2019,14 - 15,1415,2146,10731,2973,17265
15-10-2019,15 - 16,1432,2246,10630,2960,17268
15-10-2019,16 - 17,1340,2288,10670,2889,17187
15-10-2019,17 - 18,1299,2172,10988,2891,17350
15-10-2019,18 - 19,1261,2248,11023,2991,17523
15-10-2019,19 - 20,1235,2197,10724,2972,17128
15-10-2019,20 - 21,1292,2145,10195,2825,16457
15-10-2019,21 - 22,1308,2066,9594,2721,15689
15-10-2019,22 - 23,1240,1958,8862,2494,14554
15-10-2019,23 - 00,1109,1838,8471,2275,13693
16-10-2019,00 - 01,1164,1790,8087,2178,13219
16-10-2019,01 - 02,1159,1797,7867,2084,12907
16-10-2019,02 - 03,1116,1797,7772,2064,12749
16-10-2019,03 - 04,1087,1809,7760,2075,12731
16-10-2019,04 - 05,1110,1836,7925,2085,12956
16-10-2019,05 - 06,1176,1848,8420,2248,13692
16-10-2019,06 - 07,1246,2002,9695,2629,15572
16-10-2019,07 - 08,1283,2155,10665,2956,17059
16-10-2019,08 - 09,1390,2194,10785,2980,17349
16-10-2019,09 - 10,1362,2275,10729,2991,17357
16-10-2019,10 - 11,1321,2242,10858,3036,17457
16-10-2019,11 - 12,1306,2198,10840,3064,17408
16-10-2019,12 - 13,1331,2232,10834,3131,17528
16-10-2019,13 - 14,1355,2162,10727,3124,17368
16-10-2019,14 - 15,1119,2132,10666,2836,16753
16-10-2019,15 - 16,1236,2049,10836,2762,16883
16-10-2019,16 - 17,1232,2069,10840,3011,17152
16-10-2019,17 - 18,1265,2185,11066,3081,17597
16-10-2019,18 - 19,1322,2158,11198,3113,17791
16-10-2019,19 - 20,1259,2266,10826,3038,17389
16-10-2019,20 - 21,1224,2114,10446,2886,16670
16-10-2019,21 - 22,1194,1995,9930,2697,15816
16-10-2019,22 - 23,1100,1922,9086,2477,14585
16-10-2019,23 - 00,1091,1852,8114,2254,13311
17-10-2019,00 - 01,1168,1796,7792,2091,12847
17-10-2019,01 - 02,1246,1820,7601,2025,12692
17-10-2019,02 - 03,1050,1938,7801,1980,12769
17-10-2019,03 - 04,1168,1841,7917,1980,12906
17-10-2019,04 - 05,1205,1842,7967,2048,13062
17-10-2019,05 - 06,1230,1875,8454,2237,13796
17-10-2019,06 - 07,1435,1897,9716,2669,15717
17-10-2019,07 - 08,1357,2073,10817,2989,17236
17-10-2019,08 - 09,1338,2098,10763,3035,17234
17-10-2019,09 - 10,1224,2173,10900,3012,17309
17-10-2019,10 - 11,1276,2243,11040,3040,17599
17-10-2019,11 - 12,1269,2203,11146,3029,17647
17-10-2019,12 - 13,1235,2139,11145,3001,17520
17-10-2019,13 - 14,1248,2153,10953,3062,17416
17-10-2019,14 - 15,1208,2067,10938,3036,17249
17-10-2019,15 - 16,1224,2092,10908,3129,17353
17-10-2019,16 - 17,1266,2187,10776,2953,17182
17-10-2019,17 - 18,1192,2197,11098,2905,17392
17-10-2019,18 - 19,1241,2264,10973,2954,17432
17-10-2019,19 - 20,1290,2180,10759,2989,17218
17-10-2019,20 - 21,1271,2102,10265,2800,16438
17-10-2019,21 - 22,1229,2060,9704,2622,15615
17-10-2019,22 - 23,1232,1885,8978,2421,14516
17-10-2019,23 - 00,1191,1750,8309,2223,13473
18-10-2019,00 - 01,1205,1808,7686,2153,12852
18-10-2019,01 - 02,1111,1782,7238,2097,12228
18-10-2019,02 - 03,1041,1764,7067,2062,11934
18-10-2019,03 - 04,991,1748,7132,2070,11941
18-10-2019,04 - 05,1162,1768,7497,2123,12550
18-10-2019,05 - 06,1075,1704,8139,2270,13188
18-10-2019,06 - 07,1207,1989,9537,2628,15361
18-10-2019,07 - 08,1289,2023,10396,2895,16603
18-10-2019,08 - 09,1315,2008,10601,2938,16862
18-10-2019,09 - 10,1230,1980,10738,2904,16852
18-10-2019,10 - 11,1301,1888,10798,3003,16990
18-10-2019,11 - 12,1253,1860,10718,2869,16700
18-10-2019,12 - 13,1278,1876,10548,2851,16553
18-10-2019,13 - 14,1295,1939,10230,2865,16329
18-10-2019,14 - 15,1253,1913,10070,2810,16046
18-10-2019,15 - 16,1244,1908,9914,2719,15785
18-10-2019,16 - 17,1299,1882,9874,2648,15703
18-10-2019,17 - 18,1302,2046,10143,2724,16215
18-10-2019,18 - 19,1231,1950,10357,2788,16326
18-10-2019,19 - 20,1171,1954,9990,2672,15787
18-10-2019,20 - 21,1185,1829,9460,2438,14912
18-10-2019,21 - 22,1127,1786,8950,2277,14140
18-10-2019,22 - 23,1054,1582,8435,2244,13315
18-10-2019,23 - 00,1048,1699,7956,2112,12815
19-10-2019,00 - 01,1145,1657,7624,2031,12457
19-10-2019,01 - 02,1154,1642,7425,1931,12152
19-10-2019,02 - 03,1106,1594,7420,1851,11971
19-10-2019,03 - 04,1106,1597,7400,1850,11953
19-10-2019,04 - 05,1062,1587,7266,1899,11814
19-10-2019,05 - 06,1091,1554,7391,1914,11950
19-10-2019,06 - 07,1105,1666,7591,2007,12369
19-10-2019,07 - 08,1121,1725,7906,2176,12928
19-10-2019,08 - 09,1176,1846,8229,2290,13541
19-10-2019,09 - 10,1232,1867,8594,2441,14134
19-10-2019,10 - 11,1237,1816,8893,2538,14484
19-10-2019,11 - 12,1201,1896,8958,2592,14647
19-10-2019,12 - 13,1206,1881,8932,2624,14643
19-10-2019,13 - 14,1059,1905,8955,2423,14342
19-10-2019,14 - 15,965,1962,8865,2261,14053
19-10-2019,15 - 16,894,1834,8850,2261,13839
19-10-2019,16 - 17,1084,1889,9057,2391,14421
19-10-2019,17 - 18,1185,2034,9391,2565,15175
19-10-2019,18 - 19,1151,1767,9448,2687,15053
19-10-2019,19 - 20,1124,1747,9114,2571,14556
19-10-2019,20 - 21,1140,1820,9002,2475,14437
19-10-2019,21 - 22,1158,1667,8380,2379,13584
19-10-2019,22 - 23,1094,1639,7844,2232,12809
19-10-2019,23 - 00,1005,1653,7746,2123,12527
20-10-2019,00 - 01,952,1768,7799,1975,12494
20-10-2019,01 - 02,949,1643,7496,1852,11940
20-10-2019,02 - 03,969,1753,7379,1832,11933
20-10-2019,03 - 04,1013,1766,7398,1861,12038
20-10-2019,04 - 05,1098,1641,7398,1873,12010
20-10-2019,05 - 06,1121,1589,7420,1933,12063
20-10-2019,06 - 07,1136,1745,7701,2025,12607
20-10-2019,07 - 08,1163,1721,8060,2143,13087
20-10-2019,08 - 09,1092,1750,8343,2233,13418
20-10-2019,09 - 10,1154,1820,8883,2368,14225
20-10-2019,10 - 11,1105,1989,9226,2434,14754
20-10-2019,11 - 12,1118,2047,9392,2480,15037
20-10-2019,12 - 13,1184,2026,9511,2497,15218
20-10-2019,13 - 14,1217,1955,9364,2388,14924
20-10-2019,14 - 15,1126,1938,9196,2334,14594
20-10-2019,15 - 16,1154,1969,9226,2344,14693
20-10-2019,16 - 17,1187,2011,9362,2400,14960
20-10-2019,17 - 18,1269,2047,9720,2557,15593
20-10-2019,18 - 19,1315,2141,10023,2684,16163
20-10-2019,19 - 20,1339,2167,9903,2640,16049
20-10-2019,20 - 21,1296,2013,9561,2507,15377
20-10-2019,21 - 22,1263,1956,9125,2380,14724
20-10-2019,22 - 23,1177,1938,8653,2258,14026
20-10-2019,23 - 00,1225,1767,8268,2066,13326
21-10-2019,00 - 01,1095,1746,8083,2006,12930
21-10-2019,01 - 02,1032,1764,7888,1936,12620
21-10-2019,02 - 03,1030,1723,7777,1976,12506
21-10-2019,03 - 04,993,1712,7859,1997,12561
21-10-2019,04 - 05,1045,1728,8058,2032,12863
21-10-2019,05 - 06,1170,1802,8570,2222,13764
21-10-2019,06 - 07,1419,2080,9952,2654,16105
21-10-2019,07 - 08,1519,2327,11053,3005,17904
21-10-2019,08 - 09,1281,2347,11265,3094,17987
21-10-2019,09 - 10,1265,2379,11085,3088,17817
21-10-2019,10 - 11,1202,2234,11297,3102,17835
21-10-2019,11 - 12,1197,2133,11249,3117,17696
21-10-2019,12 - 13,1135,2035,11203,3044,17417
21-10-2019,13 - 14,1180,2164,11141,3078,17563
21-10-2019,14 - 15,1208,2098,11081,3023,17410
21-10-2019,15 - 16,1162,2052,11154,3087,17455
21-10-2019,16 - 17,1157,2105,11060,3016,17338
21-10-2019,17 - 18,1189,2243,11488,3045,17965
21-10-2019,18 - 19,1194,2267,11619,3121,18201
21-10-2019,19 - 20,1115,2200,11389,3013,17717
21-10-2019,20 - 21,1141,2143,10827,2865,16976
21-10-2019,21 - 22,1227,1989,10220,2677,16113
21-10-2019,22 - 23,1177,1795,9518,2526,15016
21-10-2019,23 - 00,1072,1764,8764,2329,13929
22-10-2019,00 - 01,943,1699,8300,2143,13085
22-10-2019,01 - 02,789,1694,8080,2130,12693
22-10-2019,02 - 03,853,1662,7955,2139,12609
22-10-2019,03 - 04,1025,1640,7914,2144,12723
22-10-2019,04 - 05,1148,1608,7979,2185,12920
22-10-2019,05 - 06,1156,1619,8445,2363,13583
22-10-2019,06 - 07,1221,1864,9596,2718,15399
22-10-2019,07 - 08,1249,2151,10604,3018,17022
22-10-2019,08 - 09,1278,2110,10660,3075,17123
22-10-2019,09 - 10,1311,1962,10526,3040,16839
22-10-2019,10 - 11,1094,1954,10572,3030,16650
22-10-2019,11 - 12,1107,1996,10587,2901,16591
22-10-2019,12 - 13,1112,1910,10446,2944,16412
22-10-2019,13 - 14,1153,1871,10327,2958,16309
22-10-2019,14 - 15,1278,1756,10218,2884,16136
22-10-2019,15 - 16,1181,1884,10154,2846,16065
22-10-2019,16 - 17,1186,2034,10225,2864,16309
22-10-2019,17 - 18,1170,2103,10664,2978,16915
22-10-2019,18 - 19,1094,1984,10905,3050,17033
22-10-2019,19 - 20,1099,1995,10641,2953,16688
22-10-2019,20 - 21,1068,1878,10208,2764,15918
22-10-2019,21 - 22,1082,1792,9603,2575,15052
22-10-2019,22 - 23,1081,1788,9021,2407,14297
22-10-2019,23 - 00,994,1719,8476,2167,13356
23-10-2019,00 - 01,966,1718,8195,2139,13018
23-10-2019,01 - 02,1020,1710,8066,2041,12837
23-10-2019,02 - 03,948,1703,7964,2007,12622
23-10-2019,03 - 04,1053,1754,7956,2030,12793
23-10-2019,04 - 05,1011,1729,8140,2058,12938
23-10-2019,05 - 06,1203,1920,8575,2264,13962
23-10-2019,06 - 07,1174,2267,9776,2689,15906
23-10-2019,07 - 08,1102,2416,10792,3112,17422
23-10-2019,08 - 09,1126,2258,10815,3143,17342
23-10-2019,09 - 10,1287,2208,10740,3135,17370
23-10-2019,10 - 11,1334,2097,10780,3193,17404
23-10-2019,11 - 12,1326,1926,10678,3153,17083
23-10-2019,12 - 13,1294,1873,10553,3068,16788
23-10-2019,13 - 14,1063,2011,10549,3032,16655
23-10-2019,14 - 15,1079,2022,10446,3050,16597
23-10-2019,15 - 16,1149,2036,10610,3024,16819
23-10-2019,16 - 17,1180,2054,10714,3004,16952
23-10-2019,17 - 18,1271,2083,11002,3040,17396
23-10-2019,18 - 19,1230,2000,11130,3049,17409
23-10-2019,19 - 20,1241,1938,10664,2944,16787
23-10-2019,20 - 21,1134,1931,10204,2824,16093
23-10-2019,21 - 22,1126,1785,9697,2640,15248
23-10-2019,22 - 23,1179,1854,9043,2485,14561
23-10-2019,23 - 00,1132,1849,8533,2367,13881
24-10-2019,00 - 01,1087,1825,8188,2252,13352
24-10-2019,01 - 02,995,1749,7937,2171,12852
24-10-2019,02 - 03,1036,1666,7784,2131,12617
24-10-2019,03 - 04,1039,1679,7794,2111,12623
24-10-2019,04 - 05,1046,1768,7879,2188,12881
24-10-2019,05 - 06,1095,1881,8454,2427,13857
24-10-2019,06 - 07,1027,2072,9817,2835,15751
24-10-2019,07 - 08,1144,2049,10793,3052,17038
24-10-2019,08 - 09,1187,2026,10910,3097,17220
24-10-2019,09 - 10,1185,1924,10917,3039,17065
24-10-2019,10 - 11,1100,2028,10934,3045,17107
24-10-2019,11 - 12,1158,1927,10840,3086,17011
24-10-2019,12 - 13,1110,1953,10761,3032,16856
24-10-2019,13 - 14,1082,1904,10664,3034,16684
24-10-2019,14 - 15,1137,1845,10547,2937,16466
24-10-2019,15 - 16,1180,2013,10349,3012,16554
24-10-2019,16 - 17,1276,2195,10075,2966,16512
24-10-2019,17 - 18,1310,2298,10307,3031,16946
24-10-2019,18 - 19,1262,2016,10590,3178,17046
24-10-2019,19 - 20,1215,2038,10362,3136,16751
24-10-2019,20 - 21,1241,1896,9972,2941,16050
24-10-2019,21 - 22,1160,1860,9248,2713,14981
24-10-2019,22 - 23,1060,1762,8621,2484,13927
24-10-2019,23 - 00,870,1663,8199,2221,12953
25-10-2019,00 - 01,862,1751,7918,2115,12646
25-10-2019,01 - 02,990,1655,7667,2045,12357
25-10-2019,02 - 03,913,1730,7490,2082,12215
25-10-2019,03 - 04,905,1709,7443,2130,12187
25-10-2019,04 - 05,984,1700,7509,2130,12323
25-10-2019,05 - 06,899,1737,7880,2270,12786
25-10-2019,06 - 07,1127,1975,8930,2625,14657
25-10-2019,07 - 08,1275,2202,10101,3098,16676
25-10-2019,08 - 09,1244,2134,10279,3244,16901
25-10-2019,09 - 10,1107,2168,10325,3047,16647
25-10-2019,10 - 11,1190,1984,10426,3104,16704
25-10-2019,11 - 12,1161,1600,10403,3009,16173
25-10-2019,12 - 13,1213,1780,10244,2901,16138
25-10-2019,13 - 14,1107,1790,10101,2786,15784
25-10-2019,14 - 15,1156,1722,9985,2686,15549
25-10-2019,15 - 16,1237,1719,9883,2692,15531
25-10-2019,16 - 17,1167,1659,9933,2790,15549
25-10-2019,17 - 18,1163,1671,10311,2928,16073
25-10-2019,18 - 19,1094,1807,10412,3012,16325
25-10-2019,19 - 20,1032,1717,10210,2908,15867
25-10-2019,20 - 21,976,1638,9760,2784,15158
25-10-2019,21 - 22,887,1633,9235,2638,14393
25-10-2019,22 - 23,1029,1604,8811,2478,13922
25-10-2019,23 - 00,985,1566,8447,2367,13365
26-10-2019,00 - 01,994,1652,8356,2196,13198
26-10-2019,01 - 02,1041,1584,8140,2089,12854
26-10-2019,02 - 03,1080,1549,8057,1980,12666
26-10-2019,03 - 04,1016,1516,7914,1968,12414
26-10-2019,04 - 05,992,1523,7803,1997,12315
26-10-2019,05 - 06,1033,1664,7778,2045,12520
26-10-2019,06 - 07,1057,1780,8218,2150,13205
26-10-2019,07 - 08,1088,1787,8672,2304,13851
26-10-2019,08 - 09,1022,1815,9110,2411,14358
26-10-2019,09 - 10,1167,1893,9713,2555,15328
26-10-2019,10 - 11,1179,1777,10056,2610,15622
26-10-2019,11 - 12,1200,1891,10268,2633,15992
26-10-2019,12 - 13,1280,1882,10212,2593,15967
26-10-2019,13 - 14,1261,1735,10145,2605,15746
26-10-2019,14 - 15,1208,1646,10032,2636,15522
26-10-2019,15 - 16,1281,1711,10028,2646,15666
26-10-2019,16 - 17,1212,1890,10166,2627,15895
26-10-2019,17 - 18,1143,1882,10554,2701,16280
26-10-2019,18 - 19,1151,1713,10589,2787,16240
26-10-2019,19 - 20,1182,1746,10252,2661,15841
26-10-2019,20 - 21,1193,1715,9929,2469,15306
26-10-2019,21 - 22,1261,1734,9522,2355,14872
26-10-2019,22 - 23,1133,1687,9003,2310,14133
26-10-2019,23 - 00,1157,1564,8674,2125,13520
27-10-2019,00 - 01,1090,1649,8483,1918,13140
27-10-2019,01 - 02,1134,1660,8349,1870,13013
27-10-2019,02 - 03,1043,1648,8301,1887,12879
27-10-2019,02 - 03,1084,1713,8337,1795,12929
27-10-2019,03 - 04,1065,1738,8335,1770,12908
27-10-2019,04 - 05,1146,1829,8390,1775,13140
27-10-2019,05 - 06,1180,1845,8537,1829,13391
27-10-2019,06 - 07,1141,1896,8727,1944,13708
27-10-2019,07 - 08,1176,1978,8949,2022,14125
27-10-2019,08 - 09,1171,1944,9431,2201,14747
27-10-2019,09 - 10,1326,1968,9816,2346,15456
27-10-2019,10 - 11,1172,1919,10065,2411,15567
27-10-2019,11 - 12,1187,1918,10091,2444,15640
27-10-2019,12 - 13,1177,1762,10033,2476,15448
27-10-2019,13 - 14,1227,1778,9970,2516,15491
27-10-2019,14 - 15,1262,1844,9963,2699,15768
27-10-2019,15 - 16,1316,1956,10139,2688,16099
27-10-2019,16 - 17,1330,2001,10683,2784,16798
27-10-2019,17 - 18,1348,1975,11186,2963,17472
27-10-2019,18 - 19,1302,1976,11058,2880,17216
27-10-2019,19 - 20,1282,1966,10789,2777,16814
27-10-2019,20 - 21,1237,1880,10463,2653,16233
27-10-2019,21 - 22,1318,1653,10119,2559,15649
27-10-2019,22 - 23,1199,1623,9640,2423,14885
27-10-2019,23 - 00,1143,1640,9236,2285,14304
28-10-2019,00 - 01,1161,1577,9056,2121,13915
28-10-2019,01 - 02,1184,1604,8926,2074,13788
28-10-2019,02 - 03,1209,1534,8893,2095,13731
28-10-2019,03 - 04,1162,1539,8989,2216,13906
28-10-2019,04 - 05,1219,1582,9088,2272,14161
28-10-2019,05 - 06,1254,1732,9556,2408,14950
28-10-2019,06 - 07,1351,1854,10903,2793,16901
28-10-2019,07 - 08,1334,1900,11803,3090,18127
28-10-2019,08 - 09,1390,1995,12054,3254,18693
28-10-2019,09 - 10,1348,1999,11898,3232,18477
28-10-2019,10 - 11,1328,2000,11853,3202,18383
28-10-2019,11 - 12,1232,1930,11681,3126,17969
28-10-2019,12 - 13,1164,1912,11601,3045,17722
28-10-2019,13 - 14,1177,1942,11536,3058,17713
28-10-2019,14 - 15,1207,1910,11600,3036,17753
28-10-2019,15 - 16,1406,1955,11721,3053,18135
28-10-2019,16 - 17,1321,2114,12119,3108,18662
28-10-2019,17 - 18,1242,1976,12526,3303,19047
28-10-2019,18 - 19,1339,2013,12441,3230,19023
28-10-2019,19 - 20,1213,2004,12116,3136,18469
28-10-2019,20 - 21,1233,1874,11703,2987,17797
28-10-2019,21 - 22,1316,1811,11178,2836,17141
28-10-2019,22 - 23,1386,1782,10614,2696,16478
28-10-2019,23 - 00,1134,1831,10074,2539,15578
29-10-2019,00 - 01,1138,1796,9738,2485,15157
29-10-2019,01 - 02,1254,1698,9450,2513,14915
29-10-2019,02 - 03,1294,1574,9325,2488,14681
29-10-2019,03 - 04,1251,1593,9501,2508,14853
29-10-2019,04 - 05,1143,1595,9617,2603,14958
29-10-2019,05 - 06,1264,1791,10135,2799,15989
29-10-2019,06 - 07,1453,1941,11395,3183,17972
29-10-2019,07 - 08,1283,1978,12187,3409,18857
29-10-2019,08 - 09,1223,1880,12402,3482,18987
29-10-2019,09 - 10,1281,1890,12135,3460,18766
29-10-2019,10 - 11,1320,2004,12042,3376,18742
29-10-2019,11 - 12,1214,1989,11832,3295,18330
29-10-2019,12 - 13,1179,1904,11529,3206,17818
29-10-2019,13 - 14,1262,2030,11402,3187,17881
29-10-2019,14 - 15,1219,2197,11296,3145,17857
29-10-2019,15 - 16,1262,2232,11423,3223,18140
29-10-2019,16 - 17,1294,2165,11803,3316,18578
29-10-2019,17 - 18,1411,2195,12277,3485,19368
29-10-2019,18 - 19,1464,2130,12076,3381,19051
29-10-2019,19 - 20,1348,2297,11833,3288,18766
29-10-2019,20 - 21,1301,2299,11635,3173,18408
29-10-2019,21 - 22,1318,2244,11220,3003,17785
29-10-2019,22 - 23,1300,2080,10695,2871,16946
29-10-2019,23 - 00,1316,2060,10210,2727,16313
30-10-2019,00 - 01,1338,1855,9929,2638,15760
30-10-2019,01 - 02,1312,1896,9809,2623,15640
30-10-2019,02 - 03,1272,1858,9768,2642,15540
30-10-2019,03 - 04,1261,1894,9888,2754,15797
30-10-2019,04 - 05,1262,1971,10088,2876,16197
30-10-2019,05 - 06,1309,2029,10592,3080,17010
30-10-2019,06 - 07,1468,2153,11704,3487,18812
30-10-2019,07 - 08,1365,2254,12481,3774,19874
30-10-2019,08 - 09,1397,2281,12721,3821,20220
30-10-2019,09 - 10,1342,2172,12480,3672,19666
30-10-2019,10 - 11,1352,2202,12367,3558,19479
30-10-2019,11 - 12,1362,2211,12047,3478,19098
30-10-2019,12 - 13,1169,2067,11901,3375,18512
30-10-2019,13 - 14,932,2099,11800,3387,18218
30-10-2019,14 - 15,1072,2051,11802,3390,18315
30-10-2019,15 - 16,1160,2186,11886,3415,18647
30-10-2019,16 - 17,1233,2293,12270,3449,19245
30-10-2019,17 - 18,1213,2387,12686,3571,19857
30-10-2019,18 - 19,1154,2342,12385,3420,19301
30-10-2019,19 - 20,1189,2174,12123,3255,18741
30-10-2019,20 - 21,1394,1861,11771,3105,18131
30-10-2019,21 - 22,1354,1852,11203,2952,17361
30-10-2019,22 - 23,1178,1684,10544,2728,16134
30-10-2019,23 - 00,1096,1895,9987,2517,15495
31-10-2019,00 - 01,1054,1797,9654,2467,14972
31-10-2019,01 - 02,1062,1647,9386,2412,14507
31-10-2019,02 - 03,1078,1787,9289,2379,14533
31-10-2019,03 - 04,1086,1731,9318,2412,14547
31-10-2019,04 - 05,1087,1745,9479,2447,14758
31-10-2019,05 - 06,982,1815,9996,2534,15327
31-10-2019,06 - 07,1341,1964,11127,2930,17362
31-10-2019,07 - 08,1331,2062,11925,3235,18553
31-10-2019,08 - 09,1273,2093,12095,3337,18798
31-10-2019,09 - 10,1347,2193,12031,3341,18912
31-10-2019,10 - 11,1436,2183,11945,3356,18920
31-10-2019,11 - 12,1354,2090,11615,3339,18398
31-10-2019,12 - 13,1307,1867,11335,3229,17738
31-10-2019,13 - 14,1297,1768,11173,3184,17422
31-10-2019,14 - 15,1396,1947,11270,3192,17805
31-10-2019,15 - 16,1390,2137,11500,3204,18231
31-10-2019,16 - 17,1476,2189,11697,3271,18633
31-10-2019,17 - 18,1450,2087,12030,3378,18945
31-10-2019,18 - 19,1428,1915,11828,3223,18394
31-10-2019,19 - 20,1239,1848,11688,3091,17866
31-10-2019,20 - 21,1057,1788,11342,3010,17197
31-10-2019,21 - 22,1204,1831,10850,2901,16786
31-10-2019,22 - 23,1324,1985,10230,2669,16208
31-10-2019,23 - 00,1322,1848,9647,2490,15307
01-11-2019,00 - 01,1238,1964,9421,2444,15067
01-11-2019,01 - 02,1102,1859,9224,2367,14552
01-11-2019,02 - 03,1135,1860,9179,2329,14503
01-11-2019,03 - 04,1220,1857,9170,2313,14560
01-11-2019,04 - 05,1169,1893,9421,2369,14852
01-11-2019,05 - 06,1202,1996,10003,2539,15740
01-11-2019,06 - 07,1300,2245,11088,2896,17529
01-11-2019,07 - 08,1268,2265,11742,3216,18491
01-11-2019,08 - 09,1342,2231,12012,3296,18881
01-11-2019,09 - 10,1409,2163,11939,3261,18772
01-11-2019,10 - 11,1431,2110,12047,3245,18833
01-11-2019,11 - 12,1361,2009,11906,3215,18491
01-11-2019,12 - 13,1347,1946,11771,3094,18158
01-11-2019,13 - 14,1402,1961,11534,3090,17987
01-11-2019,14 - 15,1368,1949,11397,3105,17819
01-11-2019,15 - 16,1366,2102,11494,3107,18069
01-11-2019,16 - 17,1519,2211,11891,3216,18837
01-11-2019,17 - 18,1519,2147,11971,3325,18962
01-11-2019,18 - 19,1449,2103,11640,3203,18395
01-11-2019,19 - 20,1361,1919,11245,2996,17521
01-11-2019,20 - 21,1356,2035,10772,2850,17013
01-11-2019,21 - 22,1272,1824,10264,2710,16070
01-11-2019,22 - 23,1251,1740,9872,2610,15473
01-11-2019,23 - 00,1142,1626,9410,2507,14685
02-11-2019,00 - 01,1082,1702,9232,2424,14440
02-11-2019,01 - 02,999,1654,9137,2378,14168
02-11-2019,02 - 03,1073,1700,8794,2350,13917
02-11-2019,03 - 04,1165,1765,8750,2338,14018
02-11-2019,04 - 05,1228,1789,8797,2349,14163
02-11-2019,05 - 06,1218,1741,8882,2381,14222
02-11-2019,06 - 07,1213,1794,9154,2401,14562
02-11-2019,07 - 08,1260,1801,9383,2481,14925
02-11-2019,08 - 09,1459,1843,9788,2614,15704
02-11-2019,09 - 10,1524,1896,10216,2732,16368
02-11-2019,10 - 11,1429,2011,10450,2800,16690
02-11-2019,11 - 12,1405,1974,10558,2794,16731
02-11-2019,12 - 13,1221,1979,10578,2784,16562
02-11-2019,13 - 14,1306,1876,10530,2753,16465
02-11-2019,14 - 15,1297,1907,10516,2721,16441
02-11-2019,15 - 16,1332,1872,10580,2757,16541
02-11-2019,16 - 17,1301,2035,10956,2847,17139
02-11-2019,17 - 18,1295,2028,11057,2923,17303
02-11-2019,18 - 19,1283,2028,10857,2871,17039
02-11-2019,19 - 20,1117,2022,10627,2711,16477
02-11-2019,20 - 21,1011,2001,10418,2603,16033
02-11-2019,21 - 22,1372,1974,9906,2518,15770
02-11-2019,22 - 23,1257,1904,9503,2387,15051
02-11-2019,23 - 00,1163,1865,8993,2269,14290
03-11-2019,00 - 01,985,1802,8706,2227,13720
03-11-2019,01 - 02,1091,1777,8562,2182,13612
03-11-2019,02 - 03,1055,1762,8462,2167,13446
03-11-2019,03 - 04,1115,1840,8451,2122,13528
03-11-2019,04 - 05,1137,1809,8507,2106,13559
03-11-2019,05 - 06,1108,1841,8670,2146,13765
03-11-2019,06 - 07,1037,1784,8907,2174,13902
03-11-2019,07 - 08,1149,1726,9163,2214,14252
03-11-2019,08 - 09,1197,1892,9609,2302,15000
03-11-2019,09 - 10,1229,1854,10176,2447,15706
03-11-2019,10 - 11,1194,2078,10570,2592,16434
03-11-2019,11 - 12,1278,2125,10784,2601,16788
03-11-2019,12 - 13,1300,1969,10836,2666,16771
03-11-2019,13 - 14,1152,1864,10813,2636,16465
03-11-2019,14 - 15,1143,2034,10918,2612,16707
03-11-2019,15 - 16,1119,2141,11018,2627,16905
03-11-2019,16 - 17,1242,2085,11454,2787,17568
03-11-2019,17 - 18,1291,1981,11717,2950,17939
03-11-2019,18 - 19,1225,2205,11598,2898,17926
03-11-2019,19 - 20,1133,2221,11273,2768,17395
03-11-2019,20 - 21,1063,2041,10934,2670,16708
03-11-2019,21 - 22,1129,1934,10511,2558,16132
03-11-2019,22 - 23,1206,1866,10016,2381,15469
03-11-2019,23 - 00,1194,1774,9549,2249,14766
04-11-2019,00 - 01,1257,1765,9300,2240,14562
04-11-2019,01 - 02,1298,1854,9157,2230,14539
04-11-2019,02 - 03,1331,1916,9198,2241,14686
04-11-2019,03 - 04,1332,1948,9276,2187,14743
04-11-2019,04 - 05,1313,1993,9457,2232,14995
04-11-2019,05 - 06,1470,2143,10063,2381,16057
04-11-2019,06 - 07,1421,2300,11292,2791,17804
04-11-2019,07 - 08,1418,2406,12321,3170,19315
04-11-2019,08 - 09,1464,2381,12483,3269,19597
04-11-2019,09 - 10,1386,2409,12461,3311,19567
04-11-2019,10 - 11,1437,2377,12471,3396,19681
04-11-2019,11 - 12,1361,2364,12385,3365,19475
04-11-2019,12 - 13,1427,2341,12300,3289,19357
04-11-2019,13 - 14,1374,2379,12268,3308,19329
04-11-2019,14 - 15,1404,2458,12290,3340,19492
04-11-2019,15 - 16,1408,2403,12523,3361,19695
04-11-2019,16 - 17,1301,2488,12903,3440,20132
04-11-2019,17 - 18,1295,2397,13175,3496,20363
04-11-2019,18 - 19,1407,2317,12934,3386,20044
04-11-2019,19 - 20,1500,2311,12663,3296,19770
04-11-2019,20 - 21,1464,2235,12142,3085,18926
04-11-2019,21 - 22,1458,2256,11598,2910,18222
04-11-2019,22 - 23,1363,2147,10942,2784,17236
04-11-2019,23 - 00,1339,1977,10413,2622,16351
05-11-2019,00 - 01,1382,1877,10069,2528,15856
05-11-2019,01 - 02,1339,2027,9953,2511,15830
05-11-2019,02 - 03,1317,2012,9838,2525,15692
05-11-2019,03 - 04,1290,2027,9736,2543,15596
05-11-2019,04 - 05,1406,2096,9891,2646,16039
05-11-2019,05 - 06,1501,2210,10566,2877,17154
05-11-2019,06 - 07,1643,2294,11828,3240,19005
05-11-2019,07 - 08,1605,2481,12746,3576,20408
05-11-2019,08 - 09,1541,2450,12766,3625,20382
05-11-2019,09 - 10,1411,2423,12765,3612,20211
05-11-2019,10 - 11,1445,2415,12620,3633,20113
05-11-2019,11 - 12,1404,2415,12593,3605,20017
05-11-2019,12 - 13,1372,2418,12411,3616,19817
05-11-2019,13 - 14,1379,2297,12385,3667,19728
05-11-2019,14 - 15,1473,2335,12505,3663,19976
05-11-2019,15 - 16,1432,2409,12743,3701,20285
05-11-2019,16 - 17,1397,2478,13225,3745,20845
05-11-2019,17 - 18,1539,2443,13433,3825,21240
05-11-2019,18 - 19,1550,2342,13201,3716,20809
05-11-2019,19 - 20,1458,2345,12916,3609,20328
05-11-2019,20 - 21,1391,2342,12535,3498,19766
05-11-2019,21 - 22,1395,2250,11991,3296,18932
05-11-2019,22 - 23,1316,2097,11343,3025,17781
05-11-2019,23 - 00,1354,2028,10778,2783,16943
06-11-2019,00 - 01,1322,2001,10484,2644,16451
06-11-2019,01 - 02,1277,1887,10257,2608,16029
06-11-2019,02 - 03,1246,1954,10286,2590,16076
06-11-2019,03 - 04,1279,2024,10427,2615,16345
06-11-2019,04 - 05,1301,2059,10516,2672,16548
06-11-2019,05 - 06,1342,2189,11126,2892,17549
06-11-2019,06 - 07,1447,2396,12513,3412,19768
06-11-2019,07 - 08,1606,2417,13423,3710,21156
06-11-2019,08 - 09,1384,2480,13467,3725,21056
06-11-2019,09 - 10,1387,2509,13386,3712,20994
06-11-2019,10 - 11,1393,2452,13300,3730,20875
06-11-2019,11 - 12,1437,2421,13140,3675,20673
06-11-2019,12 - 13,1413,2327,12858,3601,20199
06-11-2019,13 - 14,1436,2393,12882,3594,20305
06-11-2019,14 - 15,1453,2422,12875,3568,20318
06-11-2019,15 - 16,1450,2425,13082,3581,20538
06-11-2019,16 - 17,1337,2515,13445,3638,20935
06-11-2019,17 - 18,1444,2481,13716,3725,21366
06-11-2019,18 - 19,1383,2352,13460,3623,20818
06-11-2019,19 - 20,1384,2328,13090,3490,20292
06-11-2019,20 - 21,1358,2262,12651,3334,19605
06-11-2019,21 - 22,1443,2241,12130,3186,19000
06-11-2019,22 - 23,1314,2143,11457,2990,17904
06-11-2019,23 - 00,1274,2080,10839,2771,16964
07-11-2019,00 - 01,1270,2047,10489,2666,16472
07-11-2019,01 - 02,1252,2038,10211,2648,16149
07-11-2019,02 - 03,1231,1983,10223,2595,16032
07-11-2019,03 - 04,1236,1944,10295,2633,16108
07-11-2019,04 - 05,1260,2041,10451,2702,16454
07-11-2019,05 - 06,1378,2138,11019,2861,17396
07-11-2019,06 - 07,1338,2264,12223,3282,19107
07-11-2019,07 - 08,1419,2380,13065,3586,20450
07-11-2019,08 - 09,1398,2458,13164,3632,20652
07-11-2019,09 - 10,1383,2389,13187,3606,20565
07-11-2019,10 - 11,1407,2410,13200,3660,20677
07-11-2019,11 - 12,1379,2396,13127,3619,20521
07-11-2019,12 - 13,1382,2286,13065,3523,20256
07-11-2019,13 - 14,1346,2323,12988,3504,20161
07-11-2019,14 - 15,1438,2356,12975,3485,20254
07-11-2019,15 - 16,1430,2389,12964,3548,20331
07-11-2019,16 - 17,1448,2382,13266,3603,20699
07-11-2019,17 - 18,1397,2280,13385,3678,20740
07-11-2019,18 - 19,1442,2274,13153,3574,20443
07-11-2019,19 - 20,1386,2174,12819,3478,19857
07-11-2019,20 - 21,1310,2159,12406,3347,19222
07-11-2019,21 - 22,1355,2135,11757,3142,18389
07-11-2019,22 - 23,1280,2098,11132,2928,17438
07-11-2019,23 - 00,1219,2033,10522,2678,16452
08-11-2019,00 - 01,1272,1861,10068,2550,15751
08-11-2019,01 - 02,1270,1984,9861,2503,15618
08-11-2019,02 - 03,1258,2036,9777,2414,15485
08-11-2019,03 - 04,1249,2037,9680,2386,15352
08-11-2019,04 - 05,1285,1963,9851,2399,15498
08-11-2019,05 - 06,1304,2093,10338,2585,16320
08-11-2019,06 - 07,1423,2326,11605,3005,18359
08-11-2019,07 - 08,1415,2471,12593,3351,19830
08-11-2019,08 - 09,1579,2404,12835,3402,20220
08-11-2019,09 - 10,1380,2414,12791,3376,19961
08-11-2019,10 - 11,1470,2452,12863,3327,20112
08-11-2019,11 - 12,1505,2432,12799,3245,19981
08-11-2019,12 - 13,1431,2346,12580,3261,19618
08-11-2019,13 - 14,1447,2334,12409,3225,19415
08-11-2019,14 - 15,1414,2358,12368,3211,19351
08-11-2019,15 - 16,1463,2438,12452,3170,19523
08-11-2019,16 - 17,1501,2429,12683,3277,19890
08-11-2019,17 - 18,1472,2454,12594,3352,19872
08-11-2019,18 - 19,1456,2404,12319,3274,19453
08-11-2019,19 - 20,1490,2305,11907,3167,18869
08-11-2019,20 - 21,1527,2190,11264,3009,17990
08-11-2019,21 - 22,1409,2189,10662,2860,17120
08-11-2019,22 - 23,1457,2141,10126,2706,16430
08-11-2019,23 - 00,1370,2149,9709,2537,15765
09-11-2019,00 - 01,1288,1973,9346,2425,15032
09-11-2019,01 - 02,1306,2082,9190,2333,14911
09-11-2019,02 - 03,1335,2148,9002,2275,14760
09-11-2019,03 - 04,1348,2178,8954,2264,14744
09-11-2019,04 - 05,1387,2196,8956,2262,14801
09-11-2019,05 - 06,1397,2189,9175,2307,15068
09-11-2019,06 - 07,1396,2189,9448,2428,15461
09-11-2019,07 - 08,1320,2189,9834,2565,15908
09-11-2019,08 - 09,1452,2270,10338,2723,16783
09-11-2019,09 - 10,1404,2292,10864,2824,17384
09-11-2019,10 - 11,1465,2342,11184,2919,17910
09-11-2019,11 - 12,1504,2375,11402,2971,18252
09-11-2019,12 - 13,1511,2333,11504,2980,18328
09-11-2019,13 - 14,1432,2339,11409,2943,18123
09-11-2019,14 - 15,1498,2339,11388,2904,18129
09-11-2019,15 - 16,1580,2431,11569,2944,18524
09-11-2019,16 - 17,1585,2531,12029,3103,19248
09-11-2019,17 - 18,1548,2535,12117,3169,19369
09-11-2019,18 - 19,1551,2419,11972,3075,19017
09-11-2019,19 - 20,1521,2392,11534,2996,18443
09-11-2019,20 - 21,1450,2313,11133,2825,17721
09-11-2019,21 - 22,1400,2194,10638,2679,16911
09-11-2019,22 - 23,1535,2271,10227,2557,16590
09-11-2019,23 - 00,1438,2206,9802,2488,15934
10-11-2019,00 - 01,1395,2218,9417,2358,15388
10-11-2019,01 - 02,1444,2027,9301,2295,15067
10-11-2019,02 - 03,1383,1941,9190,2267,14781
10-11-2019,03 - 04,1406,1930,9175,2258,14769
10-11-2019,04 - 05,1418,1970,9248,2272,14908
10-11-2019,05 - 06,1409,2010,9380,2326,15125
10-11-2019,06 - 07,1439,2092,9659,2386,15576
10-11-2019,07 - 08,1432,2072,10034,2508,16046
10-11-2019,08 - 09,1415,2117,10360,2650,16542
10-11-2019,09 - 10,1418,2201,10779,2793,17191
10-11-2019,10 - 11,1416,2133,11190,2901,17640
10-11-2019,11 - 12,1405,2308,11538,2891,18142
10-11-2019,12 - 13,1378,2336,11594,2870,18178
10-11-2019,13 - 14,1312,2213,11718,2842,18085
10-11-2019,14 - 15,1302,2135,11578,2847,17862
10-11-2019,15 - 16,1414,2187,11827,2917,18345
10-11-2019,16 - 17,1454,2279,12346,3108,19187
10-11-2019,17 - 18,1474,2278,12533,3244,19529
10-11-2019,18 - 19,1452,2288,12436,3252,19428
10-11-2019,19 - 20,1318,2228,12209,3191,18946
10-11-2019,20 - 21,1261,2182,11941,3072,18456
10-11-2019,21 - 22,1220,2231,11452,2932,17835
10-11-2019,22 - 23,1037,2342,10957,2766,17102
10-11-2019,23 - 00,1141,2041,10465,2576,16223
11-11-2019,00 - 01,1152,1940,10227,2519,15838
11-11-2019,01 - 02,1157,1972,10040,2465,15634
11-11-2019,02 - 03,1144,1925,9948,2457,15474
11-11-2019,03 - 04,1151,2002,9933,2449,15535
11-11-2019,04 - 05,1210,2072,10048,2457,15787
11-11-2019,05 - 06,1179,2201,10612,2631,16623
11-11-2019,06 - 07,1319,2360,12042,3031,18752
11-11-2019,07 - 08,1372,2492,13074,3400,20338
11-11-2019,08 - 09,1379,2478,13167,3442,20466
11-11-2019,09 - 10,1411,2444,13100,3388,20343
11-11-2019,10 - 11,1347,2401,12947,3431,20126
11-11-2019,11 - 12,1382,2454,12977,3402,20215
11-11-2019,12 - 13,1421,2462,12896,3352,20131
11-11-2019,13 - 14,1421,2539,12752,3318,20030
11-11-2019,14 - 15,1356,2451,12706,3342,19855
11-11-2019,15 - 16,1431,2524,12961,3409,20325
11-11-2019,16 - 17,1380,2574,13133,3528,20615
11-11-2019,17 - 18,1351,2520,13157,3648,20676
11-11-2019,18 - 19,1319,2509,12801,3579,20208
11-11-2019,19 - 20,1423,2446,12414,3461,19744
11-11-2019,20 - 21,1452,2313,11872,3229,18866
11-11-2019,21 - 22,1435,2308,11338,3014,18095
11-11-2019,22 - 23,1383,2237,10693,2766,17079
11-11-2019,23 - 00,1314,1916,10049,2575,15854
12-11-2019,00 - 01,1341,1895,9553,2490,15279
12-11-2019,01 - 02,1312,1759,9273,2468,14812
12-11-2019,02 - 03,1298,1927,9387,2421,15033
12-11-2019,03 - 04,1319,1987,9342,2463,15111
12-11-2019,04 - 05,1343,2107,9395,2538,15383
12-11-2019,05 - 06,1374,2048,9804,2724,15950
12-11-2019,06 - 07,1485,2157,10965,3134,17741
12-11-2019,07 - 08,1488,2322,12075,3465,19350
12-11-2019,08 - 09,1447,2417,12090,3495,19449
12-11-2019,09 - 10,1493,2479,12045,3532,19549
12-11-2019,10 - 11,1464,2429,12085,3574,19552
12-11-2019,11 - 12,1426,2311,12203,3586,19526
12-11-2019,12 - 13,1398,2267,12320,3462,19447
12-11-2019,13 - 14,1388,2218,12276,3443,19325
12-11-2019,14 - 15,1423,2211,12212,3451,19297
12-11-2019,15 - 16,1462,2436,12392,3467,19757
12-11-2019,16 - 17,1523,2509,12635,3520,20187
12-11-2019,17 - 18,1515,2380,12709,3650,20254
12-11-2019,18 - 19,1475,2396,12443,3588,19902
12-11-2019,19 - 20,1440,2247,12019,3394,19100
12-11-2019,20 - 21,1411,2156,11500,3212,18279
12-11-2019,21 - 22,1491,2213,11040,2983,17727
12-11-2019,22 - 23,1349,2022,10487,2837,16695
12-11-2019,23 - 00,1280,2037,9857,2667,15841
13-11-2019,00 - 01,1261,1992,9463,2549,15265
13-11-2019,01 - 02,1272,2019,9230,2458,14979
13-11-2019,02 - 03,1298,2022,9199,2446,14965
13-11-2019,03 - 04,1318,2238,9201,2464,15221
13-11-2019,04 - 05,1354,2079,9479,2502,15414
13-11-2019,05 - 06,1399,2034,10096,2665,16194
13-11-2019,06 - 07,1386,2243,11329,3102,18060
13-11-2019,07 - 08,1355,2339,12369,3469,19532
13-11-2019,08 - 09,1354,2221,12408,3497,19480
13-11-2019,09 - 10,1415,2307,12361,3463,19546
13-11-2019,10 - 11,1263,2334,12313,3484,19394
13-11-2019,11 - 12,1375,2237,12267,3477,19356
13-11-2019,12 - 13,1302,2209,12242,3447,19200
13-11-2019,13 - 14,1291,2207,12057,3423,18978
13-11-2019,14 - 15,1405,2297,12080,3427,19209
13-11-2019,15 - 16,1412,2363,12265,3481,19521
13-11-2019,16 - 17,1416,2357,12576,3533,19882
13-11-2019,17 - 18,1359,2234,12741,3607,19941
13-11-2019,18 - 19,1358,2194,12457,3560,19569
13-11-2019,19 - 20,1404,2203,12230,3442,19279
13-11-2019,20 - 21,1316,2066,11948,3291,18621
13-11-2019,21 - 22,1338,1987,11150,3125,17600
13-11-2019,22 - 23,1280,1994,10489,2895,16658
13-11-2019,23 - 00,1277,1925,9726,2675,15603
14-11-2019,00 - 01,1188,1880,9153,2533,14754
14-11-2019,01 - 02,1202,1806,9153,2505,14666
14-11-2019,02 - 03,1193,1772,9099,2506,14570
14-11-2019,03 - 04,1165,1774,9123,2510,14572
14-11-2019,04 - 05,1199,1753,9256,2553,14761
14-11-2019,05 - 06,1127,1834,9813,2760,15534
14-11-2019,06 - 07,1361,2162,11202,3210,17935
14-11-2019,07 - 08,1407,2276,12270,3543,19496
14-11-2019,08 - 09,1368,2241,12333,3551,19493
14-11-2019,09 - 10,1466,2303,12246,3490,19505
14-11-2019,10 - 11,1225,2274,12383,3509,19391
14-11-2019,11 - 12,1264,2224,12405,3506,19399
14-11-2019,12 - 13,1354,2301,12369,3442,19466
14-11-2019,13 - 14,1358,2311,12266,3422,19357
14-11-2019,14 - 15,1353,2345,12240,3427,19365
14-11-2019,15 - 16,1334,2416,12420,3447,19617
14-11-2019,16 - 17,1355,2401,12755,3517,20028
14-11-2019,17 - 18,1353,2382,12794,3568,20097
14-11-2019,18 - 19,1406,2297,12489,3505,19697
14-11-2019,19 - 20,1352,2329,12172,3398,19251
14-11-2019,20 - 21,1294,2396,11725,3301,18716
14-11-2019,21 - 22,1221,2323,11140,3173,17857
14-11-2019,22 - 23,1259,2239,10510,2973,16981
14-11-2019,23 - 00,1183,2038,9976,2741,15938
15-11-2019,00 - 01,1125,1954,9574,2557,15210
15-11-2019,01 - 02,1250,2036,9421,2474,15181
15-11-2019,02 - 03,1351,2023,9298,2475,15147
15-11-2019,03 - 04,1336,1941,9140,2447,14864
15-11-2019,04 - 05,1239,1973,9241,2461,14914
15-11-2019,05 - 06,1215,2059,9739,2635,15648
15-11-2019,06 - 07,1348,2293,10923,2965,17529
15-11-2019,07 - 08,1493,2335,11967,3242,19037
15-11-2019,08 - 09,1576,2211,12140,3268,19195
15-11-2019,09 - 10,1473,2230,12189,3298,19190
15-11-2019,10 - 11,1324,2261,12200,3291,19076
15-11-2019,11 - 12,1230,2286,12165,3323,19004
15-11-2019,12 - 13,1350,2366,12134,3325,19175
15-11-2019,13 - 14,1491,2401,11922,3274,19088
15-11-2019,14 - 15,1312,2387,11862,3233,18794
15-11-2019,15 - 16,1421,2483,11989,3237,19130
15-11-2019,16 - 17,1478,2497,12195,3383,19553
15-11-2019,17 - 18,1389,2409,12289,3430,19517
15-11-2019,18 - 19,1328,2342,11950,3328,18948
15-11-2019,19 - 20,1352,2339,11326,3153,18170
15-11-2019,20 - 21,1403,2211,10708,3010,17332
15-11-2019,21 - 22,1302,2170,10233,2801,16506
15-11-2019,22 - 23,1321,2155,9682,2623,15781
15-11-2019,23 - 00,1261,2068,9241,2510,15080
16-11-2019,00 - 01,1378,1909,8807,2443,14537
16-11-2019,01 - 02,1288,1916,8655,2365,14224
16-11-2019,02 - 03,1263,1925,8528,2275,13991
16-11-2019,03 - 04,1257,1994,8464,2283,13998
16-11-2019,04 - 05,1257,2023,8471,2289,14040
16-11-2019,05 - 06,1337,2048,8577,2323,14285
16-11-2019,06 - 07,1352,2152,8861,2514,14879
16-11-2019,07 - 08,1302,2183,9259,2676,15420
16-11-2019,08 - 09,1387,2284,9807,2823,16301
16-11-2019,09 - 10,1390,2252,10320,2959,16921
16-11-2019,10 - 11,1401,2194,10568,2994,17157
16-11-2019,11 - 12,1318,2286,10760,3039,17403
16-11-2019,12 - 13,1325,2188,10789,2941,17243
16-11-2019,13 - 14,1342,2230,10767,2886,17225
16-11-2019,14 - 15,1289,2282,10741,2884,17196
16-11-2019,15 - 16,1285,2328,10837,2906,17356
16-11-2019,16 - 17,1393,2401,11092,2981,17867
16-11-2019,17 - 18,1371,2236,11053,3004,17664
16-11-2019,18 - 19,1361,2180,10825,2938,17304
16-11-2019,19 - 20,1287,2320,10432,2833,16872
16-11-2019,20 - 21,1334,2232,10044,2699,16309
16-11-2019,21 - 22,1382,2035,9615,2578,15610
16-11-2019,22 - 23,1364,2016,9230,2464,15074
16-11-2019,23 - 00,1319,1977,8794,2309,14399
17-11-2019,00 - 01,1335,1998,8410,2287,14030
17-11-2019,01 - 02,1341,1999,8245,2289,13874
17-11-2019,02 - 03,1364,1985,8281,2282,13912
17-11-2019,03 - 04,1379,2013,8216,2264,13872
17-11-2019,04 - 05,1356,2099,8197,2226,13878
17-11-2019,05 - 06,1351,2044,8273,2399,14067
17-11-2019,06 - 07,1400,2148,8424,2476,14448
17-11-2019,07 - 08,1477,2201,8757,2539,14974
17-11-2019,08 - 09,1499,2215,9104,2559,15377
17-11-2019,09 - 10,1477,2220,9425,2738,15860
17-11-2019,10 - 11,1463,2241,9854,2926,16484
17-11-2019,11 - 12,1458,2279,10117,2990,16844
17-11-2019,12 - 13,1396,2167,10168,2902,16633
17-11-2019,13 - 14,1434,2245,10287,2896,16862
17-11-2019,14 - 15,1398,2118,10396,2869,16781
17-11-2019,15 - 16,1447,2256,10711,2945,17359
17-11-2019,16 - 17,1450,2416,11108,3102,18076
17-11-2019,17 - 18,1441,2494,11199,3221,18355
17-11-2019,18 - 19,1364,2324,10971,3173,17832
17-11-2019,19 - 20,1310,2187,10769,3046,17312
17-11-2019,20 - 21,1278,2261,10472,2873,16884
17-11-2019,21 - 22,1346,2109,10021,2650,16126
17-11-2019,22 - 23,1266,2060,9540,2488,15354
17-11-2019,23 - 00,1238,1941,9059,2349,14587
18-11-2019,00 - 01,1180,1975,8776,2253,14184
18-11-2019,01 - 02,1199,1911,8570,2155,13835
18-11-2019,02 - 03,1204,1911,8506,2134,13755
18-11-2019,03 - 04,1186,1958,8517,2228,13889
18-11-2019,04 - 05,1209,2099,8650,2331,14289
18-11-2019,05 - 06,1263,2145,9107,2497,15012
18-11-2019,06 - 07,1351,2352,10460,2873,17036
18-11-2019,07 - 08,1377,2466,11556,3219,18618
18-11-2019,08 - 09,1420,2425,11707,3281,18833
18-11-2019,09 - 10,1389,2434,11688,3302,18813
18-11-2019,10 - 11,1321,2443,11719,3330,18813
18-11-2019,11 - 12,1355,2458,11761,3354,18928
18-11-2019,12 - 13,1387,2458,11790,3367,19002
18-11-2019,13 - 14,1343,2566,11781,3464,19154
18-11-2019,14 - 15,1285,2559,11821,3459,19124
18-11-2019,15 - 16,1345,2619,11990,3494,19448
18-11-2019,16 - 17,1415,2640,12048,3507,19610
18-11-2019,17 - 18,1365,2808,12080,3491,19744
18-11-2019,18 - 19,1399,2599,11633,3431,19062
18-11-2019,19 - 20,1337,2521,11120,3219,18197
18-11-2019,20 - 21,1350,2295,10672,3055,17372
18-11-2019,21 - 22,1296,2248,10171,2868,16583
18-11-2019,22 - 23,1107,2124,9614,2653,15498
18-11-2019,23 - 00,1161,2330,9002,2456,14949
19-11-2019,00 - 01,1174,2133,8606,2374,14287
19-11-2019,01 - 02,1204,2176,8395,2311,14086
19-11-2019,02 - 03,1293,2181,8289,2238,14001
19-11-2019,03 - 04,1291,2193,8254,2198,13936
19-11-2019,04 - 05,1277,2056,8209,2330,13872
19-11-2019,05 - 06,1342,2117,8839,2631,14929
19-11-2019,06 - 07,1440,2113,9962,2986,16501
19-11-2019,07 - 08,1562,2241,10979,3358,18140
19-11-2019,08 - 09,1551,2256,11444,3516,18767
19-11-2019,09 - 10,1321,2099,11482,3561,18463
19-11-2019,10 - 11,1333,1931,11508,3561,18333
19-11-2019,11 - 12,1391,2071,11607,3580,18649
19-11-2019,12 - 13,1335,2132,11574,3518,18559
19-11-2019,13 - 14,1408,1967,11514,3562,18451
19-11-2019,14 - 15,1426,1943,11640,3537,18546
19-11-2019,15 - 16,1405,2148,11948,3525,19026
19-11-2019,16 - 17,1446,2231,12259,3505,19441
19-11-2019,17 - 18,1302,2223,12264,3625,19414
19-11-2019,18 - 19,1289,2119,11968,3451,18827
19-11-2019,19 - 20,1219,2001,11686,3311,18217
19-11-2019,20 - 21,1113,1810,11199,3184,17306
19-11-2019,21 - 22,1179,1901,10650,2958,16688
19-11-2019,22 - 23,990,1898,9882,2714,15484
19-11-2019,23 - 00,1018,1786,9195,2517,14516
20-11-2019,00 - 01,1039,1590,8873,2437,13939
20-11-2019,01 - 02,1121,1665,8480,2414,13680
20-11-2019,02 - 03,1110,1638,8562,2371,13681
20-11-2019,03 - 04,978,1640,8637,2407,13662
20-11-2019,04 - 05,1004,1751,8755,2483,13993
20-11-2019,05 - 06,1126,1865,9324,2637,14952
20-11-2019,06 - 07,1284,2071,10655,3069,17079
20-11-2019,07 - 08,1334,2107,11731,3342,18514
20-11-2019,08 - 09,1355,2200,11774,3370,18699
20-11-2019,09 - 10,1328,2226,11673,3395,18622
20-11-2019,10 - 11,1239,2196,11747,3482,18664
20-11-2019,11 - 12,1208,2224,11703,3463,18598
20-11-2019,12 - 13,1294,2180,11688,3417,18579
20-11-2019,13 - 14,1118,2141,11662,3373,18294
20-11-2019,14 - 15,1127,2232,11660,3317,18336
20-11-2019,15 - 16,1156,2269,11797,3315,18537
20-11-2019,16 - 17,1191,2364,11974,3341,18870
20-11-2019,17 - 18,1215,2416,12061,3374,19066
20-11-2019,18 - 19,1363,2198,11923,3353,18837
20-11-2019,19 - 20,1312,2036,11611,3291,18250
20-11-2019,20 - 21,1184,1876,11227,3178,17465
20-11-2019,21 - 22,1150,1691,10425,3012,16278
20-11-2019,22 - 23,1243,1685,9767,2740,15435
20-11-2019,23 - 00,1132,1638,9139,2560,14469
21-11-2019,00 - 01,1199,1469,8742,2502,13912
21-11-2019,01 - 02,1139,1608,8627,2434,13808
21-11-2019,02 - 03,1090,1457,8502,2352,13401
21-11-2019,03 - 04,1143,1441,8520,2313,13417
21-11-2019,04 - 05,1304,1477,8520,2365,13666
21-11-2019,05 - 06,1274,1415,9069,2532,14290
21-11-2019,06 - 07,1253,1607,10340,2974,16174
21-11-2019,07 - 08,1149,1788,11512,3326,17775
21-11-2019,08 - 09,1256,1879,11939,3365,18439
21-11-2019,09 - 10,1401,2013,11894,3368,18676
21-11-2019,10 - 11,1490,1920,11865,3414,18689
21-11-2019,11 - 12,1409,2145,11961,3494,19009
21-11-2019,12 - 13,1263,2135,11944,3544,18886
21-11-2019,13 - 14,1252,2100,11979,3549,18880
21-11-2019,14 - 15,1235,2129,11873,3502,18739
21-11-2019,15 - 16,1227,2199,12317,3515,19258
21-11-2019,16 - 17,1168,2185,12558,3546,19457
21-11-2019,17 - 18,1181,2122,12585,3597,19485
21-11-2019,18 - 19,1192,2187,12238,3511,19128
21-11-2019,19 - 20,1223,2148,11791,3344,18506
21-11-2019,20 - 21,1319,2096,11290,3168,17873
21-11-2019,21 - 22,1351,1905,10644,3028,16928
21-11-2019,22 - 23,1261,1879,10029,2848,16017
21-11-2019,23 - 00,1133,1814,9284,2657,14888
22-11-2019,00 - 01,1231,1835,8877,2557,14500
22-11-2019,01 - 02,1167,1744,8660,2492,14063
22-11-2019,02 - 03,1189,1809,8634,2443,14075
22-11-2019,03 - 04,1158,1844,8625,2469,14096
22-11-2019,04 - 05,1122,1905,8720,2480,14227
22-11-2019,05 - 06,1228,1999,9219,2640,15086
22-11-2019,06 - 07,1315,2000,10554,3064,16933
22-11-2019,07 - 08,1412,2197,11762,3384,18755
22-11-2019,08 - 09,1454,2189,11948,3433,19024
22-11-2019,09 - 10,1433,2023,11886,3448,18790
22-11-2019,10 - 11,1408,2040,11944,3409,18801
22-11-2019,11 - 12,1401,2029,12140,3400,18970
22-11-2019,12 - 13,1495,2062,12073,3342,18972
22-11-2019,13 - 14,1411,2032,11975,3260,18678
22-11-2019,14 - 15,1434,2041,12054,3205,18734
22-11-2019,15 - 16,1353,2046,12233,3242,18874
22-11-2019,16 - 17,1314,2123,12365,3267,19069
22-11-2019,17 - 18,1240,2066,12324,3243,18873
22-11-2019,18 - 19,1220,1908,11931,3124,18183
22-11-2019,19 - 20,1222,1871,11356,2934,17383
22-11-2019,20 - 21,1267,1882,10934,2709,16792
22-11-2019,21 - 22,1142,1896,10389,2598,16025
22-11-2019,22 - 23,1140,1805,9894,2488,15327
22-11-2019,23 - 00,1219,1861,9395,2353,14828
23-11-2019,00 - 01,1208,1912,9109,2263,14492
23-11-2019,01 - 02,1242,1886,8832,2173,14133
23-11-2019,02 - 03,1199,1779,8676,2135,13789
23-11-2019,03 - 04,1128,1778,8566,2119,13591
23-11-2019,04 - 05,1083,1784,8561,2125,13553
23-11-2019,05 - 06,1176,1785,8710,2167,13838
23-11-2019,06 - 07,1130,1912,9040,2324,14406
23-11-2019,07 - 08,1171,1972,9468,2515,15126
23-11-2019,08 - 09,1162,2043,9857,2631,15693
23-11-2019,09 - 10,1219,2101,10252,2680,16252
23-11-2019,10 - 11,1625,2119,10633,2747,17124
23-11-2019,11 - 12,1168,2099,10764,2834,16865
23-11-2019,12 - 13,1294,2212,10808,2911,17225
23-11-2019,13 - 14,1270,2147,10872,2923,17212
23-11-2019,14 - 15,1262,2055,10925,2865,17107
23-11-2019,15 - 16,1304,2098,11079,2934,17415
23-11-2019,16 - 17,1340,2131,11296,3089,17856
23-11-2019,17 - 18,1271,2108,11343,3059,17781
23-11-2019,18 - 19,1356,1975,11107,2986,17424
23-11-2019,19 - 20,1381,1884,10804,2839,16908
23-11-2019,20 - 21,1383,1806,10327,2741,16257
23-11-2019,21 - 22,1328,1839,9843,2575,15585
23-11-2019,22 - 23,1310,1676,9548,2424,14958
23-11-2019,23 - 00,1264,1644,9248,2303,14459
24-11-2019,00 - 01,1229,1615,8977,2231,14052
24-11-2019,01 - 02,1225,1722,8907,2172,14026
24-11-2019,02 - 03,1140,1644,8721,2156,13661
24-11-2019,03 - 04,1118,1671,8646,2188,13623
24-11-2019,04 - 05,1188,1701,8669,2199,13757
24-11-2019,05 - 06,1241,1763,8811,2284,14099
24-11-2019,06 - 07,1234,1812,9079,2366,14491
24-11-2019,07 - 08,1214,1849,9430,2461,14954
24-11-2019,08 - 09,1211,1931,9812,2568,15522
24-11-2019,09 - 10,1239,1965,10383,2714,16301
24-11-2019,10 - 11,1267,2019,10839,2788,16913
24-11-2019,11 - 12,1238,2135,11198,2855,17426
24-11-2019,12 - 13,1277,2069,11238,2968,17552
24-11-2019,13 - 14,1317,2160,11300,2998,17775
24-11-2019,14 - 15,1268,2143,11340,2924,17675
24-11-2019,15 - 16,1337,2190,11585,2965,18077
24-11-2019,16 - 17,1357,2277,11895,3132,18661
24-11-2019,17 - 18,1349,2239,11992,3192,18772
24-11-2019,18 - 19,1375,2232,11860,3158,18625
24-11-2019,19 - 20,1346,2171,11558,3036,18111
24-11-2019,20 - 21,1283,2230,11265,2909,17687
24-11-2019,21 - 22,1243,2179,10814,2767,17003
24-11-2019,22 - 23,1214,2048,10305,2641,16208
24-11-2019,23 - 00,1248,1963,9823,2442,15476
25-11-2019,00 - 01,1116,1866,9327,2246,14555
25-11-2019,01 - 02,1049,1825,9116,2181,14171
25-11-2019,02 - 03,1125,1755,9041,2193,14114
25-11-2019,03 - 04,1159,1833,9160,2301,14453
25-11-2019,04 - 05,1149,1912,9445,2335,14841
25-11-2019,05 - 06,1180,1996,9977,2534,15687
25-11-2019,06 - 07,1379,2158,11324,3018,17879
25-11-2019,07 - 08,1407,2350,12490,3398,19645
25-11-2019,08 - 09,1384,2324,12698,3521,19927
25-11-2019,09 - 10,1333,2360,12742,3524,19959
25-11-2019,10 - 11,1316,2238,12846,3565,19965
25-11-2019,11 - 12,1343,2182,12868,3577,19970
25-11-2019,12 - 13,1364,2122,13035,3522,20043
25-11-2019,13 - 14,1366,2134,12928,3564,19992
25-11-2019,14 - 15,1374,2182,12973,3541,20070
25-11-2019,15 - 16,1439,2147,13254,3580,20420
25-11-2019,16 - 17,1423,2297,13269,3619,20608
25-11-2019,17 - 18,1343,2104,13268,3649,20364
25-11-2019,18 - 19,1328,2180,12921,3551,19980
25-11-2019,19 - 20,1331,2123,12571,3492,19517
25-11-2019,20 - 21,1319,2085,12001,3315,18720
25-11-2019,21 - 22,1256,2148,11565,3163,18132
25-11-2019,22 - 23,1235,1990,10827,2968,17020
25-11-2019,23 - 00,1203,1904,10110,2715,15932
26-11-2019,00 - 01,1134,1615,9581,2539,14869
26-11-2019,01 - 02,1132,1667,9393,2487,14679
26-11-2019,02 - 03,1193,1724,9338,2448,14703
26-11-2019,03 - 04,1154,1725,9270,2459,14608
26-11-2019,04 - 05,1206,1764,9447,2527,14944
26-11-2019,05 - 06,1283,1903,9969,2707,15862
26-11-2019,06 - 07,1320,2125,11247,3123,17815
26-11-2019,07 - 08,1430,2232,12404,3475,19541
26-11-2019,08 - 09,1407,2234,12592,3531,19764
26-11-2019,09 - 10,1339,2231,12477,3511,19558
26-11-2019,10 - 11,1347,2201,12513,3542,19603
26-11-2019,11 - 12,1384,2236,12553,3569,19742
26-11-2019,12 - 13,1390,2295,12530,3549,19764
26-11-2019,13 - 14,1411,2229,12484,3551,19675
26-11-2019,14 - 15,1235,2301,12590,3471,19597
26-11-2019,15 - 16,1209,2370,12846,3542,19967
26-11-2019,16 - 17,1233,2339,12948,3567,20087
26-11-2019,17 - 18,1142,2288,12806,3603,19839
26-11-2019,18 - 19,1233,2223,12529,3512,19497
26-11-2019,19 - 20,1300,2251,12264,3386,19201
26-11-2019,20 - 21,1242,2137,11778,3233,18390
26-11-2019,21 - 22,1287,2208,11129,3064,17688
26-11-2019,22 - 23,1226,2080,10376,2830,16512
26-11-2019,23 - 00,1155,1993,9687,2583,15418
27-11-2019,00 - 01,1146,1961,9242,2463,14812
27-11-2019,01 - 02,1159,1780,9116,2364,14419
27-11-2019,02 - 03,1133,1800,8949,2332,14214
27-11-2019,03 - 04,1180,1869,8939,2316,14304
27-11-2019,04 - 05,1237,1881,9060,2343,14521
27-11-2019,05 - 06,1358,2085,9611,2519,15573
27-11-2019,06 - 07,1467,2195,10780,2956,17398
27-11-2019,07 - 08,1531,2382,12113,3308,19334
27-11-2019,08 - 09,1551,2344,12387,3388,19670
27-11-2019,09 - 10,1511,2233,12249,3349,19342
27-11-2019,10 - 11,1408,2155,12246,3415,19224
27-11-2019,11 - 12,1412,2269,12245,3401,19327
27-11-2019,12 - 13,1502,2308,12288,3396,19494
27-11-2019,13 - 14,1591,2303,12173,3400,19467
27-11-2019,14 - 15,1492,2269,12167,3391,19319
27-11-2019,15 - 16,1455,2466,12527,3454,19902
27-11-2019,16 - 17,1505,2482,12599,3445,20031
27-11-2019,17 - 18,1490,2435,12675,3493,20093
27-11-2019,18 - 19,1537,2481,12521,3479,20018
27-11-2019,19 - 20,1457,2337,12148,3398,19340
27-11-2019,20 - 21,1412,2370,11632,3201,18615
27-11-2019,21 - 22,1326,2325,11005,3008,17664
27-11-2019,22 - 23,1290,2244,10313,2852,16699
27-11-2019,23 - 00,1267,2175,9726,2649,15817
28-11-2019,00 - 01,1271,2097,9183,2471,15022
28-11-2019,01 - 02,1333,2038,9007,2414,14792
28-11-2019,02 - 03,1336,2092,8932,2377,14737
28-11-2019,03 - 04,1332,2129,9009,2383,14853
28-11-2019,04 - 05,1307,2186,9220,2423,15136
28-11-2019,05 - 06,1355,2340,9693,2595,15983
28-11-2019,06 - 07,1505,2588,10946,2999,18038
28-11-2019,07 - 08,1519,2700,11980,3347,19546
28-11-2019,08 - 09,1457,2690,12178,3356,19681
28-11-2019,09 - 10,1406,2535,12102,3294,19337
28-11-2019,10 - 11,1447,2636,12135,3304,19522
28-11-2019,11 - 12,1438,2596,12085,3330,19449
28-11-2019,12 - 13,1449,2603,12072,3391,19515
28-11-2019,13 - 14,1457,2696,11988,3327,19468
28-11-2019,14 - 15,1471,2554,12077,3293,19395
28-11-2019,15 - 16,1537,2663,12339,3398,19937
28-11-2019,16 - 17,1530,2592,12398,3437,19957
28-11-2019,17 - 18,1504,2594,12421,3445,19964
28-11-2019,18 - 19,1517,2570,12187,3325,19599
28-11-2019,19 - 20,1480,2447,11768,3245,18940
28-11-2019,20 - 21,1390,2496,11395,3149,18430
28-11-2019,21 - 22,1399,2424,10882,2949,17654
28-11-2019,22 - 23,1358,2298,10393,2740,16789
28-11-2019,23 - 00,1397,2108,9941,2540,15986
29-11-2019,00 - 01,1365,2083,9704,2301,15453
29-11-2019,01 - 02,1324,1958,9577,2213,15072
29-11-2019,02 - 03,1332,1923,9573,2214,15042
29-11-2019,03 - 04,1329,1857,9629,2247,15062
29-11-2019,04 - 05,1258,1984,9863,2358,15463
29-11-2019,05 - 06,1385,2057,10384,2577,16403
29-11-2019,06 - 07,1526,2325,11708,3075,18634
29-11-2019,07 - 08,1442,2494,12840,3468,20244
29-11-2019,08 - 09,1450,2491,13037,3560,20538
29-11-2019,09 - 10,1430,2521,13101,3677,20729
29-11-2019,10 - 11,1332,2603,13160,3735,20830
29-11-2019,11 - 12,1337,2463,13154,3764,20718
29-11-2019,12 - 13,1445,2192,13058,3736,20431
29-11-2019,13 - 14,1408,2187,12898,3672,20165
29-11-2019,14 - 15,1352,2296,12730,3613,19991
29-11-2019,15 - 16,1410,2624,12999,3650,20683
29-11-2019,16 - 17,1336,2687,13391,3774,21188
29-11-2019,17 - 18,1355,2550,13480,3782,21167
29-11-2019,18 - 19,1248,2419,13170,3677,20514
29-11-2019,19 - 20,1272,2344,12766,3554,19936
29-11-2019,20 - 21,1301,2166,12352,3356,19175
29-11-2019,21 - 22,1322,2140,11925,3178,18565
29-11-2019,22 - 23,1341,2035,11479,2974,17829
29-11-2019,23 - 00,1337,1959,10921,2840,17057
30-11-2019,00 - 01,1121,2046,10703,2836,16706
30-11-2019,01 - 02,1188,2062,10470,2804,16524
30-11-2019,02 - 03,1179,2075,10251,2781,16286
30-11-2019,03 - 04,1206,2062,10232,2723,16223
30-11-2019,04 - 05,1176,2137,10347,2722,16382
30-11-2019,05 - 06,1185,2145,10615,2808,16753
30-11-2019,06 - 07,1193,2160,11033,2921,17307
30-11-2019,07 - 08,1126,2183,11611,3184,18104
30-11-2019,08 - 09,1265,2191,12030,3345,18831
30-11-2019,09 - 10,1246,2120,12337,3446,19149
30-11-2019,10 - 11,1324,2112,12418,3458,19312
30-11-2019,11 - 12,1372,2297,12424,3389,19482
30-11-2019,12 - 13,1340,2299,12325,3261,19225
30-11-2019,13 - 14,1421,2233,12151,3174,18979
30-11-2019,14 - 15,1397,2112,12149,3194,18852
30-11-2019,15 - 16,1306,2099,12529,3304,19238
30-11-2019,16 - 17,1361,2210,12932,3575,20078
30-11-2019,17 - 18,1387,2157,13015,3632,20191
30-11-2019,18 - 19,1393,2246,12965,3588,20192
30-11-2019,19 - 20,1301,2251,12785,3512,19849
30-11-2019,20 - 21,1296,2189,12448,3425,19358
30-11-2019,21 - 22,1294,2094,12140,3311,18839
30-11-2019,22 - 23,1280,2047,11857,3218,18402
30-11-2019,23 - 00,1206,2032,11482,3091,17811
01-12-2019,00 - 01,1205,1965,11170,2988,17328
01-12-2019,01 - 02,1196,1843,10842,2938,16819
01-12-2019,02 - 03,1207,1947,10766,2932,16852
01-12-2019,03 - 04,1235,1882,10673,2906,16696
01-12-2019,04 - 05,1251,1874,10558,2909,16592
01-12-2019,05 - 06,1280,1949,10673,2946,16848
01-12-2019,06 - 07,1308,1977,10943,3026,17254
01-12-2019,07 - 08,1364,2125,11447,3079,18015
01-12-2019,08 - 09,1338,2205,11927,3144,18614
01-12-2019,09 - 10,1381,2184,12326,3257,19148
01-12-2019,10 - 11,1364,2158,12536,3294,19352
01-12-2019,11 - 12,1309,2128,12606,3297,19340
01-12-2019,12 - 13,1277,2187,12488,3304,19256
01-12-2019,13 - 14,1317,2114,12382,3239,19052
01-12-2019,14 - 15,1316,2185,12339,3230,19070
01-12-2019,15 - 16,1334,2212,12813,3309,19668
01-12-2019,16 - 17,1360,2236,13055,3424,20075
01-12-2019,17 - 18,1389,2277,13193,3488,20347
01-12-2019,18 - 19,1364,2227,13116,3425,20132
01-12-2019,19 - 20,1256,2199,13020,3282,19757
01-12-2019,20 - 21,1221,2226,12777,3233,19457
01-12-2019,21 - 22,1279,2145,12254,3126,18804
01-12-2019,22 - 23,1244,2138,11775,2934,18091
01-12-2019,23 - 00,1328,2030,11316,2782,17456
02-12-2019,00 - 01,1137,1962,10886,2680,16665
02-12-2019,01 - 02,1170,2024,10781,2566,16541
02-12-2019,02 - 03,1252,2002,10732,2573,16559
02-12-2019,03 - 04,1222,1969,10869,2578,16638
02-12-2019,04 - 05,1220,1871,11223,2634,16948
02-12-2019,05 - 06,1287,2115,12001,2844,18247
02-12-2019,06 - 07,1296,2326,13366,3318,20306
02-12-2019,07 - 08,1365,2227,14595,3732,21919
02-12-2019,08 - 09,1435,2312,14774,3836,22357
02-12-2019,09 - 10,1408,2387,14618,3814,22227
02-12-2019,10 - 11,1335,2392,14624,3862,22213
02-12-2019,11 - 12,1371,2319,14396,3825,21911
02-12-2019,12 - 13,1365,2384,14109,3735,21593
02-12-2019,13 - 14,1403,2318,13980,3786,21487
02-12-2019,14 - 15,1406,2207,14130,3752,21495
02-12-2019,15 - 16,1398,2313,14515,3849,22075
02-12-2019,16 - 17,1408,2360,14752,3970,22490
02-12-2019,17 - 18,1309,2392,14897,3994,22592
02-12-2019,18 - 19,1291,2434,14690,3907,22322
02-12-2019,19 - 20,1258,2269,14297,3862,21686
02-12-2019,20 - 21,1315,2224,13987,3725,21251
02-12-2019,21 - 22,1299,2116,13671,3520,20606
02-12-2019,22 - 23,1201,2025,13133,3326,19685
02-12-2019,23 - 00,1182,2083,12419,3142,18826
03-12-2019,00 - 01,1142,1986,11994,3042,18164
03-12-2019,01 - 02,1065,1948,11858,3018,17889
03-12-2019,02 - 03,1179,1912,11684,3062,17837
03-12-2019,03 - 04,1194,1800,11562,3049,17605
03-12-2019,04 - 05,1252,1991,11738,3065,18046
03-12-2019,05 - 06,1285,2165,12291,3287,19028
03-12-2019,06 - 07,1432,2166,13424,3624,20646
03-12-2019,07 - 08,1331,2172,14471,3871,21845
03-12-2019,08 - 09,1207,1959,14451,3860,21477
03-12-2019,09 - 10,1095,2013,14329,3776,21213
03-12-2019,10 - 11,1284,2101,14392,3770,21547
03-12-2019,11 - 12,1124,2080,14279,3820,21303
03-12-2019,12 - 13,1300,2167,14106,3769,21342
03-12-2019,13 - 14,1253,2239,13809,3758,21059
03-12-2019,14 - 15,1117,2554,13797,3781,21249
03-12-2019,15 - 16,1324,2362,14256,3859,21801
03-12-2019,16 - 17,1276,2191,14364,3865,21696
03-12-2019,17 - 18,1128,2018,14338,3828,21312
03-12-2019,18 - 19,1228,2177,13861,3675,20941
03-12-2019,19 - 20,1146,2046,13369,3552,20113
03-12-2019,20 - 21,1125,2023,12862,3473,19483
03-12-2019,21 - 22,1093,1944,12216,3295,18548
03-12-2019,22 - 23,1099,1865,11424,3079,17467
03-12-2019,23 - 00,1116,1828,10658,2792,16394
04-12-2019,00 - 01,1121,1733,10242,2534,15630
04-12-2019,01 - 02,1066,1813,10155,2487,15521
04-12-2019,02 - 03,1114,1731,9990,2489,15324
04-12-2019,03 - 04,1158,1680,10051,2544,15433
04-12-2019,04 - 05,1120,1772,10329,2528,15749
04-12-2019,05 - 06,1133,2015,10956,2689,16793
04-12-2019,06 - 07,1146,2158,12142,3149,18595
04-12-2019,07 - 08,1312,2147,13220,3578,20257
04-12-2019,08 - 09,1173,2217,13281,3626,20297
04-12-2019,09 - 10,1265,2153,13046,3622,20086
04-12-2019,10 - 11,1439,1852,13078,3718,20087
04-12-2019,11 - 12,1374,2097,12932,3724,20127
04-12-2019,12 - 13,1352,2089,13065,3578,20084
04-12-2019,13 - 14,1338,2135,12890,3594,19957
04-12-2019,14 - 15,1439,2140,12890,3590,20059
04-12-2019,15 - 16,1230,2295,13219,3679,20423
04-12-2019,16 - 17,1168,2433,13304,3718,20623
04-12-2019,17 - 18,1294,2126,13444,3721,20585
04-12-2019,18 - 19,1245,1882,13262,3632,20021
04-12-2019,19 - 20,1220,1802,12869,3571,19462
04-12-2019,20 - 21,1067,1780,12445,3457,18749
04-12-2019,21 - 22,1173,1943,11930,3305,18351
04-12-2019,22 - 23,1060,1808,11208,3083,17159
04-12-2019,23 - 00,1106,1838,10486,2869,16299
05-12-2019,00 - 01,1079,1776,9988,2715,15558
05-12-2019,01 - 02,1030,1586,9814,2606,15036
05-12-2019,02 - 03,1107,1810,9668,2515,15100
05-12-2019,03 - 04,1138,1882,9625,2543,15188
05-12-2019,04 - 05,1216,1641,9715,2680,15252
05-12-2019,05 - 06,1216,1587,10281,2904,15988
05-12-2019,06 - 07,1269,1937,11595,3314,18115
05-12-2019,07 - 08,1299,2048,12623,3627,19597
05-12-2019,08 - 09,1339,1997,12725,3651,19712
05-12-2019,09 - 10,1268,1988,12683,3608,19547
05-12-2019,10 - 11,1212,2073,12573,3682,19540
05-12-2019,11 - 12,1233,2027,12524,3647,19431
05-12-2019,12 - 13,1193,1918,12462,3560,19133
05-12-2019,13 - 14,1145,1952,12468,3582,19147
05-12-2019,14 - 15,1231,2102,12463,3642,19438
05-12-2019,15 - 16,1217,2144,12832,3714,19907
05-12-2019,16 - 17,1270,2093,13010,3802,20175
05-12-2019,17 - 18,1273,2080,13119,3813,20285
05-12-2019,18 - 19,1221,2058,12798,3669,19746
05-12-2019,19 - 20,1370,2036,12417,3577,19400
05-12-2019,20 - 21,1307,2092,12008,3454,18861
05-12-2019,21 - 22,1172,2043,11359,3258,17832
05-12-2019,22 - 23,1137,1876,10540,3044,16597
05-12-2019,23 - 00,1170,1782,9871,2789,15612
06-12-2019,00 - 01,1103,1670,9515,2696,14984
06-12-2019,01 - 02,1124,1628,9299,2655,14706
06-12-2019,02 - 03,1116,1767,9211,2638,14732
06-12-2019,03 - 04,1164,1874,9186,2659,14883
06-12-2019,04 - 05,1211,1852,9278,2684,15025
06-12-2019,05 - 06,1348,1957,9777,2851,15933
06-12-2019,06 - 07,1430,2051,11000,3271,17752
06-12-2019,07 - 08,1688,2218,12070,3618,19594
06-12-2019,08 - 09,1475,2324,12314,3673,19786
06-12-2019,09 - 10,1162,2165,12317,3623,19267
06-12-2019,10 - 11,1331,2204,12224,3600,19359
06-12-2019,11 - 12,1479,2210,12131,3586,19406
06-12-2019,12 - 13,1393,2035,11985,3495,18908
06-12-2019,13 - 14,1323,2066,11871,3504,18764
06-12-2019,14 - 15,1348,2138,11807,3428,18721
06-12-2019,15 - 16,1456,2253,12237,3540,19486
06-12-2019,16 - 17,1437,2207,12523,3608,19775
06-12-2019,17 - 18,1366,2186,12509,3621,19682
06-12-2019,18 - 19,1312,2035,12064,3487,18898
06-12-2019,19 - 20,1379,2032,11504,3319,18234
06-12-2019,20 - 21,1327,2009,10970,3162,17468
06-12-2019,21 - 22,1199,1858,10376,2983,16416
06-12-2019,22 - 23,1154,1629,9894,2836,15513
06-12-2019,23 - 00,1173,1551,9512,2681,14917
07-12-2019,00 - 01,1100,1628,9058,2563,14349
07-12-2019,01 - 02,1127,1631,8795,2474,14027
07-12-2019,02 - 03,1163,1761,8719,2427,14070
07-12-2019,03 - 04,1182,1799,8692,2440,14113
07-12-2019,04 - 05,1153,1938,8455,2431,13977
07-12-2019,05 - 06,1199,2033,8508,2514,14254
07-12-2019,06 - 07,1245,1992,8936,2621,14794
07-12-2019,07 - 08,1299,2035,9507,2834,15675
07-12-2019,08 - 09,1407,1964,9999,2887,16257
07-12-2019,09 - 10,1323,1948,10373,2891,16535
07-12-2019,10 - 11,1333,2085,10733,3024,17175
07-12-2019,11 - 12,1213,2039,10820,3018,17090
07-12-2019,12 - 13,1250,1988,11040,2979,17257
07-12-2019,13 - 14,1310,1930,11092,2945,17277
07-12-2019,14 - 15,1304,1939,11201,3005,17449
07-12-2019,15 - 16,1300,1934,11582,3111,17927
07-12-2019,16 - 17,1355,1938,11820,3273,18386
07-12-2019,17 - 18,1307,2041,11966,3339,18653
07-12-2019,18 - 19,1232,1982,11879,3296,18389
07-12-2019,19 - 20,1286,1849,11604,3273,18012
07-12-2019,20 - 21,1263,1743,11288,3123,17417
07-12-2019,21 - 22,1255,1727,10847,2974,16803
07-12-2019,22 - 23,1176,1845,10576,2836,16433
07-12-2019,23 - 00,1159,1725,10237,2760,15881
08-12-2019,00 - 01,1260,1559,9934,2652,15405
08-12-2019,01 - 02,1184,1609,9824,2541,15158
08-12-2019,02 - 03,1188,1630,9858,2493,15169
08-12-2019,03 - 04,1278,1631,9755,2401,15065
08-12-2019,04 - 05,1343,1662,9763,2388,15156
08-12-2019,05 - 06,1399,1777,9899,2419,15494
08-12-2019,06 - 07,1415,2146,9945,2527,16033
08-12-2019,07 - 08,1414,2232,10250,2622,16518
08-12-2019,08 - 09,1409,2398,10603,2748,17158
08-12-2019,09 - 10,1455,2343,10995,2854,17647
08-12-2019,10 - 11,1415,2129,11307,3069,17920
08-12-2019,11 - 12,1392,1990,11624,3173,18179
08-12-2019,12 - 13,1417,1949,11712,3178,18256
08-12-2019,13 - 14,1417,1736,11670,3177,18000
08-12-2019,14 - 15,1449,1724,11681,3129,17983
08-12-2019,15 - 16,1450,2004,11931,3121,18506
08-12-2019,16 - 17,1504,2044,12019,3224,18791
08-12-2019,17 - 18,1509,2201,12114,3243,19067
08-12-2019,18 - 19,1218,2052,11772,3262,18304
08-12-2019,19 - 20,1428,1897,11437,3154,17916
08-12-2019,20 - 21,1413,1728,11149,3043,17333
08-12-2019,21 - 22,1392,1815,10725,2935,16867
08-12-2019,22 - 23,1420,1942,10373,2749,16484
08-12-2019,23 - 00,1415,1887,9990,2643,15935
09-12-2019,00 - 01,1486,1752,9665,2626,15529
09-12-2019,01 - 02,1551,1756,9468,2579,15354
09-12-2019,02 - 03,1508,1743,9435,2591,15277
09-12-2019,03 - 04,1499,1781,9323,2584,15187
09-12-2019,04 - 05,1609,1812,9307,2656,15384
09-12-2019,05 - 06,1611,1888,9844,2772,16115
09-12-2019,06 - 07,1783,2201,11045,3130,18159
09-12-2019,07 - 08,1776,2280,12106,3567,19729
09-12-2019,08 - 09,1726,2343,12325,3692,20086
09-12-2019,09 - 10,1527,2423,12238,3697,19885
09-12-2019,10 - 11,1513,2301,12368,3740,19922
09-12-2019,11 - 12,1534,2272,12311,3725,19842
09-12-2019,12 - 13,1496,2344,12294,3671,19805
09-12-2019,13 - 14,1457,2277,12291,3608,19633
09-12-2019,14 - 15,1379,2098,12514,3622,19613
09-12-2019,15 - 16,1389,2288,12878,3662,20217
09-12-2019,16 - 17,1428,2264,13023,3687,20402
09-12-2019,17 - 18,1502,2218,13056,3739,20515
09-12-2019,18 - 19,1503,2130,12754,3566,19953
09-12-2019,19 - 20,1541,2152,12650,3477,19820
09-12-2019,20 - 21,1497,2050,12324,3269,19140
09-12-2019,21 - 22,1407,1887,11833,3163,18290
09-12-2019,22 - 23,1395,1965,11277,2998,17635
09-12-2019,23 - 00,1290,1974,10603,2772,16639
10-12-2019,00 - 01,1311,1958,10403,2763,16435
10-12-2019,01 - 02,1236,1914,10352,2695,16197
10-12-2019,02 - 03,1400,2006,10510,2749,16665
10-12-2019,03 - 04,1393,1970,10663,2891,16917
10-12-2019,04 - 05,1304,2121,10842,2981,17248
10-12-2019,05 - 06,1415,2250,11388,3267,18320
10-12-2019,06 - 07,1624,2457,12830,3677,20588
10-12-2019,07 - 08,1664,2660,14063,4110,22497
10-12-2019,08 - 09,1761,2686,14258,4089,22794
10-12-2019,09 - 10,1780,2671,14362,4051,22864
10-12-2019,10 - 11,1688,2613,14398,4107,22806
10-12-2019,11 - 12,1581,2687,14178,3950,22396
10-12-2019,12 - 13,1703,2739,13917,3886,22245
10-12-2019,13 - 14,1602,2432,13713,3873,21620
10-12-2019,14 - 15,1640,2420,13792,3824,21676
10-12-2019,15 - 16,1690,2402,14173,3947,22212
10-12-2019,16 - 17,1705,2043,14337,3997,22082
10-12-2019,17 - 18,1651,2013,14490,4014,22168
10-12-2019,18 - 19,1562,2054,14168,3892,21676
10-12-2019,19 - 20,1482,2130,13629,3720,20961
10-12-2019,20 - 21,1350,2072,13085,3537,20044
10-12-2019,21 - 22,1194,1999,12601,3337,19131
10-12-2019,22 - 23,1308,1962,11890,3169,18329
10-12-2019,23 - 00,1155,1899,11193,2999,17246
11-12-2019,00 - 01,1244,1866,10793,2892,16795
11-12-2019,01 - 02,1240,1837,10594,2819,16490
11-12-2019,02 - 03,1245,1838,10504,2791,16378
11-12-2019,03 - 04,1258,1834,10459,2842,16393
11-12-2019,04 - 05,1307,1948,10539,2889,16683
11-12-2019,05 - 06,1291,1871,10997,3072,17231
11-12-2019,06 - 07,1439,2129,12245,3451,19264
11-12-2019,07 - 08,1474,2237,13249,3821,20781
11-12-2019,08 - 09,1323,2246,13533,4003,21105
11-12-2019,09 - 10,1381,2188,13364,4027,20960
11-12-2019,10 - 11,1344,2204,13449,4162,21159
11-12-2019,11 - 12,1354,2132,13570,4150,21206
11-12-2019,12 - 13,1382,2286,13513,4040,21221
11-12-2019,13 - 14,1331,2197,13298,3999,20825
11-12-2019,14 - 15,1262,2038,13238,3990,20528
11-12-2019,15 - 16,1274,2093,13575,4012,20954
11-12-2019,16 - 17,1341,2129,13670,4016,21156
11-12-2019,17 - 18,1296,2055,13641,3996,20988
11-12-2019,18 - 19,1283,2180,13300,3866,20629
11-12-2019,19 - 20,1312,2170,12917,3766,20165
11-12-2019,20 - 21,1296,2045,12516,3615,19472
11-12-2019,21 - 22,1249,2052,12029,3415,18745
11-12-2019,22 - 23,1192,2001,11260,3207,17660
11-12-2019,23 - 00,1230,1875,10595,2992,16692
12-12-2019,00 - 01,1068,1705,10095,2830,15698
12-12-2019,01 - 02,1193,1730,9832,2775,15530
12-12-2019,02 - 03,1174,1603,9707,2747,15231
12-12-2019,03 - 04,1168,1610,9704,2741,15223
12-12-2019,04 - 05,1300,1775,9829,2767,15671
12-12-2019,05 - 06,1391,1918,10445,2955,16709
12-12-2019,06 - 07,1179,2046,11752,3395,18372
12-12-2019,07 - 08,1139,2005,12714,3746,19604
12-12-2019,08 - 09,1217,2181,13016,3867,20281
12-12-2019,09 - 10,1176,2233,13012,3845,20266
12-12-2019,10 - 11,1160,2340,13352,3876,20728
12-12-2019,11 - 12,1082,2104,13281,3866,20333
12-12-2019,12 - 13,1214,2078,13286,3837,20415
12-12-2019,13 - 14,1260,2306,13268,3833,20667
12-12-2019,14 - 15,1287,2275,13250,3795,20607
12-12-2019,15 - 16,1171,2167,13643,3858,20839
12-12-2019,16 - 17,1393,2150,13758,3843,21144
12-12-2019,17 - 18,1378,2181,13762,3906,21227
12-12-2019,18 - 19,1194,2126,13493,3781,20594
12-12-2019,19 - 20,1149,2106,13071,3653,19979
12-12-2019,20 - 21,1193,2165,12656,3487,19501
12-12-2019,21 - 22,1324,2127,11974,3366,18791
12-12-2019,22 - 23,1263,2022,11347,3152,17784
12-12-2019,23 - 00,1255,1936,10738,2941,16870
13-12-2019,00 - 01,1290,1957,10420,2804,16471
13-12-2019,01 - 02,1235,1852,10146,2767,16000
13-12-2019,02 - 03,1326,1930,10055,2722,16033
13-12-2019,03 - 04,1339,1930,10166,2751,16186
13-12-2019,04 - 05,1449,1955,10344,2784,16532
13-12-2019,05 - 06,1290,2183,10916,2972,17361
13-12-2019,06 - 07,1414,2306,12092,3372,19184
13-12-2019,07 - 08,1538,2508,13126,3784,20956
13-12-2019,08 - 09,1589,2307,13337,3937,21170
13-12-2019,09 - 10,1497,2403,13136,3898,20934
13-12-2019,10 - 11,1371,2289,13108,3872,20640
13-12-2019,11 - 12,1370,2274,13057,3843,20544
13-12-2019,12 - 13,1387,2259,13039,3830,20515
13-12-2019,13 - 14,1411,2182,12885,3842,20320
13-12-2019,14 - 15,1416,2138,12807,3795,20156
13-12-2019,15 - 16,1381,2295,13059,3873,20608
13-12-2019,16 - 17,1349,2320,13050,3867,20586
13-12-2019,17 - 18,1306,2246,12919,3801,20272
13-12-2019,18 - 19,1304,2156,12580,3695,19735
13-12-2019,19 - 20,1314,2091,12087,3532,19024
13-12-2019,20 - 21,1310,2169,11554,3412,18445
13-12-2019,21 - 22,1163,2070,11151,3281,17665
13-12-2019,22 - 23,1090,1948,10630,3086,16754
13-12-2019,23 - 00,1214,1846,10149,2874,16083
14-12-2019,00 - 01,1317,1832,9620,2659,15428
14-12-2019,01 - 02,1181,1749,9386,2577,14893
14-12-2019,02 - 03,1128,1680,9245,2583,14636
14-12-2019,03 - 04,1148,1659,9250,2614,14671
14-12-2019,04 - 05,1202,1715,9245,2586,14748
14-12-2019,05 - 06,1298,1722,9336,2597,14953
14-12-2019,06 - 07,1380,1906,9663,2704,15653
14-12-2019,07 - 08,1315,2044,10103,2862,16324
14-12-2019,08 - 09,1419,2249,10677,3039,17384
14-12-2019,09 - 10,1425,2223,11127,3170,17945
14-12-2019,10 - 11,1476,2212,11605,3343,18636
14-12-2019,11 - 12,1462,2239,11790,3408,18899
14-12-2019,12 - 13,1449,2259,11797,3408,18913
14-12-2019,13 - 14,1511,2194,11766,3397,18868
14-12-2019,14 - 15,1476,2391,11803,3367,19037
14-12-2019,15 - 16,1515,2485,11952,3381,19333
14-12-2019,16 - 17,1545,2530,12081,3518,19674
14-12-2019,17 - 18,1537,2386,12093,3522,19538
14-12-2019,18 - 19,1465,2351,11907,3442,19165
14-12-2019,19 - 20,1479,2266,11510,3295,18550
14-12-2019,20 - 21,1423,2307,11116,3153,17999
14-12-2019,21 - 22,1442,2074,10707,3018,17241
14-12-2019,22 - 23,1356,2048,10236,2923,16563
14-12-2019,23 - 00,1374,1974,9883,2798,16029
15-12-2019,00 - 01,1291,1893,9526,2671,15381
15-12-2019,01 - 02,1265,2064,9170,2602,15101
15-12-2019,02 - 03,1259,2044,9026,2557,14886
15-12-2019,03 - 04,1286,1955,8992,2548,14781
15-12-2019,04 - 05,1257,1977,8989,2548,14771
15-12-2019,05 - 06,1228,1928,9109,2643,14908
15-12-2019,06 - 07,1226,1955,9375,2729,15285
15-12-2019,07 - 08,1364,2076,9701,2827,15968
15-12-2019,08 - 09,1307,2144,10143,2995,16589
15-12-2019,09 - 10,1311,2190,10625,3044,17170
15-12-2019,10 - 11,1343,2257,11038,3158,17796
15-12-2019,11 - 12,1385,2262,11241,3227,18115
15-12-2019,12 - 13,1366,2245,11341,3282,18234
15-12-2019,13 - 14,1374,2254,11322,3322,18272
15-12-2019,14 - 15,1387,2296,11521,3373,18577
15-12-2019,15 - 16,1401,2343,11805,3334,18883
15-12-2019,16 - 17,1411,2344,11939,3474,19168
15-12-2019,17 - 18,1432,2383,12087,3543,19445
15-12-2019,18 - 19,1384,2378,12153,3529,19444
15-12-2019,19 - 20,1342,2190,11999,3455,18986
15-12-2019,20 - 21,1265,2264,11791,3347,18667
15-12-2019,21 - 22,1272,2097,11377,3127,17873
15-12-2019,22 - 23,1265,2031,10749,2919,16964
15-12-2019,23 - 00,1260,1905,10205,2802,16172
16-12-2019,00 - 01,1222,1837,9711,2702,15472
16-12-2019,01 - 02,1218,1880,9535,2633,15266
16-12-2019,02 - 03,1231,1885,9417,2610,15143
16-12-2019,03 - 04,1280,1925,9490,2676,15371
16-12-2019,04 - 05,1258,1955,9560,2718,15491
16-12-2019,05 - 06,1343,1940,10068,2850,16201
16-12-2019,06 - 07,1343,2122,11345,3252,18062
16-12-2019,07 - 08,1436,2302,12621,3696,20055
16-12-2019,08 - 09,1434,2304,12840,3764,20342
16-12-2019,09 - 10,1448,2363,12694,3684,20189
16-12-2019,10 - 11,1390,2299,12858,3710,20257
16-12-2019,11 - 12,1361,2305,12938,3696,20300
16-12-2019,12 - 13,1413,2476,13013,3637,20539
16-12-2019,13 - 14,1430,2505,13024,3657,20616
16-12-2019,14 - 15,1431,2448,12934,3616,20429
16-12-2019,15 - 16,1441,2501,13299,3724,20965
16-12-2019,16 - 17,1386,2581,13401,3767,21135
16-12-2019,17 - 18,1388,2583,13411,3798,21180
16-12-2019,18 - 19,1392,2485,12948,3690,20515
16-12-2019,19 - 20,1352,2318,12464,3605,19739
16-12-2019,20 - 21,1294,2195,11862,3447,18798
16-12-2019,21 - 22,1260,2221,11334,3254,18069
16-12-2019,22 - 23,1195,2110,10571,3014,16890
16-12-2019,23 - 00,1218,2000,10014,2772,16004
17-12-2019,00 - 01,1192,1869,9531,2597,15189
17-12-2019,01 - 02,1200,1834,9271,2546,14851
17-12-2019,02 - 03,1184,1845,8988,2545,14562
17-12-2019,03 - 04,1186,1848,9267,2549,14850
17-12-2019,04 - 05,1156,1882,9391,2596,15025
17-12-2019,05 - 06,1239,1943,9956,2754,15892
17-12-2019,06 - 07,1356,2045,11213,3158,17772
17-12-2019,07 - 08,1419,2259,12390,3558,19626
17-12-2019,08 - 09,1452,2399,12753,3727,20331
17-12-2019,09 - 10,1450,2315,12598,3648,20011
17-12-2019,10 - 11,1379,2333,12630,3651,19993
17-12-2019,11 - 12,1369,2381,12601,3605,19956
17-12-2019,12 - 13,1441,2272,12562,3527,19802
17-12-2019,13 - 14,1458,2176,12460,3630,19724
17-12-2019,14 - 15,1464,2341,12705,3602,20112
17-12-2019,15 - 16,1372,2430,13158,3643,20603
17-12-2019,16 - 17,1469,2484,12999,3688,20640
17-12-2019,17 - 18,1502,2417,13039,3602,20560
17-12-2019,18 - 19,1437,2347,12722,3492,19998
17-12-2019,19 - 20,1235,2295,12423,3367,19320
17-12-2019,20 - 21,1317,2127,11772,3194,18410
17-12-2019,21 - 22,1361,2082,11211,2939,17593
17-12-2019,22 - 23,1336,2063,10635,2819,16853
17-12-2019,23 - 00,1222,2016,9905,2660,15803
18-12-2019,00 - 01,1104,2006,9538,2610,15258
18-12-2019,01 - 02,1041,2034,9262,2535,14872
18-12-2019,02 - 03,1154,2021,9267,2409,14851
18-12-2019,03 - 04,1218,2029,9258,2457,14962
18-12-2019,04 - 05,1302,2127,9400,2418,15247
18-12-2019,05 - 06,1342,2179,9968,2576,16065
18-12-2019,06 - 07,1539,2472,11102,2936,18049
18-12-2019,07 - 08,1429,2616,12203,3406,19654
18-12-2019,08 - 09,1537,2533,12508,3602,20180
18-12-2019,09 - 10,1499,2543,12522,3617,20181
18-12-2019,10 - 11,1526,2539,12742,3683,20490
18-12-2019,11 - 12,1591,2374,12693,3600,20258
18-12-2019,12 - 13,1573,2322,12580,3493,19968
18-12-2019,13 - 14,1547,2279,12477,3457,19760
18-12-2019,14 - 15,1494,2214,12610,3435,19753
18-12-2019,15 - 16,1523,2198,13023,3582,20326
18-12-2019,16 - 17,1502,2119,13166,3657,20444
18-12-2019,17 - 18,1430,2117,13219,3600,20366
18-12-2019,18 - 19,1533,2190,12989,3518,20230
18-12-2019,19 - 20,1465,2108,12680,3534,19787
18-12-2019,20 - 21,1375,1970,12259,3357,18961
18-12-2019,21 - 22,1224,2027,11806,3237,18294
18-12-2019,22 - 23,1184,1930,11207,3001,17322
18-12-2019,23 - 00,1231,1788,10570,2726,16315
19-12-2019,00 - 01,1295,1779,10159,2639,15872
19-12-2019,01 - 02,1298,1708,9963,2639,15608
19-12-2019,02 - 03,1254,1891,9886,2649,15680
19-12-2019,03 - 04,1243,1935,9973,2701,15852
19-12-2019,04 - 05,1304,1942,10147,2703,16096
19-12-2019,05 - 06,1405,1883,10616,2905,16809
19-12-2019,06 - 07,1609,2133,11750,3252,18744
19-12-2019,07 - 08,1501,2305,13015,3641,20462
19-12-2019,08 - 09,1397,2394,13472,3713,20976
19-12-2019,09 - 10,1524,2441,13277,3636,20878
19-12-2019,10 - 11,1516,2552,13204,3573,20845
19-12-2019,11 - 12,1423,2377,13066,3461,20327
19-12-2019,12 - 13,1335,2295,12808,3401,19839
19-12-2019,13 - 14,1402,2315,12825,3359,19901
19-12-2019,14 - 15,1526,2257,12937,3398,20118
19-12-2019,15 - 16,1461,2304,13209,3521,20495
19-12-2019,16 - 17,1547,2162,13181,3641,20531
19-12-2019,17 - 18,1650,2145,13172,3609,20576
19-12-2019,18 - 19,1686,1907,12793,3517,19903
19-12-2019,19 - 20,1540,1916,12297,3498,19251
19-12-2019,20 - 21,1339,1867,11862,3334,18402
19-12-2019,21 - 22,1376,1658,11412,3139,17585
19-12-2019,22 - 23,1464,1828,10889,2926,17107
19-12-2019,23 - 00,1205,1713,10116,2778,15812
20-12-2019,00 - 01,1138,1666,9518,2719,15041
20-12-2019,01 - 02,1130,1842,9165,2618,14755
20-12-2019,02 - 03,1287,1978,8930,2541,14736
20-12-2019,03 - 04,1445,2069,8899,2526,14939
20-12-2019,04 - 05,1384,2124,9023,2563,15094
20-12-2019,05 - 06,1410,2076,9441,2680,15607
20-12-2019,06 - 07,1506,2262,10614,2977,17359
20-12-2019,07 - 08,1579,2506,11600,3379,19064
20-12-2019,08 - 09,1544,2465,11937,3547,19493
20-12-2019,09 - 10,1520,2471,11868,3491,19350
20-12-2019,10 - 11,1523,2355,11867,3466,19211
20-12-2019,11 - 12,1603,2300,11767,3493,19163
20-12-2019,12 - 13,1593,2285,11681,3466,19025
20-12-2019,13 - 14,1603,2236,11598,3398,18835
20-12-2019,14 - 15,1573,2262,11639,3359,18833
20-12-2019,15 - 16,1586,2328,11897,3435,19246
20-12-2019,16 - 17,1527,2256,11958,3486,19227
20-12-2019,17 - 18,1532,2263,11912,3428,19135
20-12-2019,18 - 19,1528,2136,11588,3347,18599
20-12-2019,19 - 20,1436,2077,11087,3235,17835
20-12-2019,20 - 21,1412,2145,10577,2979,17113
20-12-2019,21 - 22,1375,1991,10134,2818,16318
20-12-2019,22 - 23,1375,1897,9617,2709,15598
20-12-2019,23 - 00,1381,1836,9084,2596,14897
21-12-2019,00 - 01,1288,1886,8828,2451,14453
21-12-2019,01 - 02,1284,1881,8642,2350,14157
21-12-2019,02 - 03,1303,1814,8434,2277,13828
21-12-2019,03 - 04,1313,1992,8360,2282,13947
21-12-2019,04 - 05,1353,2032,8360,2273,14018
21-12-2019,05 - 06,1361,1889,8452,2279,13981
21-12-2019,06 - 07,1284,1911,8794,2328,14317
21-12-2019,07 - 08,1326,1981,9222,2472,15001
21-12-2019,08 - 09,1399,2169,9824,2659,16051
21-12-2019,09 - 10,1355,2306,10269,2784,16714
21-12-2019,10 - 11,1371,2242,10567,2873,17053
21-12-2019,11 - 12,1347,2262,10776,2888,17273
21-12-2019,12 - 13,1389,2251,10777,2917,17334
21-12-2019,13 - 14,1411,2320,10738,2902,17371
21-12-2019,14 - 15,1407,2310,10839,2883,17439
21-12-2019,15 - 16,1418,2234,10918,2944,17514
21-12-2019,16 - 17,1425,2364,11090,3162,18041
21-12-2019,17 - 18,1392,2255,11098,3222,17967
21-12-2019,18 - 19,1340,2126,10904,3113,17483
21-12-2019,19 - 20,1288,2097,10555,2929,16869
21-12-2019,20 - 21,1325,2149,10188,2813,16475
21-12-2019,21 - 22,1238,1963,9796,2721,15718
21-12-2019,22 - 23,1192,1977,9351,2618,15138
21-12-2019,23 - 00,1238,1947,8946,2520,14651
22-12-2019,00 - 01,1249,1805,8583,2381,14018
22-12-2019,01 - 02,1253,1868,8371,2261,13753
22-12-2019,02 - 03,1242,1855,8272,2200,13569
22-12-2019,03 - 04,1233,1815,8197,2209,13454
22-12-2019,04 - 05,1204,1771,8233,2191,13399
22-12-2019,05 - 06,1223,1781,8377,2208,13589
22-12-2019,06 - 07,1319,1894,8612,2295,14120
22-12-2019,07 - 08,1343,1981,8989,2422,14735
22-12-2019,08 - 09,1329,2030,9471,2555,15385
22-12-2019,09 - 10,1377,2089,10040,2726,16232
22-12-2019,10 - 11,1420,2147,10488,2896,16951
22-12-2019,11 - 12,1421,2192,10735,3001,17349
22-12-2019,12 - 13,1426,2203,10739,3059,17427
22-12-2019,13 - 14,1288,2331,10711,2996,17326
22-12-2019,14 - 15,1413,2226,10805,2967,17411
22-12-2019,15 - 16,1448,2317,11150,3062,17977
22-12-2019,16 - 17,1442,2257,11326,3195,18220
22-12-2019,17 - 18,1393,2215,11369,3229,18206
22-12-2019,18 - 19,1383,2238,11170,3148,17939
22-12-2019,19 - 20,1474,2127,10880,3006,17487
22-12-2019,20 - 21,1368,2072,10474,2854,16768
22-12-2019,21 - 22,1268,2033,10040,2757,16098
22-12-2019,22 - 23,1295,1971,9553,2611,15430
22-12-2019,23 - 00,1274,1854,9188,2443,14759
23-12-2019,00 - 01,1253,1894,8798,2361,14306
23-12-2019,01 - 02,1248,1818,8574,2327,13967
23-12-2019,02 - 03,1266,1794,8580,2297,13937
23-12-2019,03 - 04,1274,1807,8584,2220,13885
23-12-2019,04 - 05,1213,1786,8716,2223,13938
23-12-2019,05 - 06,1213,1737,9029,2319,14298
23-12-2019,06 - 07,1202,1858,9648,2509,15217
23-12-2019,07 - 08,1243,2085,10418,2757,16503
23-12-2019,08 - 09,1262,2284,10986,2952,17484
23-12-2019,09 - 10,1366,2255,11266,3026,17913
23-12-2019,10 - 11,1274,2216,11481,3068,18039
23-12-2019,11 - 12,1310,2235,11574,3113,18232
23-12-2019,12 - 13,1276,2257,11584,3109,18226
23-12-2019,13 - 14,1369,2261,11544,3119,18293
23-12-2019,14 - 15,1369,2220,11629,3146,18364
23-12-2019,15 - 16,1374,2241,11886,3188,18689
23-12-2019,16 - 17,1386,2292,12016,3264,18958
23-12-2019,17 - 18,1353,2292,12051,3292,18988
23-12-2019,18 - 19,1351,2232,11761,3178,18522
23-12-2019,19 - 20,1316,2166,11265,2994,17741
23-12-2019,20 - 21,1316,2076,10715,2832,16939
23-12-2019,21 - 22,1327,2029,10226,2668,16250
23-12-2019,22 - 23,1172,1993,9708,2517,15390
23-12-2019,23 - 00,1276,1847,9330,2412,14865
24-12-2019,00 - 01,1230,1810,8892,2284,14216
24-12-2019,01 - 02,1230,1769,8619,2214,13832
24-12-2019,02 - 03,1186,1803,8516,2175,13680
24-12-2019,03 - 04,1144,1777,8483,2139,13543
24-12-2019,04 - 05,1158,1803,8533,2188,13682
24-12-2019,05 - 06,1167,1760,8674,2218,13819
24-12-2019,06 - 07,1189,1836,8992,2320,14337
24-12-2019,07 - 08,1230,1895,9464,2458,15047
24-12-2019,08 - 09,1286,2051,10010,2641,15988
24-12-2019,09 - 10,1301,2100,10402,2756,16559
24-12-2019,10 - 11,1250,2042,10680,2828,16800
24-12-2019,11 - 12,1294,2152,10783,2889,17118
24-12-2019,12 - 13,1268,2131,10778,2879,17056
24-12-2019,13 - 14,1263,2124,10597,2822,16806
24-12-2019,14 - 15,1330,2230,10403,2776,16739
24-12-2019,15 - 16,1335,2309,10472,2811,16927
24-12-2019,16 - 17,1354,2298,10346,2882,16880
24-12-2019,17 - 18,1537,2257,10101,2839,16734
24-12-2019,18 - 19,1223,2169,9869,2713,15974
24-12-2019,19 - 20,1152,2051,9763,2597,15563
24-12-2019,20 - 21,1130,2053,9633,2538,15354
24-12-2019,21 - 22,1221,2039,9469,2492,15221
24-12-2019,22 - 23,1221,2088,9222,2467,14998
24-12-2019,23 - 00,1196,2053,8990,2393,14632
25-12-2019,00 - 01,1215,2009,8728,2294,14246
25-12-2019,01 - 02,1203,1957,8512,2238,13910
25-12-2019,02 - 03,1151,1943,8392,2200,13686
25-12-2019,03 - 04,1147,1936,8355,2196,13634
25-12-2019,04 - 05,1107,1864,8373,2210,13554
25-12-2019,05 - 06,1270,1900,8557,2261,13988
25-12-2019,06 - 07,1257,1966,8890,2369,14482
25-12-2019,07 - 08,1201,2053,9170,2476,14900
25-12-2019,08 - 09,1203,2135,9452,2558,15348
25-12-2019,09 - 10,1274,2143,9692,2633,15742
25-12-2019,10 - 11,1207,2191,10073,2712,16183
25-12-2019,11 - 12,1245,2268,10299,2786,16598
25-12-2019,12 - 13,1307,2318,10452,2828,16905
25-12-2019,13 - 14,1269,2253,10489,2837,16848
25-12-2019,14 - 15,1230,2296,10583,2818,16927
25-12-2019,15 - 16,1259,2273,10889,2863,17284
25-12-2019,16 - 17,1277,2357,11015,2969,17618
25-12-2019,17 - 18,1256,2351,11055,2987,17649
25-12-2019,18 - 19,1284,2278,10888,2976,17426
25-12-2019,19 - 20,1237,2169,10648,2850,16904
25-12-2019,20 - 21,1232,2179,10396,2766,16573
25-12-2019,21 - 22,1187,2225,10109,2696,16217
25-12-2019,22 - 23,1164,2069,9766,2604,15603
25-12-2019,23 - 00,1238,2076,9463,2498,15275
26-12-2019,00 - 01,1212,2020,9170,2378,14780
26-12-2019,01 - 02,1151,2030,8951,2324,14456
26-12-2019,02 - 03,1174,1928,8854,2289,14245
26-12-2019,03 - 04,1217,2008,8852,2295,14372
26-12-2019,04 - 05,1240,2019,8929,2336,14524
26-12-2019,05 - 06,1236,1989,9114,2396,14735
26-12-2019,06 - 07,1261,2087,9488,2503,15339
26-12-2019,07 - 08,1249,2116,9855,2634,15854
26-12-2019,08 - 09,1275,2227,10252,2737,16491
26-12-2019,09 - 10,1320,2298,10587,2891,17096
26-12-2019,10 - 11,1269,2385,10999,2982,17635
26-12-2019,11 - 12,1311,2422,11215,3040,17988
26-12-2019,12 - 13,1349,2396,11303,3091,18139
26-12-2019,13 - 14,1352,2290,11296,3086,18024
26-12-2019,14 - 15,1341,2403,11388,3100,18232
26-12-2019,15 - 16,1299,2445,11758,3181,18683
26-12-2019,16 - 17,1297,2450,11964,3315,19026
26-12-2019,17 - 18,1282,2422,11948,3352,19004
26-12-2019,18 - 19,1349,2422,11794,3257,18822
26-12-2019,19 - 20,1302,2349,11611,3192,18454
26-12-2019,20 - 21,1300,2236,11264,3095,17895
26-12-2019,21 - 22,1285,2253,10855,2979,17372
26-12-2019,22 - 23,1187,2306,10463,2827,16783
26-12-2019,23 - 00,1166,2067,10078,2674,15985
27-12-2019,00 - 01,1165,1949,9822,2582,15518
27-12-2019,01 - 02,1151,1967,9615,2503,15236
27-12-2019,02 - 03,1162,1912,9535,2462,15071
27-12-2019,03 - 04,1225,1965,9559,2466,15215
27-12-2019,04 - 05,1237,1914,9589,2521,15261
27-12-2019,05 - 06,1200,1942,9913,2618,15673
27-12-2019,06 - 07,1135,2051,10606,2893,16685
27-12-2019,07 - 08,1190,2172,11381,3211,17954
27-12-2019,08 - 09,1236,2409,11857,3365,18867
27-12-2019,09 - 10,1382,2390,12070,3392,19234
27-12-2019,10 - 11,1374,2440,12322,3413,19549
27-12-2019,11 - 12,1381,2387,12432,3412,19612
27-12-2019,12 - 13,1370,2408,12433,3329,19540
27-12-2019,13 - 14,1409,2438,12453,3308,19608
27-12-2019,14 - 15,1390,2470,12556,3329,19745
27-12-2019,15 - 16,1427,2568,12883,3418,20296
27-12-2019,16 - 17,1503,2530,13095,3538,20666
27-12-2019,17 - 18,1497,2554,13109,3585,20745
27-12-2019,18 - 19,1483,2553,12899,3568,20503
27-12-2019,19 - 20,1501,2571,12508,3491,20071
27-12-2019,20 - 21,1503,2480,12041,3384,19408
27-12-2019,21 - 22,1419,2208,11623,3191,18441
27-12-2019,22 - 23,1316,2119,11204,3041,17680
27-12-2019,23 - 00,1252,1981,10836,2945,17014
28-12-2019,00 - 01,1173,2079,10513,2858,16623
28-12-2019,01 - 02,1079,2045,10314,2802,16240
28-12-2019,02 - 03,989,2107,10206,2785,16087
28-12-2019,03 - 04,1003,2180,10307,2817,16307
28-12-2019,04 - 05,1032,2198,10335,2841,16406
28-12-2019,05 - 06,1022,2143,10561,2885,16611
28-12-2019,06 - 07,1045,2089,10782,2992,16908
28-12-2019,07 - 08,1045,2237,11183,3167,17632
28-12-2019,08 - 09,1271,2544,11678,3298,18791
28-12-2019,09 - 10,1245,2612,12121,3445,19423
28-12-2019,10 - 11,1400,2688,12403,3517,20008
28-12-2019,11 - 12,1342,2487,12403,3485,19717
28-12-2019,12 - 13,1335,2423,12354,3468,19580
28-12-2019,13 - 14,1346,2436,12303,3419,19504
28-12-2019,14 - 15,1297,2598,12427,3411,19733
28-12-2019,15 - 16,1292,2505,12861,3536,20194
28-12-2019,16 - 17,1355,2450,12984,3721,20510
28-12-2019,17 - 18,1391,2434,12880,3771,20476
28-12-2019,18 - 19,1364,2343,12519,3705,19931
28-12-2019,19 - 20,1336,2308,12275,3549,19468
28-12-2019,20 - 21,1324,2226,11980,3402,18932
28-12-2019,21 - 22,1356,2185,11524,3228,18293
28-12-2019,22 - 23,1246,2045,10966,3134,17391
28-12-2019,23 - 00,1058,1956,10430,2957,16401
29-12-2019,00 - 01,1035,1915,10127,2815,15892
29-12-2019,01 - 02,1144,1931,9770,2738,15583
29-12-2019,02 - 03,1212,1871,9565,2673,15321
29-12-2019,03 - 04,1220,1968,9452,2607,15247
29-12-2019,04 - 05,1279,2099,9421,2647,15446
29-12-2019,05 - 06,1314,2071,9458,2697,15540
29-12-2019,06 - 07,1340,1963,9615,2737,15655
29-12-2019,07 - 08,1146,1922,9847,2848,15763
29-12-2019,08 - 09,1212,1920,10254,2915,16301
29-12-2019,09 - 10,1252,1991,10450,3075,16768
29-12-2019,10 - 11,1275,1735,10746,3142,16898
29-12-2019,11 - 12,1256,1704,11073,3213,17246
29-12-2019,12 - 13,1134,1743,11117,3231,17225
29-12-2019,13 - 14,1168,1746,11095,3210,17219
29-12-2019,14 - 15,1261,1862,11166,3255,17544
29-12-2019,15 - 16,1234,1861,11340,3357,17792
29-12-2019,16 - 17,1210,1853,11418,3504,17985
29-12-2019,17 - 18,1208,1911,11394,3533,18046
29-12-2019,18 - 19,1149,1840,11212,3471,17672
29-12-2019,19 - 20,1185,1832,10897,3371,17285
29-12-2019,20 - 21,1225,1866,10537,3243,16871
29-12-2019,21 - 22,1191,1782,10107,3127,16207
29-12-2019,22 - 23,1169,1743,9604,3038,15554
29-12-2019,23 - 00,1162,1691,9313,2905,15071
30-12-2019,00 - 01,1031,1669,9029,2800,14529
30-12-2019,01 - 02,948,1690,8771,2715,14124
30-12-2019,02 - 03,1065,1786,8592,2625,14068
30-12-2019,03 - 04,1122,1867,8591,2582,14162
30-12-2019,04 - 05,1127,1764,8656,2618,14165
30-12-2019,05 - 06,1172,1841,8909,2710,14632
30-12-2019,06 - 07,974,1776,9434,2896,15080
30-12-2019,07 - 08,849,1873,10058,3139,15919
30-12-2019,08 - 09,1245,1953,10517,3257,16972
30-12-2019,09 - 10,1251,2024,10613,3319,17207
30-12-2019,10 - 11,1181,2166,10789,3335,17471
30-12-2019,11 - 12,1159,1996,10857,3389,17401
30-12-2019,12 - 13,1162,1825,10829,3409,17225
30-12-2019,13 - 14,1219,1935,10823,3346,17323
30-12-2019,14 - 15,1209,2032,10826,3338,17405
30-12-2019,15 - 16,1148,2204,11090,3411,17853
30-12-2019,16 - 17,1096,2178,11219,3450,17943
30-12-2019,17 - 18,1214,2173,11340,3495,18222
30-12-2019,18 - 19,1221,2164,11169,3439,17993
30-12-2019,19 - 20,1286,2002,10701,3192,17181
30-12-2019,20 - 21,1132,2085,10335,3004,16556
30-12-2019,21 - 22,1062,1986,9967,2870,15885
30-12-2019,22 - 23,1103,1903,9563,2706,15275
30-12-2019,23 - 00,1199,1917,9183,2576,14875
31-12-2019,00 - 01,1109,1780,8771,2498,14158
31-12-2019,01 - 02,1142,1838,8599,2436,14015
31-12-2019,02 - 03,1216,1844,8458,2394,13912
31-12-2019,03 - 04,1208,1627,8378,2361,13574
31-12-2019,04 - 05,1221,1732,8390,2359,13702
31-12-2019,05 - 06,1249,1776,8532,2425,13982
31-12-2019,06 - 07,1231,1723,8822,2538,14314
31-12-2019,07 - 08,1308,1886,9292,2639,15125
31-12-2019,08 - 09,1330,1944,9673,2784,15731
31-12-2019,09 - 10,1219,1854,10112,2976,16161
31-12-2019,10 - 11,1244,1845,10393,2966,16448
31-12-2019,11 - 12,1113,1960,10376,2907,16356
31-12-2019,12 - 13,1021,2012,10485,2894,16412
31-12-2019,13 - 14,1167,2087,10584,2825,16663
31-12-2019,14 - 15,1207,2253,10900,2936,17296
31-12-2019,15 - 16,1082,2190,11451,3161,17884
31-12-2019,16 - 17,1227,2220,11876,3364,18687
31-12-2019,17 - 18,1221,2162,11856,3335,18574
31-12-2019,18 - 19,1235,2007,11478,3228,17948
31-12-2019,19 - 20,1212,1966,11080,3109,17367
31-12-2019,20 - 21,1179,1973,10653,2899,16704
31-12-2019,21 - 22,1058,1886,10386,2859,16189
31-12-2019,22 - 23,1131,1842,10139,2863,15975
31-12-2019,23 - 00,1036,1887,9713,2780,15416
