,Hours,SE1,SE2,SE3,SE4,SE
01-01-2021,00 - 01,1165,2147,9614,2752,15678
01-01-2021,01 - 02,1221,2136,9481,2669,15507
01-01-2021,02 - 03,1159,2062,9314,2595,15130
01-01-2021,03 - 04,1116,2060,9197,2544,14917
01-01-2021,04 - 05,1166,2126,9199,2538,15029
01-01-2021,05 - 06,1173,2182,9352,2568,15275
01-01-2021,06 - 07,1246,2203,9588,2666,15703
01-01-2021,07 - 08,1194,2175,9839,2754,15962
01-01-2021,08 - 09,1207,2246,10071,2814,16338
01-01-2021,09 - 10,1301,2351,10242,2871,16765
01-01-2021,10 - 11,1286,2414,10519,2983,17202
01-01-2021,11 - 12,1302,2317,10815,3081,17515
01-01-2021,12 - 13,1295,2239,10921,3130,17585
01-01-2021,13 - 14,1291,2225,11056,3131,17703
01-01-2021,14 - 15,1347,2259,11254,3147,18007
01-01-2021,15 - 16,1326,2294,11581,3209,18410
01-01-2021,16 - 17,1348,2298,11732,3338,18716
01-01-2021,17 - 18,1340,2266,11810,3387,18803
01-01-2021,18 - 19,1319,2249,11689,3328,18585
01-01-2021,19 - 20,1252,2260,11411,3221,18144
01-01-2021,20 - 21,1275,2210,11025,3094,17604
01-01-2021,21 - 22,1293,2132,10651,3003,17079
01-01-2021,22 - 23,1298,2091,10250,2915,16554
01-01-2021,23 - 00,1247,2059,9819,2813,15938
02-01-2021,00 - 01,1162,1969,9563,2706,15400
02-01-2021,01 - 02,1173,1965,9416,2647,15201
02-01-2021,02 - 03,1138,1953,9366,2622,15079
02-01-2021,03 - 04,1126,2006,9350,2610,15092
02-01-2021,04 - 05,1145,2023,9340,2657,15165
02-01-2021,05 - 06,1151,2095,9410,2691,15347
02-01-2021,06 - 07,1177,2077,9612,2744,15610
02-01-2021,07 - 08,1246,2103,9975,2865,16189
02-01-2021,08 - 09,1283,2224,10306,2969,16782
02-01-2021,09 - 10,1396,2251,10689,3079,17415
02-01-2021,10 - 11,1412,2238,11142,3161,17953
02-01-2021,11 - 12,1405,2306,11346,3235,18292
02-01-2021,12 - 13,1354,2268,11453,3256,18331
02-01-2021,13 - 14,1368,2264,11431,3243,18306
02-01-2021,14 - 15,1397,2284,11506,3263,18450
02-01-2021,15 - 16,1488,2414,11853,3289,19044
02-01-2021,16 - 17,1603,2459,12193,3440,19695
02-01-2021,17 - 18,1643,2489,12236,3516,19884
02-01-2021,18 - 19,1561,2498,12060,3494,19613
02-01-2021,19 - 20,1506,2445,11692,3391,19034
02-01-2021,20 - 21,1432,2442,11282,3269,18425
02-01-2021,21 - 22,1379,2433,10898,3160,17870
02-01-2021,22 - 23,1329,2419,10464,3047,17259
02-01-2021,23 - 00,1319,2361,10142,2940,16762
03-01-2021,00 - 01,1318,2359,9890,2890,16457
03-01-2021,01 - 02,1285,2319,9652,2824,16080
03-01-2021,02 - 03,1259,2270,9502,2759,15790
03-01-2021,03 - 04,1360,2135,9424,2720,15639
03-01-2021,04 - 05,1286,2255,9541,2726,15808
03-01-2021,05 - 06,1274,2221,9647,2732,15874
03-01-2021,06 - 07,1292,2337,9858,2839,16326
03-01-2021,07 - 08,1228,2280,10153,2902,16563
03-01-2021,08 - 09,1256,2353,10595,2953,17157
03-01-2021,09 - 10,1323,2436,10967,3028,17754
03-01-2021,10 - 11,1341,2328,11370,3118,18157
03-01-2021,11 - 12,1290,2270,11629,3194,18383
03-01-2021,12 - 13,1321,2214,11683,3169,18387
03-01-2021,13 - 14,1449,2151,11818,3153,18571
03-01-2021,14 - 15,1454,2171,11954,3217,18796
03-01-2021,15 - 16,1441,2151,12248,3348,19188
03-01-2021,16 - 17,1415,2275,12758,3607,20055
03-01-2021,17 - 18,1424,2276,12895,3739,20334
03-01-2021,18 - 19,1389,2179,12709,3691,19968
03-01-2021,19 - 20,1428,2091,12348,3614,19481
03-01-2021,20 - 21,1495,2210,12060,3456,19221
03-01-2021,21 - 22,1450,2153,11658,3352,18613
03-01-2021,22 - 23,1394,1964,11125,3207,17690
03-01-2021,23 - 00,1290,1939,10745,3062,17036
04-01-2021,00 - 01,1212,1961,10483,2919,16575
04-01-2021,01 - 02,1293,1976,10321,2928,16518
04-01-2021,02 - 03,1323,1950,10247,2955,16475
04-01-2021,03 - 04,1396,1956,10195,3002,16549
04-01-2021,04 - 05,1368,2073,10353,3069,16863
04-01-2021,05 - 06,1391,2243,10793,3175,17602
04-01-2021,06 - 07,1420,2432,11775,3455,19082
04-01-2021,07 - 08,1487,2452,12687,3834,20460
04-01-2021,08 - 09,1587,2550,13117,4014,21268
04-01-2021,09 - 10,1551,2581,13244,4004,21380
04-01-2021,10 - 11,1543,2670,13466,4006,21685
04-01-2021,11 - 12,1519,2772,13664,3998,21953
04-01-2021,12 - 13,1512,2739,13754,3968,21973
04-01-2021,13 - 14,1584,2715,13740,3937,21976
04-01-2021,14 - 15,1675,2790,13774,3912,22151
04-01-2021,15 - 16,1625,2876,13946,3962,22409
04-01-2021,16 - 17,1580,2827,14144,4039,22590
04-01-2021,17 - 18,1555,2882,14287,4119,22843
04-01-2021,18 - 19,1516,2766,13939,4068,22289
04-01-2021,19 - 20,1475,2822,13601,3912,21810
04-01-2021,20 - 21,1498,2617,12942,3744,20801
04-01-2021,21 - 22,1508,2549,12281,3601,19939
04-01-2021,22 - 23,1451,2532,11641,3412,19036
04-01-2021,23 - 00,1388,2417,11099,3241,18145
05-01-2021,00 - 01,1378,2242,10816,3089,17525
05-01-2021,01 - 02,1389,2258,10526,3039,17212
05-01-2021,02 - 03,1335,2233,10519,3000,17087
05-01-2021,03 - 04,1367,2258,10536,3007,17168
05-01-2021,04 - 05,1331,2345,10652,3057,17385
05-01-2021,05 - 06,1349,2422,11104,3193,18068
05-01-2021,06 - 07,1438,2581,11979,3538,19536
05-01-2021,07 - 08,1453,2746,12749,3816,20764
05-01-2021,08 - 09,1554,2856,13228,3893,21531
05-01-2021,09 - 10,1555,2774,13431,3975,21735
05-01-2021,10 - 11,1514,2959,13623,3980,22076
05-01-2021,11 - 12,1505,2891,13676,3946,22018
05-01-2021,12 - 13,1490,2787,13734,3932,21943
05-01-2021,13 - 14,1518,2812,13652,3972,21954
05-01-2021,14 - 15,1537,2811,13675,3968,21991
05-01-2021,15 - 16,1543,2833,13844,4001,22221
05-01-2021,16 - 17,1524,2908,14141,4107,22680
05-01-2021,17 - 18,1593,2898,14181,4148,22820
05-01-2021,18 - 19,1428,2839,13976,4075,22318
05-01-2021,19 - 20,1392,2743,13603,3956,21694
05-01-2021,20 - 21,1610,2739,13131,3792,21272
05-01-2021,21 - 22,1646,2641,12532,3570,20389
05-01-2021,22 - 23,1411,2588,12007,3390,19396
05-01-2021,23 - 00,1273,2512,11601,3229,18615
06-01-2021,00 - 01,1403,2457,11230,3096,18186
06-01-2021,01 - 02,1431,2444,11076,3078,18029
06-01-2021,02 - 03,1482,2377,10907,3059,17825
06-01-2021,03 - 04,1433,2370,10958,3041,17802
06-01-2021,04 - 05,1255,2415,11130,3083,17883
06-01-2021,05 - 06,1119,2476,11275,3131,18001
06-01-2021,06 - 07,1112,2631,11755,3264,18762
06-01-2021,07 - 08,1240,2679,12139,3379,19437
06-01-2021,08 - 09,1526,2807,12558,3466,20357
06-01-2021,09 - 10,1641,2836,12852,3549,20878
06-01-2021,10 - 11,1527,2825,13186,3577,21115
06-01-2021,11 - 12,1347,2785,13413,3655,21200
06-01-2021,12 - 13,1314,2785,13515,3701,21315
06-01-2021,13 - 14,1374,2827,13482,3715,21398
06-01-2021,14 - 15,1463,2734,13549,3737,21483
06-01-2021,15 - 16,1577,2834,13864,3801,22076
06-01-2021,16 - 17,1583,2688,14122,3920,22313
06-01-2021,17 - 18,1562,2728,14240,3937,22467
06-01-2021,18 - 19,1505,2722,13981,3852,22060
06-01-2021,19 - 20,1475,2672,13631,3732,21510
06-01-2021,20 - 21,1483,2702,13156,3639,20980
06-01-2021,21 - 22,1517,2688,12664,3473,20342
06-01-2021,22 - 23,1444,2623,12145,3330,19542
06-01-2021,23 - 00,1429,2610,11719,3251,19009
07-01-2021,00 - 01,1349,2329,11336,3137,18151
07-01-2021,01 - 02,1355,2432,11218,3079,18084
07-01-2021,02 - 03,1311,2421,11114,3062,17908
07-01-2021,03 - 04,1368,2448,11096,3068,17980
07-01-2021,04 - 05,1262,2483,11166,3080,17991
07-01-2021,05 - 06,1355,2520,11549,3236,18660
07-01-2021,06 - 07,1388,2839,12651,3523,20401
07-01-2021,07 - 08,1459,2840,13509,3808,21616
07-01-2021,08 - 09,1462,2857,13906,3951,22176
07-01-2021,09 - 10,1459,2926,13982,3990,22357
07-01-2021,10 - 11,1455,2911,14046,4077,22489
07-01-2021,11 - 12,1459,2840,14114,4090,22503
07-01-2021,12 - 13,1495,2821,14199,4062,22577
07-01-2021,13 - 14,1540,2791,14140,4065,22536
07-01-2021,14 - 15,1526,2785,14097,3968,22376
07-01-2021,15 - 16,1484,2707,14240,3980,22411
07-01-2021,16 - 17,1513,2707,14356,4049,22625
07-01-2021,17 - 18,1506,2710,14350,4062,22628
07-01-2021,18 - 19,1433,2586,14051,4028,22098
07-01-2021,19 - 20,1421,2563,13714,3900,21598
07-01-2021,20 - 21,1392,2554,13268,3728,20942
07-01-2021,21 - 22,1403,2477,12756,3627,20263
07-01-2021,22 - 23,1310,2418,12177,3444,19349
07-01-2021,23 - 00,1289,2286,11599,3290,18464
08-01-2021,00 - 01,1299,2065,11010,3200,17574
08-01-2021,01 - 02,1300,2174,10743,3103,17320
08-01-2021,02 - 03,1278,2246,10686,3096,17306
08-01-2021,03 - 04,1278,2242,10661,3101,17282
08-01-2021,04 - 05,1289,2298,10828,3111,17526
08-01-2021,05 - 06,1281,2387,11202,3231,18101
08-01-2021,06 - 07,1322,2554,12160,3499,19535
08-01-2021,07 - 08,1374,2515,13034,3822,20745
08-01-2021,08 - 09,1423,2556,13379,3941,21299
08-01-2021,09 - 10,1427,2586,13456,3975,21444
08-01-2021,10 - 11,1408,2505,13631,4057,21601
08-01-2021,11 - 12,1418,2536,13666,4064,21684
08-01-2021,12 - 13,1422,2536,13736,4028,21722
08-01-2021,13 - 14,1398,2531,13553,3960,21442
08-01-2021,14 - 15,1395,2445,13482,3913,21235
08-01-2021,15 - 16,1418,2528,13584,3869,21399
08-01-2021,16 - 17,1398,2531,13805,3880,21614
08-01-2021,17 - 18,1403,2410,13826,3883,21522
08-01-2021,18 - 19,1358,2325,13588,3784,21055
08-01-2021,19 - 20,1358,2302,13145,3706,20511
08-01-2021,20 - 21,1358,2300,12724,3564,19946
08-01-2021,21 - 22,1282,2286,12149,3366,19083
08-01-2021,22 - 23,1259,2178,11670,3213,18320
08-01-2021,23 - 00,1185,2120,11317,3121,17743
09-01-2021,00 - 01,1293,2081,11051,2981,17406
09-01-2021,01 - 02,1287,2024,10715,2945,16971
09-01-2021,02 - 03,1287,2105,10568,2887,16847
09-01-2021,03 - 04,1273,2100,10502,2876,16751
09-01-2021,04 - 05,1287,2064,10503,2917,16771
09-01-2021,05 - 06,1299,2116,10677,2924,17016
09-01-2021,06 - 07,1314,2159,11030,3057,17560
09-01-2021,07 - 08,1317,2203,11337,3222,18079
09-01-2021,08 - 09,1397,2213,11642,3357,18609
09-01-2021,09 - 10,1415,2179,12027,3429,19050
09-01-2021,10 - 11,1459,2168,12426,3504,19557
09-01-2021,11 - 12,1484,2163,12541,3526,19714
09-01-2021,12 - 13,1430,2122,12581,3496,19629
09-01-2021,13 - 14,1411,2048,12481,3441,19381
09-01-2021,14 - 15,1432,2025,12442,3420,19319
09-01-2021,15 - 16,1468,2052,12736,3510,19766
09-01-2021,16 - 17,1437,1986,13204,3693,20320
09-01-2021,17 - 18,1448,1954,13477,3758,20637
09-01-2021,18 - 19,1432,1959,13450,3731,20572
09-01-2021,19 - 20,1429,1909,13117,3624,20079
09-01-2021,20 - 21,1301,1945,12661,3501,19408
09-01-2021,21 - 22,1318,1829,12334,3404,18885
09-01-2021,22 - 23,1316,1836,11974,3284,18410
09-01-2021,23 - 00,1296,1847,11613,3173,17929
10-01-2021,00 - 01,1243,1748,11191,3076,17258
10-01-2021,01 - 02,1236,1820,11037,2994,17087
10-01-2021,02 - 03,1179,1847,10879,2955,16860
10-01-2021,03 - 04,1216,1879,10687,2919,16701
10-01-2021,04 - 05,1321,1957,10675,2923,16876
10-01-2021,05 - 06,1423,1985,10593,2956,16957
10-01-2021,06 - 07,1442,2201,10899,3045,17587
10-01-2021,07 - 08,1268,2194,11159,3152,17773
10-01-2021,08 - 09,1364,2282,11523,3230,18399
10-01-2021,09 - 10,1394,2155,11812,3317,18678
10-01-2021,10 - 11,1243,2140,12133,3358,18874
10-01-2021,11 - 12,1337,2237,12400,3404,19378
10-01-2021,12 - 13,1308,2283,12508,3455,19554
10-01-2021,13 - 14,1402,2253,12619,3539,19813
10-01-2021,14 - 15,1372,2262,12714,3571,19919
10-01-2021,15 - 16,1372,2301,12883,3671,20227
10-01-2021,16 - 17,1534,2328,13348,3780,20990
10-01-2021,17 - 18,1538,2346,13515,3803,21202
10-01-2021,18 - 19,1565,2388,13433,3786,21172
10-01-2021,19 - 20,1478,2341,13152,3711,20682
10-01-2021,20 - 21,1394,2484,12836,3617,20331
10-01-2021,21 - 22,1356,2518,12419,3461,19754
10-01-2021,22 - 23,1347,2393,11966,3326,19032
10-01-2021,23 - 00,1345,2392,11478,3173,18388
11-01-2021,00 - 01,1350,2298,11108,3081,17837
11-01-2021,01 - 02,1384,2219,10959,3059,17621
11-01-2021,02 - 03,1312,2152,10850,3036,17350
11-01-2021,03 - 04,1302,2068,10858,3011,17239
11-01-2021,04 - 05,1267,2047,11024,3082,17420
11-01-2021,05 - 06,1267,2107,11452,3308,18134
11-01-2021,06 - 07,1343,2539,12630,3680,20192
11-01-2021,07 - 08,1521,2651,13656,4082,21910
11-01-2021,08 - 09,1538,2461,14134,4190,22323
11-01-2021,09 - 10,1456,2101,14065,4158,21780
11-01-2021,10 - 11,1505,2282,14166,4151,22104
11-01-2021,11 - 12,1538,2512,14163,4128,22341
11-01-2021,12 - 13,1572,2659,14113,4110,22454
11-01-2021,13 - 14,1511,2730,13827,4045,22113
11-01-2021,14 - 15,1503,2637,13780,4075,21995
11-01-2021,15 - 16,1489,2743,14099,4061,22392
11-01-2021,16 - 17,1504,2773,14245,4129,22651
11-01-2021,17 - 18,1573,2729,14370,4128,22800
11-01-2021,18 - 19,1521,2521,13865,4040,21947
11-01-2021,19 - 20,1456,2645,13499,3917,21517
11-01-2021,20 - 21,1496,2423,13088,3742,20749
11-01-2021,21 - 22,1547,2358,12633,3528,20066
11-01-2021,22 - 23,1578,2157,12089,3298,19122
11-01-2021,23 - 00,1578,2003,11407,3109,18097
12-01-2021,00 - 01,1356,1993,11188,3032,17569
12-01-2021,01 - 02,1285,2228,11039,2988,17540
12-01-2021,02 - 03,1352,2421,10973,2935,17681
12-01-2021,03 - 04,1432,2446,11062,2916,17856
12-01-2021,04 - 05,1512,2280,11269,3016,18077
12-01-2021,05 - 06,1510,2332,11956,3210,19008
12-01-2021,06 - 07,1402,2585,13248,3560,20795
12-01-2021,07 - 08,1489,2672,14208,3923,22292
12-01-2021,08 - 09,1559,2528,14561,4040,22688
12-01-2021,09 - 10,1493,2427,14599,4017,22536
12-01-2021,10 - 11,1599,2452,14567,4010,22628
12-01-2021,11 - 12,1580,2430,14409,3991,22410
12-01-2021,12 - 13,1470,2440,14286,3746,21942
12-01-2021,13 - 14,1577,2408,14203,3835,22023
12-01-2021,14 - 15,1509,2355,14104,3954,21922
12-01-2021,15 - 16,1392,2380,14344,4075,22191
12-01-2021,16 - 17,1373,2506,14783,4061,22723
12-01-2021,17 - 18,1449,2384,14902,4160,22895
12-01-2021,18 - 19,1558,2495,14707,4040,22800
12-01-2021,19 - 20,1482,2574,14318,3832,22206
12-01-2021,20 - 21,1416,2569,14066,3756,21807
12-01-2021,21 - 22,1429,2606,13396,3629,21060
12-01-2021,22 - 23,1383,2538,12869,3488,20278
12-01-2021,23 - 00,1420,2291,12215,3286,19212
13-01-2021,00 - 01,1227,2410,11984,3172,18793
13-01-2021,01 - 02,1380,2126,11799,3164,18469
13-01-2021,02 - 03,1504,2074,11723,3117,18418
13-01-2021,03 - 04,1418,2185,11801,3120,18524
13-01-2021,04 - 05,1479,2238,11986,3173,18876
13-01-2021,05 - 06,1533,2223,12545,3333,19634
13-01-2021,06 - 07,1470,2360,13807,3673,21310
13-01-2021,07 - 08,1447,2421,14905,4074,22847
13-01-2021,08 - 09,1490,2372,15152,4213,23227
13-01-2021,09 - 10,1421,2623,14898,4191,23133
13-01-2021,10 - 11,1637,2477,14844,4245,23203
13-01-2021,11 - 12,1563,2327,14804,4251,22945
13-01-2021,12 - 13,1558,2392,14608,4229,22787
13-01-2021,13 - 14,1501,2480,14479,4238,22698
13-01-2021,14 - 15,1619,2534,14273,4278,22704
13-01-2021,15 - 16,1692,2389,14502,4302,22885
13-01-2021,16 - 17,1691,2529,14821,4372,23413
13-01-2021,17 - 18,1664,2509,14996,4394,23563
13-01-2021,18 - 19,1686,2561,14717,4176,23140
13-01-2021,19 - 20,1618,2602,14377,4066,22663
13-01-2021,20 - 21,1478,2528,13919,3915,21840
13-01-2021,21 - 22,1570,2591,13341,3817,21319
13-01-2021,22 - 23,1596,2644,12761,3587,20588
13-01-2021,23 - 00,1611,2442,12138,3385,19576
14-01-2021,00 - 01,1543,2381,11751,3298,18973
14-01-2021,01 - 02,1630,2179,11552,3235,18596
14-01-2021,02 - 03,1527,2200,11564,3172,18463
14-01-2021,03 - 04,1577,2215,11728,3183,18703
14-01-2021,04 - 05,1573,2251,11929,3262,19015
14-01-2021,05 - 06,1616,2298,12487,3409,19810
14-01-2021,06 - 07,1676,2517,13634,3792,21619
14-01-2021,07 - 08,1714,2667,14898,4152,23431
14-01-2021,08 - 09,1788,2588,15118,4152,23646
14-01-2021,09 - 10,1747,2611,14978,4144,23480
14-01-2021,10 - 11,1675,2715,15059,4173,23622
14-01-2021,11 - 12,1695,2719,15008,4166,23588
14-01-2021,12 - 13,1729,2724,14969,4105,23527
14-01-2021,13 - 14,1748,2834,14802,4084,23468
14-01-2021,14 - 15,1734,2753,14805,4084,23376
14-01-2021,15 - 16,1696,2911,15077,4164,23848
14-01-2021,16 - 17,1576,2935,15444,4236,24191
14-01-2021,17 - 18,1483,3106,15750,4338,24677
14-01-2021,18 - 19,1613,2879,15291,4272,24055
14-01-2021,19 - 20,1563,2858,14987,4162,23570
14-01-2021,20 - 21,1502,2783,14591,4085,22961
14-01-2021,21 - 22,1393,2704,14242,3931,22270
14-01-2021,22 - 23,1461,2691,13667,3739,21558
14-01-2021,23 - 00,1495,2665,13093,3526,20779
15-01-2021,00 - 01,1430,2444,12950,3472,20296
15-01-2021,01 - 02,1571,2352,12759,3348,20030
15-01-2021,02 - 03,1608,2262,12701,3457,20028
15-01-2021,03 - 04,1645,2245,12777,3560,20227
15-01-2021,04 - 05,1550,2311,12915,3591,20367
15-01-2021,05 - 06,1438,2519,13465,3810,21232
15-01-2021,06 - 07,1413,2815,14523,4155,22906
15-01-2021,07 - 08,1405,2686,15650,4533,24274
15-01-2021,08 - 09,1494,2622,16146,4572,24834
15-01-2021,09 - 10,1557,2475,16277,4545,24854
15-01-2021,10 - 11,1553,2553,16138,4547,24791
15-01-2021,11 - 12,1534,2531,16051,4478,24594
15-01-2021,12 - 13,1451,2336,16031,4323,24141
15-01-2021,13 - 14,1427,2197,15600,4209,23433
15-01-2021,14 - 15,1398,2181,15441,4173,23193
15-01-2021,15 - 16,1428,2286,15541,4240,23495
15-01-2021,16 - 17,1508,2341,15887,4388,24124
15-01-2021,17 - 18,1476,2472,15933,4513,24394
15-01-2021,18 - 19,1312,2268,15717,4457,23754
15-01-2021,19 - 20,1399,2140,15118,4309,22966
15-01-2021,20 - 21,1394,2092,14600,4171,22257
15-01-2021,21 - 22,1309,2069,14052,4091,21521
15-01-2021,22 - 23,1217,2088,13607,4020,20932
15-01-2021,23 - 00,1303,2020,13192,3961,20476
16-01-2021,00 - 01,1275,2087,12974,3846,20182
16-01-2021,01 - 02,1374,2070,12726,3761,19931
16-01-2021,02 - 03,1331,2131,12563,3737,19762
16-01-2021,03 - 04,1347,2047,12395,3766,19555
16-01-2021,04 - 05,1417,2233,12419,3794,19863
16-01-2021,05 - 06,1407,2503,12507,3788,20205
16-01-2021,06 - 07,1358,2671,12834,3840,20703
16-01-2021,07 - 08,1373,2786,13256,3902,21317
16-01-2021,08 - 09,1539,2815,13676,3955,21985
16-01-2021,09 - 10,1508,2775,14107,4106,22496
16-01-2021,10 - 11,1550,2750,14256,4150,22706
16-01-2021,11 - 12,1583,2790,14098,4046,22517
16-01-2021,12 - 13,1538,2740,14040,3896,22214
16-01-2021,13 - 14,1494,2677,13890,3799,21860
16-01-2021,14 - 15,1568,2663,13795,3784,21810
16-01-2021,15 - 16,1635,2668,13941,3836,22080
16-01-2021,16 - 17,1723,2775,14405,4036,22939
16-01-2021,17 - 18,1721,2745,14507,4184,23157
16-01-2021,18 - 19,1628,2547,14317,4161,22653
16-01-2021,19 - 20,1550,2355,13975,4029,21909
16-01-2021,20 - 21,1555,2189,13522,3914,21180
16-01-2021,21 - 22,1494,1930,13154,3813,20391
16-01-2021,22 - 23,1504,1694,12683,3685,19566
16-01-2021,23 - 00,1346,1494,12334,3599,18773
17-01-2021,00 - 01,1292,1484,11867,3498,18141
17-01-2021,01 - 02,1283,1584,11684,3419,17970
17-01-2021,02 - 03,1280,1673,11623,3374,17950
17-01-2021,03 - 04,1363,1739,11560,3355,18017
17-01-2021,04 - 05,1396,1730,11518,3360,18004
17-01-2021,05 - 06,1352,1815,11602,3360,18129
17-01-2021,06 - 07,1359,1721,11813,3435,18328
17-01-2021,07 - 08,1405,1866,12116,3521,18908
17-01-2021,08 - 09,1376,1926,12413,3618,19333
17-01-2021,09 - 10,1433,1868,12818,3701,19820
17-01-2021,10 - 11,1400,1996,13043,3797,20236
17-01-2021,11 - 12,1444,2093,13220,3822,20579
17-01-2021,12 - 13,1495,2144,13257,3847,20743
17-01-2021,13 - 14,1516,2176,13326,3793,20811
17-01-2021,14 - 15,1429,2120,13325,3772,20646
17-01-2021,15 - 16,1491,2321,13497,3829,21138
17-01-2021,16 - 17,1564,2341,14049,4013,21967
17-01-2021,17 - 18,1427,2248,14042,4107,21824
17-01-2021,18 - 19,1426,2303,13826,4061,21616
17-01-2021,19 - 20,1464,2370,13520,3983,21337
17-01-2021,20 - 21,1444,2430,13088,3862,20824
17-01-2021,21 - 22,1420,2512,12541,3736,20209
17-01-2021,22 - 23,1527,2423,12179,3583,19712
17-01-2021,23 - 00,1328,2569,11880,3493,19270
18-01-2021,00 - 01,1331,2509,11655,3398,18893
18-01-2021,01 - 02,1406,2284,11443,3359,18492
18-01-2021,02 - 03,1449,2374,11326,3338,18487
18-01-2021,03 - 04,1447,2481,11159,3326,18413
18-01-2021,04 - 05,1444,2556,11454,3407,18861
18-01-2021,05 - 06,1462,2599,12077,3567,19705
18-01-2021,06 - 07,1489,2877,13249,3946,21561
18-01-2021,07 - 08,1592,2897,14265,4298,23052
18-01-2021,08 - 09,1676,2901,14621,4383,23581
18-01-2021,09 - 10,1607,2970,14547,4390,23514
18-01-2021,10 - 11,1709,2858,14610,4412,23589
18-01-2021,11 - 12,1696,2904,14624,4403,23627
18-01-2021,12 - 13,1631,2848,14698,4391,23568
18-01-2021,13 - 14,1606,2869,14591,4353,23419
18-01-2021,14 - 15,1744,2834,14601,4322,23501
18-01-2021,15 - 16,1804,2895,14489,4326,23514
18-01-2021,16 - 17,1731,3083,14776,4406,23996
18-01-2021,17 - 18,1641,3131,14938,4398,24108
18-01-2021,18 - 19,1693,3051,14615,4323,23682
18-01-2021,19 - 20,1599,3019,14180,4204,23002
18-01-2021,20 - 21,1533,2772,13689,3998,21992
18-01-2021,21 - 22,1580,2587,13083,3792,21042
18-01-2021,22 - 23,1438,2568,12425,3606,20037
18-01-2021,23 - 00,1307,2496,11745,3415,18963
19-01-2021,00 - 01,1467,2435,11468,3220,18590
19-01-2021,01 - 02,1537,2548,11211,3158,18454
19-01-2021,02 - 03,1506,2425,10965,3140,18036
19-01-2021,03 - 04,1504,2444,11016,3115,18079
19-01-2021,04 - 05,1528,2505,11128,3151,18312
19-01-2021,05 - 06,1499,2567,11628,3277,18971
19-01-2021,06 - 07,1573,2812,12719,3646,20750
19-01-2021,07 - 08,1703,2877,13771,4031,22382
19-01-2021,08 - 09,1610,2919,14120,4120,22769
19-01-2021,09 - 10,1614,2915,13998,4116,22643
19-01-2021,10 - 11,1617,2958,14041,4155,22771
19-01-2021,11 - 12,1666,2986,14135,4177,22964
19-01-2021,12 - 13,1762,3051,14130,4166,23109
19-01-2021,13 - 14,1654,2979,13986,4119,22738
19-01-2021,14 - 15,1588,2840,14000,4114,22542
19-01-2021,15 - 16,1686,2844,14101,4151,22782
19-01-2021,16 - 17,1767,2806,14460,4274,23307
19-01-2021,17 - 18,1644,2913,14633,4286,23476
19-01-2021,18 - 19,1633,2931,14341,4176,23081
19-01-2021,19 - 20,1649,2813,13831,4037,22330
19-01-2021,20 - 21,1607,2743,13419,3857,21626
19-01-2021,21 - 22,1591,2683,12764,3662,20700
19-01-2021,22 - 23,1552,2645,12164,3529,19890
19-01-2021,23 - 00,1451,2523,11535,3307,18816
20-01-2021,00 - 01,1382,2402,11112,3108,18004
20-01-2021,01 - 02,1447,2555,10953,3025,17980
20-01-2021,02 - 03,1474,2502,10855,2989,17820
20-01-2021,03 - 04,1509,2451,10949,2990,17899
20-01-2021,04 - 05,1524,2595,11092,3032,18243
20-01-2021,05 - 06,1571,2379,11668,3169,18787
20-01-2021,06 - 07,1578,2722,12852,3505,20657
20-01-2021,07 - 08,1617,3074,13966,3832,22489
20-01-2021,08 - 09,1707,2982,14193,3963,22845
20-01-2021,09 - 10,1479,2949,14140,3974,22542
20-01-2021,10 - 11,1572,3146,14320,4014,23052
20-01-2021,11 - 12,1556,3021,14310,4026,22913
20-01-2021,12 - 13,1576,3129,14259,4039,23003
20-01-2021,13 - 14,1556,3133,14087,4074,22850
20-01-2021,14 - 15,1481,3076,14100,4029,22686
20-01-2021,15 - 16,1614,3118,14288,3988,23008
20-01-2021,16 - 17,1630,3225,14559,4018,23432
20-01-2021,17 - 18,1599,3220,14577,4037,23433
20-01-2021,18 - 19,1620,3136,14229,3922,22907
20-01-2021,19 - 20,1528,3082,13714,3785,22109
20-01-2021,20 - 21,1538,2919,13210,3575,21242
20-01-2021,21 - 22,1490,2902,12536,3355,20283
20-01-2021,22 - 23,1538,2702,11776,3101,19117
20-01-2021,23 - 00,1523,2607,11171,2878,18179
21-01-2021,00 - 01,1509,2453,10855,2844,17661
21-01-2021,01 - 02,1525,2564,10601,2821,17511
21-01-2021,02 - 03,1527,2509,10484,2801,17321
21-01-2021,03 - 04,1428,2353,10578,2810,17169
21-01-2021,04 - 05,1393,2509,10649,2826,17377
21-01-2021,05 - 06,1524,2526,10888,2969,17907
21-01-2021,06 - 07,1622,2631,11902,3362,19517
21-01-2021,07 - 08,1649,2693,13288,3786,21416
21-01-2021,08 - 09,1540,2623,13324,3871,21358
21-01-2021,09 - 10,1553,2599,13299,3852,21303
21-01-2021,10 - 11,1497,2670,13393,3805,21365
21-01-2021,11 - 12,1363,2676,13335,3782,21156
21-01-2021,12 - 13,1605,2639,13279,3758,21281
21-01-2021,13 - 14,1676,2372,12941,3687,20676
21-01-2021,14 - 15,1541,2414,12917,3711,20583
21-01-2021,15 - 16,1531,2429,13175,3770,20905
21-01-2021,16 - 17,1540,2556,13573,3857,21526
21-01-2021,17 - 18,1555,2502,13874,3996,21927
21-01-2021,18 - 19,1514,2400,13599,3929,21442
21-01-2021,19 - 20,1429,2219,13268,3802,20718
21-01-2021,20 - 21,1401,2310,12879,3600,20190
21-01-2021,21 - 22,1452,2329,12454,3403,19638
21-01-2021,22 - 23,1418,2224,11680,3222,18544
21-01-2021,23 - 00,1355,2417,11204,3069,18045
22-01-2021,00 - 01,1367,2167,10770,2916,17220
22-01-2021,01 - 02,1394,1698,10417,2849,16358
22-01-2021,02 - 03,1354,1980,10278,2763,16375
22-01-2021,03 - 04,1384,1992,10361,2785,16522
22-01-2021,04 - 05,1543,2241,10505,2932,17221
22-01-2021,05 - 06,1600,2262,10900,3078,17840
22-01-2021,06 - 07,1697,2421,12070,3355,19543
22-01-2021,07 - 08,1642,2486,13107,3690,20925
22-01-2021,08 - 09,1583,2439,13484,3731,21237
22-01-2021,09 - 10,1606,2467,13380,3706,21159
22-01-2021,10 - 11,1448,2596,13418,3895,21357
22-01-2021,11 - 12,1369,2574,13398,3845,21186
22-01-2021,12 - 13,1422,2491,13360,3799,21072
22-01-2021,13 - 14,1524,2345,12895,3705,20469
22-01-2021,14 - 15,1587,2321,12701,3604,20213
22-01-2021,15 - 16,1597,2320,12909,3607,20433
22-01-2021,16 - 17,1428,2294,13160,3640,20522
22-01-2021,17 - 18,1378,2057,13293,3759,20487
22-01-2021,18 - 19,1389,2113,13083,3729,20314
22-01-2021,19 - 20,1440,1915,12632,3566,19553
22-01-2021,20 - 21,1421,2017,12230,3381,19049
22-01-2021,21 - 22,1394,2203,11648,3226,18471
22-01-2021,22 - 23,1353,2133,11119,3062,17667
22-01-2021,23 - 00,1333,1909,10622,2915,16779
23-01-2021,00 - 01,1517,1855,10358,2862,16592
23-01-2021,01 - 02,1367,2013,9984,2805,16169
23-01-2021,02 - 03,1345,1934,9854,2746,15879
23-01-2021,03 - 04,1362,1965,9808,2761,15896
23-01-2021,04 - 05,1379,2073,9928,2860,16240
23-01-2021,05 - 06,1450,2115,10106,2984,16655
23-01-2021,06 - 07,1321,2134,10384,3054,16893
23-01-2021,07 - 08,1319,2280,10693,3159,17451
23-01-2021,08 - 09,1328,2299,10950,3286,17863
23-01-2021,09 - 10,1432,2251,11501,3409,18593
23-01-2021,10 - 11,1472,2205,11638,3514,18829
23-01-2021,11 - 12,1488,2226,11574,3530,18818
23-01-2021,12 - 13,1512,2124,11622,3530,18788
23-01-2021,13 - 14,1490,2159,11615,3497,18761
23-01-2021,14 - 15,1442,2129,11736,3482,18789
23-01-2021,15 - 16,1474,2137,12290,3482,19383
23-01-2021,16 - 17,1604,2270,12666,3567,20107
23-01-2021,17 - 18,1774,2253,12892,3650,20569
23-01-2021,18 - 19,1744,2460,12677,3640,20521
23-01-2021,19 - 20,1495,2423,12255,3525,19698
23-01-2021,20 - 21,1507,2210,11859,3421,18997
23-01-2021,21 - 22,1550,2089,11436,3310,18385
23-01-2021,22 - 23,1533,2121,11055,3244,17953
23-01-2021,23 - 00,1416,2164,10817,3110,17507
24-01-2021,00 - 01,1380,2151,10433,2987,16951
24-01-2021,01 - 02,1443,2036,10206,2957,16642
24-01-2021,02 - 03,1317,2013,10153,2893,16376
24-01-2021,03 - 04,1342,2136,10085,2920,16483
24-01-2021,04 - 05,1329,2187,10145,2942,16603
24-01-2021,05 - 06,1317,2099,10391,2999,16806
24-01-2021,06 - 07,1400,2253,10802,3110,17565
24-01-2021,07 - 08,1339,2364,11148,3234,18085
24-01-2021,08 - 09,1369,2310,11442,3314,18435
24-01-2021,09 - 10,1407,2420,11888,3434,19149
24-01-2021,10 - 11,1438,2350,12059,3482,19329
24-01-2021,11 - 12,1468,2406,12255,3516,19645
24-01-2021,12 - 13,1492,2395,12309,3502,19698
24-01-2021,13 - 14,1460,2363,12263,3492,19578
24-01-2021,14 - 15,1458,2478,12489,3497,19922
24-01-2021,15 - 16,1479,2493,12658,3492,20122
24-01-2021,16 - 17,1479,2575,13228,3663,20945
24-01-2021,17 - 18,1501,2560,13660,3766,21487
24-01-2021,18 - 19,1514,2488,13540,3731,21273
24-01-2021,19 - 20,1544,2501,13293,3667,21005
24-01-2021,20 - 21,1452,2450,12910,3543,20355
24-01-2021,21 - 22,1448,2400,12445,3420,19713
24-01-2021,22 - 23,1437,2293,11721,3274,18725
24-01-2021,23 - 00,1430,2162,11346,3166,
25-01-2021,00 - 01,1413,2014,10872,3081,17380
25-01-2021,01 - 02,1417,2114,10769,3016,17316
25-01-2021,02 - 03,1315,2197,10874,3023,17409
25-01-2021,03 - 04,1319,2156,10801,3046,17322
25-01-2021,04 - 05,1375,2116,10907,3108,17506
25-01-2021,05 - 06,1467,2300,11432,3226,18425
25-01-2021,06 - 07,1515,2564,12772,3626,20477
25-01-2021,07 - 08,1574,2625,13908,3972,22079
25-01-2021,08 - 09,1597,2812,14241,4032,22682
25-01-2021,09 - 10,1605,2824,14340,3988,22757
25-01-2021,10 - 11,1647,2833,14131,4023,22634
25-01-2021,11 - 12,1608,2781,14106,4123,22618
25-01-2021,12 - 13,1576,2725,14207,4139,22647
25-01-2021,13 - 14,1626,2737,14161,4131,22655
25-01-2021,14 - 15,1597,2808,14050,4093,22548
25-01-2021,15 - 16,1606,2901,14054,4087,22647
25-01-2021,16 - 17,1551,2893,14420,4125,22988
25-01-2021,17 - 18,1581,2905,14717,4241,22909
25-01-2021,18 - 19,1583,2887,14552,4162,22791
25-01-2021,19 - 20,1599,2858,14180,4030,22835
25-01-2021,20 - 21,1632,2893,13793,3853,22950
25-01-2021,21 - 22,1696,2699,13215,3624,23001
25-01-2021,22 - 23,1665,2667,12617,3498,22998
25-01-2021,23 - 00,1601,2630,12056,3326,22250
26-01-2021,00 - 01,1651,2278,11751,3260,18940
26-01-2021,01 - 02,1753,2203,11386,3222,18564
26-01-2021,02 - 03,1689,2083,11215,3179,18166
26-01-2021,03 - 04,1595,2100,11351,3180,18226
26-01-2021,04 - 05,1733,2222,11644,3239,18838
26-01-2021,05 - 06,1708,2293,12028,3372,19401
26-01-2021,06 - 07,1683,2520,13008,3743,20954
26-01-2021,07 - 08,1632,2736,14253,4078,22699
26-01-2021,08 - 09,1643,2743,14528,4162,23076
26-01-2021,09 - 10,1605,2724,14615,4141,23085
26-01-2021,10 - 11,1702,2628,14441,4156,22927
26-01-2021,11 - 12,2036,2673,14482,4169,23360
26-01-2021,12 - 13,1813,2644,14447,4080,22984
26-01-2021,13 - 14,1701,2668,14089,4043,21988
26-01-2021,14 - 15,1596,2660,14057,3959,22272
26-01-2021,15 - 16,1638,2626,14095,4041,22400
26-01-2021,16 - 17,1585,2649,14485,4095,22814
26-01-2021,17 - 18,1465,2698,14918,4266,23347
26-01-2021,18 - 19,1485,2673,14720,4231,23109
26-01-2021,19 - 20,1637,2675,14395,4088,22795
26-01-2021,20 - 21,1626,2687,14064,3885,22262
26-01-2021,21 - 22,1581,2564,13516,3681,21342
26-01-2021,22 - 23,1578,2536,13035,3561,20710
26-01-2021,23 - 00,1490,2497,12547,3471,20005
27-01-2021,00 - 01,1411,2253,12061,3390,19115
27-01-2021,01 - 02,1470,2279,11966,3354,19069
27-01-2021,02 - 03,1458,2212,11794,3298,18762
27-01-2021,03 - 04,1462,2160,11793,3317,18732
27-01-2021,04 - 05,1509,2123,11877,3316,18825
27-01-2021,05 - 06,1522,2341,12268,3470,19601
27-01-2021,06 - 07,1457,2478,13295,3837,21067
27-01-2021,07 - 08,1557,2564,14650,4143,22914
27-01-2021,08 - 09,1496,2571,14891,4195,23153
27-01-2021,09 - 10,1516,2648,15061,4207,23432
27-01-2021,10 - 11,1460,2667,15009,4229,23365
27-01-2021,11 - 12,1541,2654,14794,4261,23250
27-01-2021,12 - 13,1594,2654,14658,4172,23078
27-01-2021,13 - 14,1505,2574,14477,4134,22690
27-01-2021,14 - 15,1464,2520,14380,4097,22461
27-01-2021,15 - 16,1458,2604,14633,4118,22813
27-01-2021,16 - 17,1468,2653,15067,4184,23372
27-01-2021,17 - 18,1541,2747,15386,4278,23952
27-01-2021,18 - 19,1555,2757,15242,4157,23711
27-01-2021,19 - 20,1528,2677,14918,3983,23106
27-01-2021,20 - 21,1434,2699,14475,3818,22426
27-01-2021,21 - 22,1331,2687,13922,3628,21568
27-01-2021,22 - 23,1455,2596,13308,3487,20846
27-01-2021,23 - 00,1460,2633,12705,3350,20148
28-01-2021,00 - 01,1431,2334,12188,3265,19218
28-01-2021,01 - 02,1423,2325,12033,3194,18975
28-01-2021,02 - 03,1334,2305,11874,3151,18664
28-01-2021,03 - 04,1354,2283,11909,3145,18691
28-01-2021,04 - 05,1356,2233,12167,3167,18923
28-01-2021,05 - 06,1351,2343,12581,3303,19578
28-01-2021,06 - 07,1536,2645,13687,3718,21586
28-01-2021,07 - 08,1517,2785,14824,4094,23220
28-01-2021,08 - 09,1527,2859,15077,4058,23521
28-01-2021,09 - 10,1527,2840,14976,4073,23416
28-01-2021,10 - 11,1535,2824,15064,4123,23546
28-01-2021,11 - 12,1543,2843,14949,4185,23520
28-01-2021,12 - 13,1537,2852,14875,4272,23536
28-01-2021,13 - 14,1545,2814,14658,4237,23254
28-01-2021,14 - 15,1579,2807,14561,4133,23080
28-01-2021,15 - 16,1622,2811,14472,4121,23026
28-01-2021,16 - 17,1601,2880,14735,4081,23297
28-01-2021,17 - 18,1615,3009,15098,4209,23931
28-01-2021,18 - 19,1626,2894,14967,4197,23684
28-01-2021,19 - 20,1666,2842,14655,4143,23306
28-01-2021,20 - 21,1620,2820,14215,4064,22719
28-01-2021,21 - 22,1598,2697,13683,3854,21832
28-01-2021,22 - 23,1537,2634,13318,3749,21238
28-01-2021,23 - 00,1483,2531,12656,3555,20225
29-01-2021,00 - 01,1474,2365,12345,3419,19603
29-01-2021,01 - 02,1532,2345,12279,3380,19536
29-01-2021,02 - 03,1482,2378,12258,3431,19549
29-01-2021,03 - 04,1514,2406,12155,3494,19569
29-01-2021,04 - 05,1572,2442,12279,3504,19797
29-01-2021,05 - 06,1638,2428,12923,3669,20658
29-01-2021,06 - 07,1725,2698,14082,4086,22591
29-01-2021,07 - 08,1733,2855,15043,4439,24070
29-01-2021,08 - 09,1703,2836,15358,4537,24434
29-01-2021,09 - 10,1696,2907,15451,4499,24553
29-01-2021,10 - 11,1714,2909,15377,4473,24473
29-01-2021,11 - 12,1723,2766,15199,4423,24111
29-01-2021,12 - 13,1731,2812,15085,4363,23991
29-01-2021,13 - 14,1739,2735,14623,4269,23366
29-01-2021,14 - 15,1681,2729,14417,4174,23001
29-01-2021,15 - 16,1684,2801,14415,4138,23038
29-01-2021,16 - 17,1751,3006,14840,4167,23764
29-01-2021,17 - 18,1799,2918,15152,4296,24165
29-01-2021,18 - 19,1786,2964,14924,4191,23865
29-01-2021,19 - 20,1703,2888,14520,4091,23202
29-01-2021,20 - 21,1632,2791,14053,3900,22376
29-01-2021,21 - 22,1592,2747,13601,3704,21644
29-01-2021,22 - 23,1553,2727,13184,3578,21042
29-01-2021,23 - 00,1487,2695,12779,3467,20428
30-01-2021,00 - 01,1596,2609,12489,3419,20113
30-01-2021,01 - 02,1688,2467,12304,3355,19814
30-01-2021,02 - 03,1686,2501,12268,3304,19759
30-01-2021,03 - 04,1451,2546,12295,3245,19537
30-01-2021,04 - 05,1384,2647,12418,3281,19730
30-01-2021,05 - 06,1474,2652,12588,3403,20117
30-01-2021,06 - 07,1589,2632,13022,3578,20821
30-01-2021,07 - 08,1613,2761,13537,3824,21735
30-01-2021,08 - 09,1536,2838,13956,3991,22321
30-01-2021,09 - 10,1596,2881,14237,4023,22737
30-01-2021,10 - 11,1557,2842,14266,4061,22726
30-01-2021,11 - 12,1519,2669,14166,3964,22318
30-01-2021,12 - 13,1548,2547,13962,3865,21922
30-01-2021,13 - 14,1476,2521,13742,3783,21522
30-01-2021,14 - 15,1377,2604,13528,3711,21220
30-01-2021,15 - 16,1550,2582,13698,3695,21525
30-01-2021,16 - 17,1642,2846,14256,3759,22503
30-01-2021,17 - 18,1610,2837,14863,3914,23224
30-01-2021,18 - 19,1533,2713,14915,3857,23018
30-01-2021,19 - 20,1480,2685,14576,3724,22465
30-01-2021,20 - 21,1401,2565,14243,3631,21840
30-01-2021,21 - 22,1357,2592,13848,3466,21263
30-01-2021,22 - 23,1395,2526,13503,3356,20780
30-01-2021,23 - 00,1246,2496,13033,3239,20014
31-01-2021,00 - 01,1256,2304,12615,3223,19398
31-01-2021,01 - 02,1265,2113,12448,3184,19010
31-01-2021,02 - 03,1243,2197,12475,3152,19067
31-01-2021,03 - 04,1232,2118,12424,3141,18915
31-01-2021,04 - 05,1230,2086,12523,3145,18984
31-01-2021,05 - 06,1310,2063,12713,3120,19206
31-01-2021,06 - 07,1340,2291,12987,3201,19819
31-01-2021,07 - 08,1365,2354,13469,3315,20503
31-01-2021,08 - 09,1349,2218,13872,3448,20887
31-01-2021,09 - 10,1323,2267,14418,3559,21567
31-01-2021,10 - 11,1384,2493,14575,3639,22091
31-01-2021,11 - 12,1394,2447,14288,3636,21765
31-01-2021,12 - 13,1399,2342,13963,3591,21295
31-01-2021,13 - 14,1405,2293,13652,3518,20868
31-01-2021,14 - 15,1326,2302,13659,3475,20762
31-01-2021,15 - 16,1356,2397,13882,3560,21195
31-01-2021,16 - 17,1430,2502,14566,3743,22241
31-01-2021,17 - 18,1329,2569,15213,3935,23046
31-01-2021,18 - 19,1395,2588,15139,3940,23062
31-01-2021,19 - 20,1415,2614,14946,3935,22910
31-01-2021,20 - 21,1380,2630,14671,3814,22495
31-01-2021,21 - 22,1344,2541,14169,3694,21748
31-01-2021,22 - 23,1224,2447,13690,3599,20960
31-01-2021,23 - 00,1164,2368,13377,3510,20419
01-02-2021,00 - 01,1239,2293,13129,3488,20149
01-02-2021,01 - 02,1276,2226,12857,3495,19854
01-02-2021,02 - 03,1246,2171,12665,3478,19560
01-02-2021,03 - 04,1184,2254,12711,3529,19678
01-02-2021,04 - 05,1173,2317,12895,3538,19923
01-02-2021,05 - 06,1355,2457,13510,3724,21046
01-02-2021,06 - 07,1458,2670,14664,4102,22894
01-02-2021,07 - 08,1471,2905,15617,4429,24422
01-02-2021,08 - 09,1521,2766,15894,4443,24624
01-02-2021,09 - 10,1345,2834,15841,4384,24404
01-02-2021,10 - 11,1279,2743,15631,4330,23983
01-02-2021,11 - 12,1277,2711,15569,4328,23885
01-02-2021,12 - 13,1345,2712,15520,4296,23873
01-02-2021,13 - 14,1431,2650,15224,4225,23530
01-02-2021,14 - 15,1470,2640,15125,4088,23323
01-02-2021,15 - 16,1463,2707,15035,4091,23296
01-02-2021,16 - 17,1417,2743,15249,4134,23543
01-02-2021,17 - 18,1356,2795,15729,4331,24211
01-02-2021,18 - 19,1349,2699,15516,4235,23799
01-02-2021,19 - 20,1346,2705,15116,4177,23344
01-02-2021,20 - 21,1448,2764,14815,4030,23057
01-02-2021,21 - 22,1440,2738,14281,3817,22276
01-02-2021,22 - 23,1365,2696,13517,3629,21207
01-02-2021,23 - 00,1321,2683,13182,3415,20601
02-02-2021,00 - 01,1270,2429,12541,3328,19568
02-02-2021,01 - 02,1398,2443,12359,3252,19452
02-02-2021,02 - 03,1478,2463,12337,3268,19546
02-02-2021,03 - 04,1473,2484,12397,3273,19627
02-02-2021,04 - 05,1447,2562,12495,3309,19813
02-02-2021,05 - 06,1590,2763,13057,3533,20943
02-02-2021,06 - 07,1677,2904,13968,3884,22433
02-02-2021,07 - 08,1663,3032,14903,4252,23850
02-02-2021,08 - 09,1690,2983,14978,4291,23942
02-02-2021,09 - 10,1636,2928,14942,4304,23810
02-02-2021,10 - 11,1614,2911,14826,4234,23585
02-02-2021,11 - 12,1645,2843,14835,4106,23429
02-02-2021,12 - 13,1545,2826,14856,4075,23302
02-02-2021,13 - 14,1648,2812,14719,3998,23177
02-02-2021,14 - 15,1585,2919,14713,3969,23186
02-02-2021,15 - 16,1689,2977,14671,4024,23361
02-02-2021,16 - 17,1761,2987,14814,4106,23668
02-02-2021,17 - 18,1769,2947,15291,4292,24299
02-02-2021,18 - 19,1650,2871,15112,4322,23955
02-02-2021,19 - 20,1558,2990,14925,4218,23691
02-02-2021,20 - 21,1527,2873,14472,4093,22965
02-02-2021,21 - 22,1704,2807,13870,3922,22303
02-02-2021,22 - 23,1352,2565,13197,3765,20879
02-02-2021,23 - 00,1323,2452,12562,3559,19896
03-02-2021,00 - 01,1368,2386,12265,3443,19462
03-02-2021,01 - 02,1451,2283,12018,3384,19136
03-02-2021,02 - 03,1480,2428,12025,3390,19323
03-02-2021,03 - 04,1498,2446,12154,3421,19519
03-02-2021,04 - 05,1613,2459,12315,3469,19856
03-02-2021,05 - 06,1603,2714,12901,3656,20874
03-02-2021,06 - 07,1579,2947,14075,4035,22636
03-02-2021,07 - 08,1443,3007,15076,4405,23931
03-02-2021,08 - 09,1600,2856,15435,4387,24278
03-02-2021,09 - 10,1458,2851,15645,4413,24367
03-02-2021,10 - 11,1316,2922,15715,4425,24378
03-02-2021,11 - 12,1382,2799,15751,4506,24438
03-02-2021,12 - 13,1553,2727,15531,4521,24332
03-02-2021,13 - 14,1532,2707,15182,4505,23926
03-02-2021,14 - 15,1419,2682,15117,4466,23684
03-02-2021,15 - 16,1507,2649,15192,4400,23748
03-02-2021,16 - 17,1579,2667,15490,4366,24102
03-02-2021,17 - 18,1477,2722,15971,4507,24677
03-02-2021,18 - 19,1472,2743,15714,4508,24437
03-02-2021,19 - 20,1566,2710,15306,4426,24008
03-02-2021,20 - 21,1499,2720,15069,4260,23548
03-02-2021,21 - 22,1541,2656,14550,4144,22891
03-02-2021,22 - 23,1503,2588,14126,3970,22187
03-02-2021,23 - 00,1406,2644,13550,3814,21414
04-02-2021,00 - 01,1403,2349,13208,3696,20656
04-02-2021,01 - 02,1413,2230,13063,3680,20386
04-02-2021,02 - 03,1372,2333,13192,3665,20562
04-02-2021,03 - 04,1352,2294,13224,3712,20582
04-02-2021,04 - 05,1510,2371,13452,3800,21133
04-02-2021,05 - 06,1478,2622,14036,3948,22084
04-02-2021,06 - 07,1569,2809,15150,4339,23867
04-02-2021,07 - 08,1453,2810,16241,4689,25193
04-02-2021,08 - 09,1446,2738,16468,4699,25351
04-02-2021,09 - 10,1411,2706,16436,4601,25154
04-02-2021,10 - 11,1501,2671,16441,4580,25193
04-02-2021,11 - 12,1619,2602,16369,4570,25160
04-02-2021,12 - 13,1510,2508,16243,4485,24746
04-02-2021,13 - 14,1456,2457,15998,4436,24347
04-02-2021,14 - 15,1457,2478,15991,4377,24303
04-02-2021,15 - 16,1554,2290,15992,4402,24238
04-02-2021,16 - 17,1529,2336,16118,4434,24417
04-02-2021,17 - 18,1503,2478,16605,4564,25150
04-02-2021,18 - 19,1492,2503,16450,4512,24957
04-02-2021,19 - 20,1557,2246,16070,4441,24314
04-02-2021,20 - 21,1547,2227,15638,4357,23769
04-02-2021,21 - 22,1639,2331,15160,4240,23370
04-02-2021,22 - 23,1496,2043,14718,4140,22397
04-02-2021,23 - 00,1310,2109,14454,3989,21862
05-02-2021,00 - 01,1235,1960,14294,3916,21405
05-02-2021,01 - 02,1308,2093,13954,3903,21258
05-02-2021,02 - 03,1362,2074,13836,3875,21147
05-02-2021,03 - 04,1357,2130,13765,3898,21150
05-02-2021,04 - 05,1307,2181,13859,3928,21275
05-02-2021,05 - 06,1375,2155,14328,4124,21982
05-02-2021,06 - 07,1219,2518,15167,4499,23403
05-02-2021,07 - 08,1287,2654,15822,4822,24585
05-02-2021,08 - 09,1530,2476,16122,4896,25024
05-02-2021,09 - 10,1510,2373,16032,4931,24846
05-02-2021,10 - 11,1471,2196,15997,4925,24589
05-02-2021,11 - 12,1487,2082,15885,4802,24256
05-02-2021,12 - 13,1483,2229,15603,4665,23980
05-02-2021,13 - 14,1426,2250,15214,4501,23391
05-02-2021,14 - 15,1359,2330,15070,4436,23195
05-02-2021,15 - 16,1286,2315,15071,4429,23101
05-02-2021,16 - 17,1388,2253,15400,4473,23514
05-02-2021,17 - 18,1368,2269,15821,4625,24083
05-02-2021,18 - 19,1425,2302,15652,4558,23937
05-02-2021,19 - 20,1427,2257,15203,4386,23273
05-02-2021,20 - 21,1302,2291,14826,4198,22617
05-02-2021,21 - 22,1307,2276,14446,4005,22034
05-02-2021,22 - 23,1323,2341,13983,3915,21562
05-02-2021,23 - 00,1339,2226,13526,3864,20955
06-02-2021,00 - 01,1296,2376,13096,3768,20536
06-02-2021,01 - 02,1101,2243,12995,3699,20038
06-02-2021,02 - 03,1096,2206,12860,3664,19826
06-02-2021,03 - 04,1152,2144,12897,3689,19882
06-02-2021,04 - 05,1270,1955,12989,3730,19944
06-02-2021,05 - 06,1311,1874,13197,3848,20230
06-02-2021,06 - 07,1321,2015,13505,4011,20852
06-02-2021,07 - 08,1273,1973,13911,4075,21232
06-02-2021,08 - 09,1374,1956,14311,4233,21874
06-02-2021,09 - 10,1296,2007,14706,4438,22447
06-02-2021,10 - 11,1382,2179,14746,4405,22712
06-02-2021,11 - 12,1404,2128,14646,4349,22527
06-02-2021,12 - 13,1373,2069,14453,4211,22106
06-02-2021,13 - 14,1313,2103,14040,4049,21505
06-02-2021,14 - 15,1229,2146,13848,3925,21148
06-02-2021,15 - 16,1292,2144,13979,3924,21339
06-02-2021,16 - 17,1443,2159,14543,4036,22181
06-02-2021,17 - 18,1309,2212,15148,4331,23000
06-02-2021,18 - 19,1398,2113,15145,4345,23001
06-02-2021,19 - 20,1320,2112,14791,4164,22387
06-02-2021,20 - 21,1351,2099,14147,4083,21680
06-02-2021,21 - 22,1326,2095,13701,3969,21091
06-02-2021,22 - 23,1311,2124,13395,3836,20666
06-02-2021,23 - 00,1309,2099,13043,3714,20165
07-02-2021,00 - 01,1320,2175,12829,3685,20009
07-02-2021,01 - 02,1345,2033,12766,3626,19770
07-02-2021,02 - 03,1268,2062,12649,3634,19613
07-02-2021,03 - 04,1191,2033,12599,3636,19459
07-02-2021,04 - 05,1158,2079,12620,3647,19504
07-02-2021,05 - 06,1239,2175,12880,3749,20043
07-02-2021,06 - 07,1316,2145,13256,3849,20566
07-02-2021,07 - 08,1312,2253,13624,3979,21168
07-02-2021,08 - 09,1336,2301,14003,3956,21596
07-02-2021,09 - 10,1353,2436,14250,4187,22226
07-02-2021,10 - 11,1447,2448,14429,4268,22592
07-02-2021,11 - 12,1466,2507,14411,4263,22647
07-02-2021,12 - 13,1352,2439,14281,4123,22195
07-02-2021,13 - 14,1304,2410,14101,4008,21823
07-02-2021,14 - 15,1358,2397,13981,4015,21751
07-02-2021,15 - 16,1415,2389,14106,4027,21937
07-02-2021,16 - 17,1522,2467,14622,4089,22700
07-02-2021,17 - 18,1601,2538,15236,4339,23714
07-02-2021,18 - 19,1497,2448,15081,4432,23458
07-02-2021,19 - 20,1458,2379,14799,4358,22994
07-02-2021,20 - 21,1407,2437,14511,4208,22563
07-02-2021,21 - 22,1412,2403,14146,4058,22019
07-02-2021,22 - 23,1397,2410,13685,3867,21359
07-02-2021,23 - 00,1345,2372,13252,3779,20748
08-02-2021,00 - 01,1272,2288,12970,3663,20193
08-02-2021,01 - 02,1279,2204,12844,3665,19992
08-02-2021,02 - 03,1299,2126,12762,3633,19820
08-02-2021,03 - 04,1192,2179,12841,3661,19873
08-02-2021,04 - 05,1129,2236,13121,3698,20184
08-02-2021,05 - 06,1335,2388,13691,3879,21293
08-02-2021,06 - 07,1764,2501,14956,4320,23541
08-02-2021,07 - 08,1677,2793,16068,4659,25197
08-02-2021,08 - 09,1658,2893,16192,4675,25418
08-02-2021,09 - 10,1510,2809,16193,4721,25233
08-02-2021,10 - 11,1484,2783,16139,4653,25059
08-02-2021,11 - 12,1367,2711,16092,4634,24804
08-02-2021,12 - 13,1340,2669,15876,4599,24484
08-02-2021,13 - 14,1410,2580,15410,4530,23930
08-02-2021,14 - 15,1389,2644,15324,4505,23862
08-02-2021,15 - 16,1497,2700,15281,4522,24000
08-02-2021,16 - 17,1493,2729,15576,4532,24330
08-02-2021,17 - 18,1435,2644,16156,4638,24873
08-02-2021,18 - 19,1493,2545,15922,4599,24559
08-02-2021,19 - 20,1466,2457,15582,4527,24032
08-02-2021,20 - 21,1397,2430,15242,4368,23437
08-02-2021,21 - 22,1414,2401,14749,4259,22823
08-02-2021,22 - 23,1410,2302,14154,4061,21927
08-02-2021,23 - 00,1345,2366,13567,3891,21169
09-02-2021,00 - 01,1209,2236,13207,3718,20370
09-02-2021,01 - 02,1267,2225,13080,3713,20285
09-02-2021,02 - 03,1261,1983,12989,3701,19934
09-02-2021,03 - 04,1262,1930,12966,3745,19903
09-02-2021,04 - 05,1256,1964,13136,3815,20171
09-02-2021,05 - 06,1318,2058,13802,3981,21159
09-02-2021,06 - 07,1481,2367,15083,4355,23286
09-02-2021,07 - 08,1610,2494,15883,4713,24700
09-02-2021,08 - 09,1574,2433,16175,4765,24947
09-02-2021,09 - 10,1498,2547,16151,4753,24949
09-02-2021,10 - 11,1502,2656,15999,4752,24909
09-02-2021,11 - 12,1409,2258,15785,4713,24165
09-02-2021,12 - 13,1269,2170,15763,4648,23850
09-02-2021,13 - 14,1408,2264,15480,4588,23740
09-02-2021,14 - 15,1433,2436,15325,4571,23765
09-02-2021,15 - 16,1513,2604,15614,4577,24308
09-02-2021,16 - 17,1441,2795,15936,4581,24753
09-02-2021,17 - 18,1444,2974,16423,4695,25536
09-02-2021,18 - 19,1524,2964,16345,4712,25545
09-02-2021,19 - 20,1511,2833,16099,4620,25063
09-02-2021,20 - 21,1516,2781,15759,4429,24485
09-02-2021,21 - 22,1390,2793,15163,4261,23607
09-02-2021,22 - 23,1259,2756,14648,4118,22781
09-02-2021,23 - 00,1285,2520,14573,3975,22353
10-02-2021,00 - 01,1187,2498,14390,3872,21947
10-02-2021,01 - 02,1185,2352,14135,3794,21466
10-02-2021,02 - 03,1046,2379,14098,3753,21276
10-02-2021,03 - 04,983,2513,13940,3765,21201
10-02-2021,04 - 05,1235,2451,14155,3789,21630
10-02-2021,05 - 06,1434,2575,14679,3947,22635
10-02-2021,06 - 07,1384,2729,15700,4360,24173
10-02-2021,07 - 08,1438,2899,16542,4680,25559
10-02-2021,08 - 09,1420,2821,16668,4748,25657
10-02-2021,09 - 10,1413,2805,16638,4732,25588
10-02-2021,10 - 11,1363,2783,16372,4687,25205
10-02-2021,11 - 12,1279,2726,16236,4626,24867
10-02-2021,12 - 13,1334,2576,16073,4511,24494
10-02-2021,13 - 14,1231,2374,15767,4451,23823
10-02-2021,14 - 15,1353,2387,15600,4408,23748
10-02-2021,15 - 16,1460,2443,15590,4441,23934
10-02-2021,16 - 17,1471,2536,15908,4458,24373
10-02-2021,17 - 18,1428,2571,16408,4648,25055
10-02-2021,18 - 19,1306,2511,16265,4634,24716
10-02-2021,19 - 20,1062,2460,15880,4494,23896
10-02-2021,20 - 21,1100,2346,15333,4369,23148
10-02-2021,21 - 22,1200,2317,14666,4202,22385
10-02-2021,22 - 23,1217,2274,14302,4125,21918
10-02-2021,23 - 00,1242,2201,13983,3983,21409
11-02-2021,00 - 01,1257,2070,13505,3812,20644
11-02-2021,01 - 02,1300,1916,13564,3762,20542
11-02-2021,02 - 03,1323,2022,13602,3793,20740
11-02-2021,03 - 04,1323,2046,13800,3857,21026
11-02-2021,04 - 05,1361,1995,13945,3925,21226
11-02-2021,05 - 06,1326,2053,14508,4164,22051
11-02-2021,06 - 07,1287,2210,15294,4544,23335
11-02-2021,07 - 08,1358,2193,15952,4834,24337
11-02-2021,08 - 09,1324,2242,16069,4866,24501
11-02-2021,09 - 10,1292,2097,16099,4910,24398
11-02-2021,10 - 11,1377,2074,16069,4711,24231
11-02-2021,11 - 12,1389,2001,15922,4686,23998
11-02-2021,12 - 13,1497,1900,15669,4572,23638
11-02-2021,13 - 14,1565,1992,15384,4515,23456
11-02-2021,14 - 15,1509,2082,15284,4427,23302
11-02-2021,15 - 16,1504,2109,15487,4444,23544
11-02-2021,16 - 17,1642,2102,15635,4491,23870
11-02-2021,17 - 18,1555,2102,16053,4686,24396
11-02-2021,18 - 19,1563,2102,16007,4635,24307
11-02-2021,19 - 20,1591,2034,15769,4517,23911
11-02-2021,20 - 21,1614,1905,15756,4503,23778
11-02-2021,21 - 22,1459,1763,15399,4343,22964
11-02-2021,22 - 23,1411,1844,14935,4204,22394
11-02-2021,23 - 00,1375,1869,14600,4024,21868
12-02-2021,00 - 01,1263,1876,14497,4027,21663
12-02-2021,01 - 02,1159,1784,14447,4026,21416
12-02-2021,02 - 03,1144,1799,14477,4053,21473
12-02-2021,03 - 04,1284,1798,14184,4092,21358
12-02-2021,04 - 05,1328,1865,14166,4131,21490
12-02-2021,05 - 06,1282,2052,14483,4289,22106
12-02-2021,06 - 07,1327,2081,15505,4614,23527
12-02-2021,07 - 08,1508,2142,16309,4925,24884
12-02-2021,08 - 09,1552,2105,16361,4947,24965
12-02-2021,09 - 10,1546,2077,16166,4859,24648
12-02-2021,10 - 11,1514,2073,16002,4766,24355
12-02-2021,11 - 12,1706,1974,15919,4638,24237
12-02-2021,12 - 13,1436,2049,15642,4491,23618
12-02-2021,13 - 14,1401,2023,15207,4294,22925
12-02-2021,14 - 15,1326,1952,14859,4210,22347
12-02-2021,15 - 16,1357,2068,14666,4215,22306
12-02-2021,16 - 17,1394,2135,15102,4333,22964
12-02-2021,17 - 18,1291,2095,15474,4500,23360
12-02-2021,18 - 19,1307,2032,15436,4471,23246
12-02-2021,19 - 20,1243,1999,15016,4299,22557
12-02-2021,20 - 21,1323,1907,14810,4176,22216
12-02-2021,21 - 22,1345,1895,14351,4040,21631
12-02-2021,22 - 23,1248,1863,13826,3864,20801
12-02-2021,23 - 00,1277,1779,13714,3791,20561
13-02-2021,00 - 01,1301,1814,13489,3737,20341
13-02-2021,01 - 02,1417,1740,13420,3780,20357
13-02-2021,02 - 03,1482,1643,13669,3796,20590
13-02-2021,03 - 04,1430,1797,13839,3782,20848
13-02-2021,04 - 05,1481,1653,13862,3768,20764
13-02-2021,05 - 06,1541,1759,13976,3834,21110
13-02-2021,06 - 07,1327,1844,14312,3950,21433
13-02-2021,07 - 08,1393,1862,14607,4066,21928
13-02-2021,08 - 09,1367,1879,15093,4159,22498
13-02-2021,09 - 10,1172,1917,14870,4158,22117
13-02-2021,10 - 11,1300,1996,14787,4039,22122
13-02-2021,11 - 12,1483,2039,14847,3924,22293
13-02-2021,12 - 13,1431,1963,14473,3742,21609
13-02-2021,13 - 14,1495,1778,14049,3570,20892
13-02-2021,14 - 15,1498,1845,13953,3509,20805
13-02-2021,15 - 16,1402,2074,14068,3570,21114
13-02-2021,16 - 17,1433,2245,14431,3755,21864
13-02-2021,17 - 18,1414,2119,14883,4007,22423
13-02-2021,18 - 19,1388,2202,15175,4045,22810
13-02-2021,19 - 20,1529,2002,14785,3940,22256
13-02-2021,20 - 21,1482,1901,14411,3921,21715
13-02-2021,21 - 22,1384,1889,13937,3793,21003
13-02-2021,22 - 23,1375,1861,13852,3707,20795
13-02-2021,23 - 00,1412,1752,13527,3622,20313
14-02-2021,00 - 01,1411,1889,13322,3592,20214
14-02-2021,01 - 02,1266,1816,13116,3580,19778
14-02-2021,02 - 03,1185,1702,13201,3580,19668
14-02-2021,03 - 04,1268,1635,13280,3634,19817
14-02-2021,04 - 05,1273,1846,13286,3627,20032
14-02-2021,05 - 06,1309,1922,13223,3560,20014
14-02-2021,06 - 07,1410,2068,13556,3620,20654
14-02-2021,07 - 08,1394,2135,13862,3783,21174
14-02-2021,08 - 09,1408,2138,13988,3927,21461
14-02-2021,09 - 10,1439,2206,13926,3937,21508
14-02-2021,10 - 11,1440,2193,14160,3894,21687
14-02-2021,11 - 12,1409,2160,13746,3819,21134
14-02-2021,12 - 13,1423,2134,13517,3642,20716
14-02-2021,13 - 14,1433,2035,12814,3455,19737
14-02-2021,14 - 15,1481,2076,12564,3402,19523
14-02-2021,15 - 16,1456,2107,12735,3435,19733
14-02-2021,16 - 17,1591,2176,13298,3614,20679
14-02-2021,17 - 18,1497,2320,14228,3950,21995
14-02-2021,18 - 19,1553,2356,14378,4072,22359
14-02-2021,19 - 20,1583,2390,14157,4056,22186
14-02-2021,20 - 21,1508,2355,13834,3995,21692
14-02-2021,21 - 22,1494,2284,13451,3872,21101
14-02-2021,22 - 23,1320,2269,13186,3778,20553
14-02-2021,23 - 00,1240,2309,12821,3697,20067
15-02-2021,00 - 01,1399,2192,12679,3640,19910
15-02-2021,01 - 02,1339,2077,12595,3633,19644
15-02-2021,02 - 03,1348,2016,12434,3637,19435
15-02-2021,03 - 04,1372,1803,12525,3676,19376
15-02-2021,04 - 05,1301,1864,12805,3738,19708
15-02-2021,05 - 06,1407,1896,13524,3939,20766
15-02-2021,06 - 07,1625,1922,14588,4314,22449
15-02-2021,07 - 08,1703,1969,15327,4606,23605
15-02-2021,08 - 09,1564,2185,15346,4646,23741
15-02-2021,09 - 10,1554,2154,15192,4532,23432
15-02-2021,10 - 11,1574,2077,14914,4404,22969
15-02-2021,11 - 12,1394,2057,14777,4371,22599
15-02-2021,12 - 13,1449,2122,14585,4313,22469
15-02-2021,13 - 14,1631,2031,14529,4279,22470
15-02-2021,14 - 15,1647,1877,14399,4283,22206
15-02-2021,15 - 16,1539,2118,14568,4300,22525
15-02-2021,16 - 17,1500,2283,14702,4305,22790
15-02-2021,17 - 18,1494,2066,15514,4491,23565
15-02-2021,18 - 19,1448,2033,15521,4472,23474
15-02-2021,19 - 20,1446,2104,15126,4344,23020
15-02-2021,20 - 21,1268,2303,14775,4172,22518
15-02-2021,21 - 22,1333,2285,14316,4039,21973
15-02-2021,22 - 23,1406,2132,13728,3833,21099
15-02-2021,23 - 00,1261,2174,13117,3622,20174
16-02-2021,00 - 01,1332,2021,12785,3523,19661
16-02-2021,01 - 02,1270,1816,12505,3461,19052
16-02-2021,02 - 03,1385,1814,12563,3373,19135
16-02-2021,03 - 04,1285,1813,12569,3354,19021
16-02-2021,04 - 05,1388,1901,12612,3327,19228
16-02-2021,05 - 06,1396,2030,13108,3550,20084
16-02-2021,06 - 07,1480,2490,14122,3937,22029
16-02-2021,07 - 08,1593,2673,15026,4230,23522
16-02-2021,08 - 09,1522,2789,15282,4237,23830
16-02-2021,09 - 10,1472,2632,15183,4243,23530
16-02-2021,10 - 11,1490,2563,15102,4269,23424
16-02-2021,11 - 12,1480,2493,14912,4266,23151
16-02-2021,12 - 13,1601,2371,14782,4226,22980
16-02-2021,13 - 14,1649,2518,14681,4208,23056
16-02-2021,14 - 15,1602,2538,14527,4167,22834
16-02-2021,15 - 16,1491,2632,14452,4162,22737
16-02-2021,16 - 17,1523,2684,14541,4143,22891
16-02-2021,17 - 18,1538,2649,15049,4296,23532
16-02-2021,18 - 19,1597,2716,14968,4359,23640
16-02-2021,19 - 20,1595,2596,14661,4256,23108
16-02-2021,20 - 21,1534,2534,14205,4090,22363
16-02-2021,21 - 22,1512,2521,13526,3923,21482
16-02-2021,22 - 23,1457,2499,12911,3791,20658
16-02-2021,23 - 00,1453,2319,12323,3558,19653
17-02-2021,00 - 01,1414,2214,11834,3401,18863
17-02-2021,01 - 02,1504,2273,11640,3349,18766
17-02-2021,02 - 03,1336,2354,11641,3370,18701
17-02-2021,03 - 04,1598,2281,11635,3296,18810
17-02-2021,04 - 05,1547,2313,11738,3327,18925
17-02-2021,05 - 06,1540,2403,12215,3415,19573
17-02-2021,06 - 07,1481,2642,13353,3806,21282
17-02-2021,07 - 08,1671,2753,14450,4190,23064
17-02-2021,08 - 09,1693,2821,14719,4263,23496
17-02-2021,09 - 10,1719,2759,14809,4275,23562
17-02-2021,10 - 11,1635,2621,14847,4340,23443
17-02-2021,11 - 12,1616,2463,14944,4350,23373
17-02-2021,12 - 13,1656,2340,14906,4249,23151
17-02-2021,13 - 14,1627,2372,14694,4175,22868
17-02-2021,14 - 15,1647,2319,14684,4130,22780
17-02-2021,15 - 16,1643,2425,14728,4086,22882
17-02-2021,16 - 17,1729,2400,14888,4082,23099
17-02-2021,17 - 18,1783,2432,15282,4249,23746
17-02-2021,18 - 19,1659,2384,15316,4241,23600
17-02-2021,19 - 20,1411,2255,14850,4063,22579
17-02-2021,20 - 21,1176,2227,14388,3904,21695
17-02-2021,21 - 22,1152,2246,13877,3781,21056
17-02-2021,22 - 23,1425,2172,13239,3627,20463
17-02-2021,23 - 00,1398,2060,12768,3538,19764
18-02-2021,00 - 01,1324,2043,12389,3421,19177
18-02-2021,01 - 02,1511,2012,12137,3408,19068
18-02-2021,02 - 03,1399,1954,11966,3319,18638
18-02-2021,03 - 04,1166,1991,12007,3282,18446
18-02-2021,04 - 05,1259,2205,12180,3342,18986
18-02-2021,05 - 06,1440,2256,12689,3472,19857
18-02-2021,06 - 07,1488,2598,13770,3912,21768
18-02-2021,07 - 08,1577,2726,14653,4271,23227
18-02-2021,08 - 09,1647,2644,14912,4361,23564
18-02-2021,09 - 10,1575,2605,14991,4328,23499
18-02-2021,10 - 11,1756,2639,15114,4296,23805
18-02-2021,11 - 12,1760,2666,14970,4338,23734
18-02-2021,12 - 13,1699,2595,14904,4298,23496
18-02-2021,13 - 14,1654,2623,14805,4308,23390
18-02-2021,14 - 15,1514,2837,14688,4297,23336
18-02-2021,15 - 16,1512,2851,14758,4229,23350
18-02-2021,16 - 17,1612,2699,14793,4220,23324
18-02-2021,17 - 18,1706,2655,15185,4368,23914
18-02-2021,18 - 19,1686,2570,15153,4311,23720
18-02-2021,19 - 20,1609,2458,14672,4156,22895
18-02-2021,20 - 21,1616,2474,14093,4005,22188
18-02-2021,21 - 22,1603,2597,13471,3877,21548
18-02-2021,22 - 23,1541,2576,12858,3689,20664
18-02-2021,23 - 00,1516,2513,12289,3538,19856
19-02-2021,00 - 01,1464,2239,11756,3405,18864
19-02-2021,01 - 02,1479,2226,11477,3319,18501
19-02-2021,02 - 03,1496,2267,11246,3286,18295
19-02-2021,03 - 04,1541,2248,11234,3348,18371
19-02-2021,04 - 05,1561,2277,11312,3402,18552
19-02-2021,05 - 06,1609,2335,11844,3535,19323
19-02-2021,06 - 07,1596,2519,12960,3896,20971
19-02-2021,07 - 08,1657,2617,13889,4182,22345
19-02-2021,08 - 09,1713,2581,14020,4234,22548
19-02-2021,09 - 10,1688,2587,14006,4194,22475
19-02-2021,10 - 11,1669,2632,13954,4214,22469
19-02-2021,11 - 12,1672,2545,13807,4116,22140
19-02-2021,12 - 13,1661,2589,13686,4033,21969
19-02-2021,13 - 14,1562,2581,13384,3913,21440
19-02-2021,14 - 15,1538,2524,13209,3790,21061
19-02-2021,15 - 16,1705,2532,13122,3700,21059
19-02-2021,16 - 17,1592,2506,13209,3683,20990
19-02-2021,17 - 18,1584,2574,13607,3899,21664
19-02-2021,18 - 19,1583,2424,13435,3902,21344
19-02-2021,19 - 20,1596,2445,12917,3767,20725
19-02-2021,20 - 21,1508,2408,12376,3574,19866
19-02-2021,21 - 22,1425,2270,11892,3425,19012
19-02-2021,22 - 23,1373,2183,11367,3269,18192
19-02-2021,23 - 00,1299,2128,10825,3100,17352
20-02-2021,00 - 01,1208,1984,10550,3017,16759
20-02-2021,01 - 02,1279,1924,10247,2928,16378
20-02-2021,02 - 03,1311,2020,10128,2867,16326
20-02-2021,03 - 04,1342,1923,9954,2833,16052
20-02-2021,04 - 05,1374,1762,9951,2883,15970
20-02-2021,05 - 06,1345,1862,10148,2894,16249
20-02-2021,06 - 07,1359,1917,10376,2949,16601
20-02-2021,07 - 08,1460,2007,10631,3018,17116
20-02-2021,08 - 09,1509,2142,10975,3212,17838
20-02-2021,09 - 10,1453,2071,11288,3318,18130
20-02-2021,10 - 11,1317,2059,11512,3366,18254
20-02-2021,11 - 12,1552,2077,11640,3331,18600
20-02-2021,12 - 13,1584,2038,11566,3287,18475
20-02-2021,13 - 14,1563,2019,11487,3272,18341
20-02-2021,14 - 15,1561,1931,11144,3208,17844
20-02-2021,15 - 16,1560,1920,11344,3237,18061
20-02-2021,16 - 17,1600,2103,11582,3336,18621
20-02-2021,17 - 18,1593,2362,12316,3584,19855
20-02-2021,18 - 19,1719,2291,12297,3589,19896
20-02-2021,19 - 20,1628,2169,11830,3417,19044
20-02-2021,20 - 21,1556,2195,11220,3243,18214
20-02-2021,21 - 22,1507,2185,10822,3084,17598
20-02-2021,22 - 23,1554,2144,10438,2969,17105
20-02-2021,23 - 00,1445,1999,10085,2900,16429
21-02-2021,00 - 01,1424,1917,9758,2815,15914
21-02-2021,01 - 02,1401,1966,9532,2726,15625
21-02-2021,02 - 03,1448,1928,9362,2740,15478
21-02-2021,03 - 04,1447,1867,9258,2778,15350
21-02-2021,04 - 05,1434,1875,9439,2818,15566
21-02-2021,05 - 06,1433,1917,9525,2860,15735
21-02-2021,06 - 07,1476,2004,9789,2982,16251
21-02-2021,07 - 08,1486,2016,9883,2978,16363
21-02-2021,08 - 09,1555,2288,10363,3031,17237
21-02-2021,09 - 10,1596,2270,10690,3141,17697
21-02-2021,10 - 11,1545,2235,10873,3167,17820
21-02-2021,11 - 12,1514,2501,10981,3114,18110
21-02-2021,12 - 13,1455,2660,11028,3047,18190
21-02-2021,13 - 14,1436,2472,11032,2976,17916
21-02-2021,14 - 15,1578,2275,10935,2929,17717
21-02-2021,15 - 16,1622,2091,10897,2893,17503
21-02-2021,16 - 17,1671,2217,11321,3046,18255
21-02-2021,17 - 18,1650,2464,12055,3281,19450
21-02-2021,18 - 19,1699,2643,12157,3417,19916
21-02-2021,19 - 20,1555,2548,11895,3319,19317
21-02-2021,20 - 21,1583,2400,11350,3201,18534
21-02-2021,21 - 22,1543,2366,10949,3128,17986
21-02-2021,22 - 23,1510,2255,10572,3089,17426
21-02-2021,23 - 00,1531,2113,10151,3026,16821
22-02-2021,00 - 01,1511,1988,9789,2964,16252
22-02-2021,01 - 02,1470,2113,9814,2980,16377
22-02-2021,02 - 03,1487,2100,9820,3023,16430
22-02-2021,03 - 04,1510,2131,9956,3053,16650
22-02-2021,04 - 05,1513,2138,10083,3090,16824
22-02-2021,05 - 06,1624,2273,10594,3261,17752
22-02-2021,06 - 07,1617,2594,11897,3633,19741
22-02-2021,07 - 08,1642,2699,12730,3810,20881
22-02-2021,08 - 09,1599,2676,12970,3802,21047
22-02-2021,09 - 10,1658,2535,12708,3622,20523
22-02-2021,10 - 11,1635,2496,12488,3606,20225
22-02-2021,11 - 12,1630,2576,12412,3586,20204
22-02-2021,12 - 13,1618,2620,12343,3479,20060
22-02-2021,13 - 14,1613,2606,12203,3422,19844
22-02-2021,14 - 15,1582,2639,12259,3394,19874
22-02-2021,15 - 16,1541,2783,12435,3436,20195
22-02-2021,16 - 17,1595,2905,12503,3386,20389
22-02-2021,17 - 18,1664,3064,12998,3489,21215
22-02-2021,18 - 19,1686,3098,12954,3566,21304
22-02-2021,19 - 20,1697,3172,12668,3456,20993
22-02-2021,20 - 21,1680,3183,12299,3311,20473
22-02-2021,21 - 22,1623,3144,11733,3172,19672
22-02-2021,22 - 23,1665,2949,11162,2950,18726
22-02-2021,23 - 00,1624,2818,10548,2788,17778
23-02-2021,00 - 01,1591,2923,10115,2677,17306
23-02-2021,01 - 02,1542,2988,9901,2654,17085
23-02-2021,02 - 03,1542,2981,9822,2573,16918
23-02-2021,03 - 04,1554,2948,9847,2589,16938
23-02-2021,04 - 05,1560,2781,9936,2688,16965
23-02-2021,05 - 06,1582,2681,10417,2811,17491
23-02-2021,06 - 07,1687,2671,11535,3215,19108
23-02-2021,07 - 08,1592,2662,12469,3458,20181
23-02-2021,08 - 09,1571,2584,12765,3612,20532
23-02-2021,09 - 10,1572,2369,12706,3628,20275
23-02-2021,10 - 11,1549,2179,12627,3689,20044
23-02-2021,11 - 12,1588,2052,12575,3666,19881
23-02-2021,12 - 13,1618,2017,12398,3611,19644
23-02-2021,13 - 14,1495,2024,12204,3571,19294
23-02-2021,14 - 15,1478,1903,12293,3569,19243
23-02-2021,15 - 16,1470,2036,12356,3579,19441
23-02-2021,16 - 17,1598,2188,12508,3548,19842
23-02-2021,17 - 18,1554,2428,13270,3641,20893
23-02-2021,18 - 19,1588,2379,13241,3642,20850
23-02-2021,19 - 20,1580,2259,12836,3443,20118
23-02-2021,20 - 21,1555,1804,12147,3214,18720
23-02-2021,21 - 22,1496,1879,11749,3167,18291
23-02-2021,22 - 23,1486,1770,11127,3115,17498
23-02-2021,23 - 00,1324,1650,10555,2920,16449
24-02-2021,00 - 01,1434,1515,10038,2684,15671
24-02-2021,01 - 02,1437,1760,9807,2537,15541
24-02-2021,02 - 03,1344,1734,9661,2453,15192
24-02-2021,03 - 04,1240,1716,9774,2459,15189
24-02-2021,04 - 05,1527,1819,9796,2582,15724
24-02-2021,05 - 06,1456,1878,10209,2729,16272
24-02-2021,06 - 07,1621,2171,11288,2992,18072
24-02-2021,07 - 08,1458,2134,12147,3280,19019
24-02-2021,08 - 09,1473,2049,12463,3397,19382
24-02-2021,09 - 10,1484,2232,12511,3435,19662
24-02-2021,10 - 11,1479,2291,12474,3473,19717
24-02-2021,11 - 12,1323,2091,12363,3473,19250
24-02-2021,12 - 13,1517,1874,12296,3385,19072
24-02-2021,13 - 14,1550,1867,12142,3345,18904
24-02-2021,14 - 15,1429,1763,12034,3348,18574
24-02-2021,15 - 16,1465,1760,12034,3312,18571
24-02-2021,16 - 17,1437,1784,12079,3306,18606
24-02-2021,17 - 18,1435,1737,12637,3422,19231
24-02-2021,18 - 19,1358,1659,12557,3500,19074
24-02-2021,19 - 20,1306,1810,11975,3430,18521
24-02-2021,20 - 21,1185,1729,11426,3206,17546
24-02-2021,21 - 22,1371,1480,10898,3018,16767
24-02-2021,22 - 23,1342,1387,10264,2894,15887
24-02-2021,23 - 00,1178,1457,9684,2740,15059
25-02-2021,00 - 01,1236,1629,9381,2587,14833
25-02-2021,01 - 02,859,1574,9126,2553,14112
25-02-2021,02 - 03,1148,1558,9061,2514,14281
25-02-2021,03 - 04,1247,1544,9067,2531,14389
25-02-2021,04 - 05,1240,1604,9178,2568,14590
25-02-2021,05 - 06,1217,1654,9662,2645,15178
25-02-2021,06 - 07,1247,1741,10638,2927,16553
25-02-2021,07 - 08,1214,1736,11350,3223,17523
25-02-2021,08 - 09,1215,1856,11692,3378,18141
25-02-2021,09 - 10,1260,1966,11725,3372,18323
25-02-2021,10 - 11,1236,1957,11716,3367,18276
25-02-2021,11 - 12,1185,2096,11816,3341,18438
25-02-2021,12 - 13,1266,1967,11698,3290,18221
25-02-2021,13 - 14,1284,1867,11653,3212,18016
25-02-2021,14 - 15,1311,1801,11693,3146,17951
25-02-2021,15 - 16,1330,1876,11650,3141,17997
25-02-2021,16 - 17,1338,1979,11688,3143,18148
25-02-2021,17 - 18,1283,2209,12114,3251,18857
25-02-2021,18 - 19,1272,2113,12246,3361,18992
25-02-2021,19 - 20,1308,1914,11991,3356,18569
25-02-2021,20 - 21,1298,1790,11643,3221,17952
25-02-2021,21 - 22,1301,1717,11208,3061,17287
25-02-2021,22 - 23,1115,1833,10752,2938,16638
25-02-2021,23 - 00,1155,1615,10245,2807,15822
26-02-2021,00 - 01,1262,1533,9898,2802,15495
26-02-2021,01 - 02,1214,1718,9778,2752,15462
26-02-2021,02 - 03,1170,1736,9772,2713,15391
26-02-2021,03 - 04,1134,1701,9647,2763,15245
26-02-2021,04 - 05,1209,1749,9829,2904,15691
26-02-2021,05 - 06,1251,1665,10335,3102,16353
26-02-2021,06 - 07,1331,1908,11322,3380,17941
26-02-2021,07 - 08,1451,1999,12071,3637,19158
26-02-2021,08 - 09,1300,2068,12398,3746,19512
26-02-2021,09 - 10,1283,2034,12125,3713,19155
26-02-2021,10 - 11,1428,1988,11870,3662,18948
26-02-2021,11 - 12,1358,1912,11593,3523,18386
26-02-2021,12 - 13,1299,1760,11259,3381,17699
26-02-2021,13 - 14,1371,1811,10850,3290,17322
26-02-2021,14 - 15,1331,1660,10808,3226,17025
26-02-2021,15 - 16,1311,1687,10835,3292,17125
26-02-2021,16 - 17,1381,1903,11010,3345,17639
26-02-2021,17 - 18,1328,2008,11645,3521,18502
26-02-2021,18 - 19,1142,1863,11781,3563,18349
26-02-2021,19 - 20,1167,1855,11453,3477,17952
26-02-2021,20 - 21,1104,1988,11120,3309,17521
26-02-2021,21 - 22,1063,1928,10676,3148,16815
26-02-2021,22 - 23,1152,1639,10414,3072,16277
26-02-2021,23 - 00,1049,1544,10124,3004,15721
27-02-2021,00 - 01,1387,1615,9791,2825,15618
27-02-2021,01 - 02,1149,1517,9765,2715,15146
27-02-2021,02 - 03,1081,1341,9865,2788,15075
27-02-2021,03 - 04,1136,1403,9917,2822,15278
27-02-2021,04 - 05,978,1649,9980,2894,15501
27-02-2021,05 - 06,989,1863,10255,2928,16035
27-02-2021,06 - 07,1040,1794,10771,3033,16638
27-02-2021,07 - 08,1186,1703,11013,3070,16972
27-02-2021,08 - 09,1403,1946,11556,3140,18045
27-02-2021,09 - 10,1488,1867,11483,3133,17971
27-02-2021,10 - 11,1352,1797,11033,3075,17257
27-02-2021,11 - 12,1074,1974,10918,2959,16925
27-02-2021,12 - 13,1064,1981,10614,2790,16449
27-02-2021,13 - 14,1093,1870,10780,2735,16478
27-02-2021,14 - 15,993,1757,10828,2679,16257
27-02-2021,15 - 16,1072,1764,10783,2788,16407
27-02-2021,16 - 17,1079,1870,10950,2941,16840
27-02-2021,17 - 18,1173,1923,11527,3168,17791
27-02-2021,18 - 19,1088,1912,11766,3353,18119
27-02-2021,19 - 20,1088,1881,11499,3283,17751
27-02-2021,20 - 21,1064,1818,11027,3117,17026
27-02-2021,21 - 22,1025,1730,10516,2995,16266
27-02-2021,22 - 23,1033,1726,10084,2878,15721
27-02-2021,23 - 00,1018,1750,9913,2722,15403
28-02-2021,00 - 01,1062,1656,9724,2638,15080
28-02-2021,01 - 02,1116,1468,9610,2577,14771
28-02-2021,02 - 03,1113,1545,9657,2543,14858
28-02-2021,03 - 04,1022,1607,9627,2569,14825
28-02-2021,04 - 05,1076,1504,9765,2589,14934
28-02-2021,05 - 06,1048,1412,9889,2626,14975
28-02-2021,06 - 07,1058,1617,10128,2693,15496
28-02-2021,07 - 08,1040,1720,10299,2763,15822
28-02-2021,08 - 09,1255,1729,10451,2922,16357
28-02-2021,09 - 10,1132,1814,10553,3024,16523
28-02-2021,10 - 11,1186,1725,10478,3053,16442
28-02-2021,11 - 12,1118,1880,10290,3087,16375
28-02-2021,12 - 13,1002,1940,10168,3100,16210
28-02-2021,13 - 14,1163,1703,10008,3007,15881
28-02-2021,14 - 15,1143,1651,10001,2861,15656
28-02-2021,15 - 16,1224,1876,9984,2812,15896
28-02-2021,16 - 17,1256,2015,10435,2957,16663
28-02-2021,17 - 18,1295,2210,11120,3124,17749
28-02-2021,18 - 19,1240,2212,11599,3335,18386
28-02-2021,19 - 20,1115,1924,11393,3282,17714
28-02-2021,20 - 21,1171,1806,11072,3169,17218
28-02-2021,21 - 22,1202,1877,10847,3069,16995
28-02-2021,22 - 23,1144,1982,10779,3046,16951
28-02-2021,23 - 00,989,1901,10272,2972,16134
01-03-2021,00 - 01,1058,1782,10205,2879,15924
01-03-2021,01 - 02,1070,1607,9994,2797,15468
01-03-2021,02 - 03,1142,1416,9708,2787,15053
01-03-2021,03 - 04,1119,1415,9722,2789,15045
01-03-2021,04 - 05,1054,1511,9886,2842,15293
01-03-2021,05 - 06,1075,1628,10489,2976,16168
01-03-2021,06 - 07,1057,1937,11677,3346,18017
01-03-2021,07 - 08,1115,2077,12433,3658,19283
01-03-2021,08 - 09,1161,1938,12547,3783,19429
01-03-2021,09 - 10,1248,1898,12239,3779,19164
01-03-2021,10 - 11,1290,1706,12023,3763,18782
01-03-2021,11 - 12,1220,1662,11921,3725,18528
01-03-2021,12 - 13,1247,1835,11787,3664,18533
01-03-2021,13 - 14,1246,1993,11667,3618,18524
01-03-2021,14 - 15,1196,1955,11557,3563,18271
01-03-2021,15 - 16,1204,1841,11666,3562,18273
01-03-2021,16 - 17,1302,1850,11848,3529,18529
01-03-2021,17 - 18,1330,1822,12308,3713,19173
01-03-2021,18 - 19,1373,1757,12569,3877,19576
01-03-2021,19 - 20,1317,1820,12312,3830,19279
01-03-2021,20 - 21,1200,1800,11802,3694,18496
01-03-2021,21 - 22,1214,1807,11436,3512,17969
01-03-2021,22 - 23,1065,1761,10805,3344,16975
01-03-2021,23 - 00,1063,1598,10285,3181,16127
02-03-2021,00 - 01,1074,1583,9846,3061,15564
02-03-2021,01 - 02,1039,1767,9892,2956,15654
02-03-2021,02 - 03,995,1749,9978,2992,15714
02-03-2021,03 - 04,1074,1657,9984,3016,15731
02-03-2021,04 - 05,1226,1714,10102,3049,16091
02-03-2021,05 - 06,1158,1803,10599,3163,16723
02-03-2021,06 - 07,1191,2015,11622,3515,18343
02-03-2021,07 - 08,1129,1894,12375,3792,19190
02-03-2021,08 - 09,1218,2198,12525,3899,19840
02-03-2021,09 - 10,1262,2096,12270,3864,19492
02-03-2021,10 - 11,1285,1999,12068,3822,19174
02-03-2021,11 - 12,1120,1879,11799,3751,18549
02-03-2021,12 - 13,1195,1888,11690,3691,18464
02-03-2021,13 - 14,1224,1895,11474,3627,18220
02-03-2021,14 - 15,1123,1842,11293,3614,17872
02-03-2021,15 - 16,1163,1942,11318,3603,18026
02-03-2021,16 - 17,1215,2034,11446,3613,18308
02-03-2021,17 - 18,1294,2138,12116,3762,19310
02-03-2021,18 - 19,1409,1871,12675,3830,19785
02-03-2021,19 - 20,1217,1939,12484,3731,19371
02-03-2021,20 - 21,1188,2026,12182,3574,18970
02-03-2021,21 - 22,1219,1856,11704,3422,18201
02-03-2021,22 - 23,1132,1686,11116,3315,17249
02-03-2021,23 - 00,1084,1728,10648,3142,16602
03-03-2021,00 - 01,1083,1607,10424,3064,16178
03-03-2021,01 - 02,1083,1607,10341,3034,16065
03-03-2021,02 - 03,1166,1575,10208,2998,15947
03-03-2021,03 - 04,1134,1323,10234,3016,15707
03-03-2021,04 - 05,1130,1410,10450,3089,16079
03-03-2021,05 - 06,1069,1515,11041,3273,16898
03-03-2021,06 - 07,1190,1648,12134,3660,18632
03-03-2021,07 - 08,1404,1803,12842,3972,20021
03-03-2021,08 - 09,1259,1925,13049,4022,20255
03-03-2021,09 - 10,1179,1835,12936,4106,20056
03-03-2021,10 - 11,1259,1771,12864,4038,19932
03-03-2021,11 - 12,1300,1691,12701,3962,19654
03-03-2021,12 - 13,1254,1648,12367,3842,19111
03-03-2021,13 - 14,1120,1694,12319,3753,18886
03-03-2021,14 - 15,1079,1662,12409,3670,18820
03-03-2021,15 - 16,1227,1664,12368,3661,18920
03-03-2021,16 - 17,1443,1872,12444,3683,19442
03-03-2021,17 - 18,1256,2038,13163,3794,20251
03-03-2021,18 - 19,1096,2167,13399,3898,20560
03-03-2021,19 - 20,1147,2122,13148,3824,20241
03-03-2021,20 - 21,1310,2013,12667,3646,19636
03-03-2021,21 - 22,1473,1924,12123,3509,19029
03-03-2021,22 - 23,1264,1774,11706,3284,18028
03-03-2021,23 - 00,1111,1793,11206,3141,17251
04-03-2021,00 - 01,1041,1720,10773,3049,16583
04-03-2021,01 - 02,965,1735,10694,3013,16407
04-03-2021,02 - 03,875,1691,10659,2921,16146
04-03-2021,03 - 04,1021,1650,10797,2977,16445
04-03-2021,04 - 05,1216,1623,10881,3040,16760
04-03-2021,05 - 06,1071,1719,11322,3111,17223
04-03-2021,06 - 07,1291,1888,12256,3532,18967
04-03-2021,07 - 08,1286,2091,13119,3888,20384
04-03-2021,08 - 09,1392,2142,13213,3996,20743
04-03-2021,09 - 10,1558,2023,12917,3953,20451
04-03-2021,10 - 11,1456,1994,12658,3917,20025
04-03-2021,11 - 12,1334,1970,12473,3823,19600
04-03-2021,12 - 13,1283,1963,12463,3725,19434
04-03-2021,13 - 14,1245,1925,12165,3647,18982
04-03-2021,14 - 15,1263,1952,12112,3540,18867
04-03-2021,15 - 16,1330,1818,12122,3527,18797
04-03-2021,16 - 17,1406,1880,12352,3502,19140
04-03-2021,17 - 18,1487,2268,13198,3676,20629
04-03-2021,18 - 19,1375,2196,13606,3827,21004
04-03-2021,19 - 20,1255,2200,13337,3788,20580
04-03-2021,20 - 21,1227,2026,12942,3669,19864
04-03-2021,21 - 22,1218,1793,12362,3501,18874
04-03-2021,22 - 23,1086,1736,11787,3339,17948
04-03-2021,23 - 00,1080,1749,11544,3241,17614
05-03-2021,00 - 01,1106,1678,11168,3164,17116
05-03-2021,01 - 02,1169,1660,10967,3118,16914
05-03-2021,02 - 03,1147,1574,10927,3136,16784
05-03-2021,03 - 04,1185,1468,11024,3189,16866
05-03-2021,04 - 05,1282,1554,11182,3224,17242
05-03-2021,05 - 06,1250,1781,11717,3442,18190
05-03-2021,06 - 07,1158,1976,12653,3792,19579
05-03-2021,07 - 08,1369,2154,13474,4011,21008
05-03-2021,08 - 09,1371,2430,13653,4017,21471
05-03-2021,09 - 10,1484,2523,13463,3946,21416
05-03-2021,10 - 11,1581,2429,13055,3790,20855
05-03-2021,11 - 12,1428,2299,12790,3649,20166
05-03-2021,12 - 13,1425,2222,12631,3490,19768
05-03-2021,13 - 14,1378,2024,12325,3390,19117
05-03-2021,14 - 15,1301,1950,12058,3306,18615
05-03-2021,15 - 16,1347,2025,11863,3252,18487
05-03-2021,16 - 17,1384,2297,12135,3324,19140
05-03-2021,17 - 18,1218,2412,12894,3535,20059
05-03-2021,18 - 19,1038,2257,13391,3716,20402
05-03-2021,19 - 20,1182,2103,13081,3668,20034
05-03-2021,20 - 21,1357,1919,12621,3540,19437
05-03-2021,21 - 22,1332,1770,12043,3399,18544
05-03-2021,22 - 23,1230,1617,11461,3320,17628
05-03-2021,23 - 00,1099,1665,11093,3218,17075
06-03-2021,00 - 01,1104,1628,10934,3177,16843
06-03-2021,01 - 02,1028,1675,10750,3105,16558
06-03-2021,02 - 03,974,1530,10554,3124,16182
06-03-2021,03 - 04,1088,1527,10603,3069,16287
06-03-2021,04 - 05,1228,1547,10669,3116,16560
06-03-2021,05 - 06,1192,1626,10726,3164,16708
06-03-2021,06 - 07,1139,1707,11004,3235,17085
06-03-2021,07 - 08,1254,1637,11147,3319,17357
06-03-2021,08 - 09,1356,1921,11498,3412,18187
06-03-2021,09 - 10,1379,1922,11615,3541,18457
06-03-2021,10 - 11,1364,1874,11441,3512,18191
06-03-2021,11 - 12,1188,1794,11255,3451,17688
06-03-2021,12 - 13,1132,1625,11110,3261,17128
06-03-2021,13 - 14,1160,2018,11022,3139,17339
06-03-2021,14 - 15,1147,1765,11045,3142,17099
06-03-2021,15 - 16,1151,1942,11169,3192,17454
06-03-2021,16 - 17,1281,2086,11286,3296,17949
06-03-2021,17 - 18,1374,2226,11780,3407,18787
06-03-2021,18 - 19,1374,2261,12061,3549,19245
06-03-2021,19 - 20,1172,1996,11786,3440,18394
06-03-2021,20 - 21,1166,1950,11318,3279,17713
06-03-2021,21 - 22,1195,2064,11016,3157,17432
06-03-2021,22 - 23,1198,2157,10722,3061,17138
06-03-2021,23 - 00,1222,1679,10404,2925,16230
07-03-2021,00 - 01,1221,1541,10237,2875,15874
07-03-2021,01 - 02,1236,1723,10170,2827,15956
07-03-2021,02 - 03,1236,1935,10287,2819,16277
07-03-2021,03 - 04,1199,2013,10394,2816,16422
07-03-2021,04 - 05,1196,1884,10561,2846,16487
07-03-2021,05 - 06,1156,1888,10686,2855,16585
07-03-2021,06 - 07,1204,1821,10684,2859,16568
07-03-2021,07 - 08,1206,1992,10806,2993,16997
07-03-2021,08 - 09,1199,2045,11049,3175,17468
07-03-2021,09 - 10,1263,2008,11250,3315,17836
07-03-2021,10 - 11,1203,2012,11333,3209,17757
07-03-2021,11 - 12,1259,2024,11540,3116,17939
07-03-2021,12 - 13,1221,1971,11663,3014,17869
07-03-2021,13 - 14,1221,1836,11551,2735,17343
07-03-2021,14 - 15,1197,1695,11494,2694,17080
07-03-2021,15 - 16,1195,1680,11637,2826,17338
07-03-2021,16 - 17,1260,1876,11881,3042,18059
07-03-2021,17 - 18,1295,1921,12683,3349,19248
07-03-2021,18 - 19,1263,2075,13108,3574,20020
07-03-2021,19 - 20,1181,2094,12808,3540,19623
07-03-2021,20 - 21,1211,1901,12342,3433,18887
07-03-2021,21 - 22,1314,1808,11901,3390,18413
07-03-2021,22 - 23,1215,1791,11434,3271,17711
07-03-2021,23 - 00,1089,1818,11203,3199,17309
08-03-2021,00 - 01,1074,1770,11103,3149,17096
08-03-2021,01 - 02,1069,1901,10864,3072,16906
08-03-2021,02 - 03,1093,1945,10946,3083,17067
08-03-2021,03 - 04,1145,1917,11100,3158,17320
08-03-2021,04 - 05,1408,1841,11333,3287,17869
08-03-2021,05 - 06,1501,2071,11776,3449,18797
08-03-2021,06 - 07,1492,2207,12925,3832,20456
08-03-2021,07 - 08,1445,2225,13875,4157,21702
08-03-2021,08 - 09,1492,2260,13988,4151,21891
08-03-2021,09 - 10,1451,2266,13726,4021,21464
08-03-2021,10 - 11,1412,2180,13400,3895,20887
08-03-2021,11 - 12,1381,2171,13152,3798,20502
08-03-2021,12 - 13,1375,2201,12945,3700,20221
08-03-2021,13 - 14,1351,2223,12716,3610,19900
08-03-2021,14 - 15,1384,2126,12637,3514,19661
08-03-2021,15 - 16,1419,2099,12567,3539,19624
08-03-2021,16 - 17,1365,2169,12780,3564,19878
08-03-2021,17 - 18,1448,2321,13433,3768,20970
08-03-2021,18 - 19,1360,2249,13702,3934,21245
08-03-2021,19 - 20,1428,2236,13346,3897,20907
08-03-2021,20 - 21,1368,2113,13101,3774,20356
08-03-2021,21 - 22,1395,2135,12621,3644,19795
08-03-2021,22 - 23,1415,2089,12069,3521,19094
08-03-2021,23 - 00,1384,1959,11565,3347,18255
09-03-2021,00 - 01,1263,1925,11309,3347,17844
09-03-2021,01 - 02,1237,1978,11221,3299,17735
09-03-2021,02 - 03,1185,1901,11181,3311,17578
09-03-2021,03 - 04,1273,1921,11284,3351,17829
09-03-2021,04 - 05,1333,2051,11525,3414,18323
09-03-2021,05 - 06,1380,1984,11868,3579,18811
09-03-2021,06 - 07,1464,2346,12710,3893,20413
09-03-2021,07 - 08,1512,2344,13581,4109,21546
09-03-2021,08 - 09,1529,2230,13798,4112,21669
09-03-2021,09 - 10,1408,2209,13786,4008,21411
09-03-2021,10 - 11,1448,2238,13591,3844,21121
09-03-2021,11 - 12,1411,2218,13422,3749,20800
09-03-2021,12 - 13,1398,2159,13329,3706,20592
09-03-2021,13 - 14,1387,2127,13207,3641,20362
09-03-2021,14 - 15,1375,2207,13143,3669,20394
09-03-2021,15 - 16,1352,2192,13143,3699,20386
09-03-2021,16 - 17,1382,2272,13266,3712,20632
09-03-2021,17 - 18,1373,2320,13740,3869,21302
09-03-2021,18 - 19,1406,2072,13856,3935,21269
09-03-2021,19 - 20,1419,1903,13550,3861,20733
09-03-2021,20 - 21,1499,1834,13133,3788,20254
09-03-2021,21 - 22,1423,1788,12681,3654,19546
09-03-2021,22 - 23,1335,1712,12264,3466,18777
09-03-2021,23 - 00,1325,1685,11741,3278,18029
10-03-2021,00 - 01,1433,1763,11346,3175,17717
10-03-2021,01 - 02,1449,1801,11110,3124,17484
10-03-2021,02 - 03,1385,1823,11224,3102,17534
10-03-2021,03 - 04,1318,1686,11238,3160,17402
10-03-2021,04 - 05,1289,1843,11550,3242,17924
10-03-2021,05 - 06,1417,2028,12089,3436,18970
10-03-2021,06 - 07,1562,2177,13174,3779,20692
10-03-2021,07 - 08,1513,2200,14012,4047,21772
10-03-2021,08 - 09,1392,2374,14267,4007,22040
10-03-2021,09 - 10,1418,2527,14080,3930,21955
10-03-2021,10 - 11,1292,2380,14036,3870,21578
10-03-2021,11 - 12,1341,2241,13988,3811,21381
10-03-2021,12 - 13,1356,2217,13924,3721,21218
10-03-2021,13 - 14,1414,2204,13754,3620,20992
10-03-2021,14 - 15,1344,2247,13659,3588,20838
10-03-2021,15 - 16,1374,2341,13711,3597,21023
10-03-2021,16 - 17,1439,2251,13728,3642,21060
10-03-2021,17 - 18,1302,2212,13988,3806,21308
10-03-2021,18 - 19,1127,2295,14166,3896,21484
10-03-2021,19 - 20,1208,2335,13822,3814,21179
10-03-2021,20 - 21,1281,2249,13557,3672,20759
10-03-2021,21 - 22,1204,2136,13076,3495,19911
10-03-2021,22 - 23,1151,2154,12329,3306,18940
10-03-2021,23 - 00,1140,1945,11826,3123,18034
11-03-2021,00 - 01,1068,1909,11453,2999,17429
11-03-2021,01 - 02,1095,1970,11396,2947,17408
11-03-2021,02 - 03,1246,2025,11348,2947,17566
11-03-2021,03 - 04,1448,1956,11346,2996,17746
11-03-2021,04 - 05,1365,2124,11401,3102,17992
11-03-2021,05 - 06,1342,2105,11744,3296,18487
11-03-2021,06 - 07,1385,2421,12853,3665,20324
11-03-2021,07 - 08,1432,2420,13861,4053,21766
11-03-2021,08 - 09,1614,2276,14013,4204,22107
11-03-2021,09 - 10,1503,2261,14096,4225,22085
11-03-2021,10 - 11,1421,2345,14152,4244,22162
11-03-2021,11 - 12,1410,2306,14177,4247,22140
11-03-2021,12 - 13,1455,2324,14068,4232,22079
11-03-2021,13 - 14,1406,2292,13963,4127,21788
11-03-2021,14 - 15,1357,2253,13932,4050,21592
11-03-2021,15 - 16,1382,2224,14078,4004,21688
11-03-2021,16 - 17,1447,2204,14111,3940,21702
11-03-2021,17 - 18,1403,2286,14270,4043,22002
11-03-2021,18 - 19,1509,2275,14343,4111,22238
11-03-2021,19 - 20,1639,2249,13940,4026,21854
11-03-2021,20 - 21,3409,8409,11201,1702,24721
11-03-2021,21 - 22,3157,8192,10825,1685,23859
11-03-2021,22 - 23,2849,7393,10526,1691,22459
11-03-2021,23 - 00,2707,6089,10359,1711,20866
12-03-2021,00 - 01,1175,1620,10941,3045,16781
12-03-2021,01 - 02,1067,1655,10787,2951,16460
12-03-2021,02 - 03,1051,1577,10677,2848,16153
12-03-2021,03 - 04,1221,1769,10594,2834,16418
12-03-2021,04 - 05,1309,1830,10594,2873,16606
12-03-2021,05 - 06,1339,2162,11054,3029,17584
12-03-2021,06 - 07,1436,2229,11992,3390,19047
12-03-2021,07 - 08,1407,2314,12836,3740,20297
12-03-2021,08 - 09,1482,2397,13021,3780,20680
12-03-2021,09 - 10,1427,2321,12910,3734,20392
12-03-2021,10 - 11,1412,2195,12826,3732,20165
12-03-2021,11 - 12,1488,2105,12795,3700,20088
12-03-2021,12 - 13,1439,2288,12699,3627,20053
12-03-2021,13 - 14,1419,2217,12274,3601,19511
12-03-2021,14 - 15,1346,2172,12020,3503,19041
12-03-2021,15 - 16,1260,2142,11902,3446,18750
12-03-2021,16 - 17,1288,2212,12061,3460,19021
12-03-2021,17 - 18,1319,2248,12371,3608,19546
12-03-2021,18 - 19,1384,2212,12688,3721,20005
12-03-2021,19 - 20,1387,2183,12576,3608,19754
12-03-2021,20 - 21,1288,2050,12083,3439,18860
12-03-2021,21 - 22,1330,2001,11425,3303,18059
12-03-2021,22 - 23,1336,1967,11005,3237,17545
12-03-2021,23 - 00,1151,2114,10572,3111,16948
13-03-2021,00 - 01,1136,1978,10206,2943,16263
13-03-2021,01 - 02,1211,1897,10041,2835,15984
13-03-2021,02 - 03,1242,1979,9895,2762,15878
13-03-2021,03 - 04,1221,1893,9909,2771,15794
13-03-2021,04 - 05,1212,1945,9902,2850,15909
13-03-2021,05 - 06,1230,1922,10042,2917,16111
13-03-2021,06 - 07,1252,1940,10204,2926,16322
13-03-2021,07 - 08,1220,2017,10589,3049,16875
13-03-2021,08 - 09,1234,2124,11151,3180,17689
13-03-2021,09 - 10,1292,2093,11504,3252,18141
13-03-2021,10 - 11,1295,2126,11548,3310,18279
13-03-2021,11 - 12,1306,2129,11495,3294,18224
13-03-2021,12 - 13,1280,2094,11402,3225,18001
13-03-2021,13 - 14,1260,2065,11231,3157,17713
13-03-2021,14 - 15,1207,2048,11092,3208,17555
13-03-2021,15 - 16,1227,2054,11118,3284,17683
13-03-2021,16 - 17,1241,2095,11305,3309,17950
13-03-2021,17 - 18,1429,2189,11742,3462,18822
13-03-2021,18 - 19,1388,2198,12122,3555,19263
13-03-2021,19 - 20,1385,2152,12009,3477,19023
13-03-2021,20 - 21,1372,2095,11497,3289,18253
13-03-2021,21 - 22,1322,1987,11059,3152,17520
13-03-2021,22 - 23,1257,2015,10874,3093,17239
13-03-2021,23 - 00,1221,1909,10600,3012,16742
14-03-2021,00 - 01,1182,1845,10216,2865,16108
14-03-2021,01 - 02,1252,1799,10027,2768,15846
14-03-2021,02 - 03,1247,1766,9961,2735,15709
14-03-2021,03 - 04,1194,1795,9966,2686,15641
14-03-2021,04 - 05,1262,1823,10076,2641,15802
14-03-2021,05 - 06,1248,1849,10157,2714,15968
14-03-2021,06 - 07,1188,1877,10207,2778,16050
14-03-2021,07 - 08,1215,1887,10511,2888,16501
14-03-2021,08 - 09,1266,1924,10857,3022,17069
14-03-2021,09 - 10,1284,1945,11022,3103,17354
14-03-2021,10 - 11,1296,1965,11148,3201,17610
14-03-2021,11 - 12,1239,1937,11076,3205,17457
14-03-2021,12 - 13,1222,1877,10982,3192,17273
14-03-2021,13 - 14,1210,1839,10906,3097,17052
14-03-2021,14 - 15,1196,1836,10834,3026,16892
14-03-2021,15 - 16,1228,1896,10991,3035,17150
14-03-2021,16 - 17,1338,1985,11380,3105,17808
14-03-2021,17 - 18,1349,2010,11783,3193,18335
14-03-2021,18 - 19,1306,2055,12129,3337,18827
14-03-2021,19 - 20,1282,2034,11900,3307,18523
14-03-2021,20 - 21,1266,1981,11489,3117,17853
14-03-2021,21 - 22,1247,1920,11078,3001,17246
14-03-2021,22 - 23,1225,1869,10652,2953,16699
14-03-2021,23 - 00,1205,1793,10263,2854,16115
15-03-2021,00 - 01,1180,1786,10137,2835,15938
15-03-2021,01 - 02,1197,1817,9983,2778,15775
15-03-2021,02 - 03,1185,1771,9959,2759,15674
15-03-2021,03 - 04,1191,1729,10033,2727,15680
15-03-2021,04 - 05,1238,1793,10197,2752,15980
15-03-2021,05 - 06,1264,1935,10677,2942,16818
15-03-2021,06 - 07,1234,2107,11735,3281,18357
15-03-2021,07 - 08,1257,2158,12663,3579,19657
15-03-2021,08 - 09,1269,2095,12845,3695,19904
15-03-2021,09 - 10,1299,2219,12702,3716,19936
15-03-2021,10 - 11,,,,,
15-03-2021,11 - 12,,,,,
15-03-2021,12 - 13,,,,,
15-03-2021,13 - 14,,,,,
15-03-2021,14 - 15,,,,,
15-03-2021,15 - 16,,,,,
15-03-2021,16 - 17,,,,,
15-03-2021,17 - 18,,,,,
15-03-2021,18 - 19,,,,,
15-03-2021,19 - 20,,,,,
15-03-2021,20 - 21,,,,,
15-03-2021,21 - 22,,,,,
15-03-2021,22 - 23,,,,,
15-03-2021,23 - 00,,,,,
